polling_station_id;teryt_gmina;teryt_powiat;postal_code;eligible_voters;ballots_cast;valid_votes;Nawrocki;Trzaskowski
1;20101;20100;59-700;1678;1187;1178;582;596
2;20101;20100;59-700;1269;911;903;386;517
3;20101;20100;59-700;1358;996;993;437;556
4;20101;20100;59-700;1354;984;975;408;567
5;20101;20100;59-700;1195;856;850;332;518
6;20101;20100;59-700;1138;608;597;279;318
7;20101;20100;59-700;1317;961;954;435;519
8;20101;20100;59-700;1195;882;874;377;497
9;20101;20100;59-700;1277;863;856;346;510
10;20101;20100;59-700;1135;719;712;323;389
11;20101;20100;59-700;1208;791;785;289;496
12;20101;20100;59-700;1110;765;759;311;448
13;20101;20100;59-700;1154;763;763;287;476
14;20101;20100;59-700;1361;1016;1006;365;641
15;20101;20100;59-700;1191;825;818;310;508
16;20101;20100;59-700;1269;922;914;355;559
17;20101;20100;59-700;1173;714;712;322;390
18;20101;20100;59-700;1168;755;744;313;431
19;20101;20100;59-700;1372;1018;1010;355;655
20;20101;20100;59-700;1851;1245;1235;536;699
21;20101;20100;59-700;1414;912;910;388;522
22;20101;20100;59-700;300;95;94;55;39
23;20101;20100;59-700;46;24;24;14;10
24;20101;20100;59-700;82;35;35;11;24
1;20102;20100;59-700;373;258;258;164;94
2;20102;20100;59-700;863;656;653;312;341
3;20102;20100;59-700;376;278;275;152;123
4;20102;20100;59-700;715;506;504;356;148
5;20102;20100;59-700;817;593;587;260;327
6;20102;20100;59-700;406;250;246;129;117
7;20102;20100;59-700;1086;673;670;369;301
8;20102;20100;59-700;638;424;421;218;203
9;20102;20100;59-700;1510;1133;1126;450;676
10;20102;20100;59-700;841;602;596;261;335
11;20102;20100;59-730;766;485;475;344;131
12;20102;20100;59-700;189;134;131;75;56
13;20102;20100;59-700;199;126;124;70;54
14;20102;20100;59-700;379;232;229;121;108
15;20102;20100;59-700;199;125;125;70;55
16;20102;20100;59-700;192;109;108;66;42
17;20102;20100;59-700;570;428;425;196;229
18;20102;20100;59-700;199;146;144;80;64
19;20102;20100;59-700;425;262;259;160;99
20;20102;20100;59-700;396;256;256;142;114
21;20102;20100;59-700;215;148;148;80;68
1;20103;20100;59-706;1631;998;993;570;423
2;20103;20100;59-706;757;466;462;354;108
3;20103;20100;59-706;307;207;205;132;73
4;20103;20100;59-706;425;252;252;167;85
5;20103;20100;59-706;423;245;245;158;87
6;20103;20100;59-706;434;288;283;187;96
1;20104;20100;59-730;787;444;441;283;158
2;20104;20100;59-730;868;514;510;349;161
3;20104;20100;59-730;410;251;251;133;118
4;20104;20100;59-730;1117;672;670;495;175
5;20104;20100;59-730;1003;616;606;395;211
6;20104;20100;59-730;435;272;270;161;109
7;20104;20100;59-730;1722;1087;1077;662;415
8;20104;20100;59-730;1480;917;914;520;394
9;20104;20100;59-730;498;298;295;168;127
10;20104;20100;59-730;1420;871;868;606;262
11;20104;20100;59-730;1058;627;620;346;274
12;20104;20100;59-730;196;123;121;76;45
13;20104;20100;59-730;73;14;13;5;8
14;20104;20100;59-730;54;14;13;7;6
1;20105;20100;59-724;817;512;508;314;194
2;20105;20100;59-724;1236;803;788;397;391
3;20105;20100;59-724;423;259;252;130;122
4;20105;20100;59-724;503;305;304;177;127
5;20105;20100;59-724;806;430;426;224;202
6;20105;20100;59-724;320;149;149;89;60
7;20105;20100;59-726;1049;681;675;391;284
1;20106;20100;59-720;809;573;567;329;238
2;20106;20100;59-720;877;558;555;268;287
3;20106;20100;59-720;957;585;576;350;226
4;20106;20100;59-720;883;571;566;326;240
5;20106;20100;59-720;947;535;531;302;229
6;20106;20100;59-720;497;297;295;186;109
7;20106;20100;59-720;243;176;176;130;46
8;20106;20100;59-720;289;197;196;125;71
9;20106;20100;59-720;185;136;136;109;27
10;20106;20100;59-720;619;397;393;205;188
1;20201;20200;58-260;1050;672;665;362;303
2;20201;20200;58-260;1282;780;773;389;384
3;20201;20200;58-260;1124;680;672;337;335
4;20201;20200;58-260;1159;759;754;354;400
5;20201;20200;58-260;860;539;537;250;287
6;20201;20200;58-260;972;648;646;290;356
7;20201;20200;58-260;1128;709;704;319;385
8;20201;20200;58-260;992;677;671;303;368
9;20201;20200;58-260;1014;660;658;296;362
10;20201;20200;58-260;1106;766;763;319;444
11;20201;20200;58-260;902;605;600;266;334
12;20201;20200;58-260;851;549;541;288;253
13;20201;20200;58-260;890;550;545;278;267
14;20201;20200;58-260;1019;710;706;259;447
15;20201;20200;58-260;1064;670;668;303;365
16;20201;20200;58-260;924;558;552;266;286
17;20201;20200;58-260;887;483;479;251;228
18;20201;20200;58-260;1029;606;597;277;320
19;20201;20200;58-260;1002;610;602;299;303
20;20201;20200;58-260;1093;728;719;301;418
21;20201;20200;58-260;812;473;469;220;249
22;20201;20200;58-260;40;11;11;5;6
1;20202;20200;58-200;1103;855;850;286;564
2;20202;20200;58-200;1439;1059;1049;413;636
3;20202;20200;58-200;974;672;666;353;313
4;20202;20200;58-200;848;590;587;275;312
5;20202;20200;58-200;995;661;655;300;355
6;20202;20200;58-200;1143;792;785;339;446
7;20202;20200;58-200;999;670;666;263;403
8;20202;20200;58-200;983;693;684;292;392
9;20202;20200;58-200;905;635;635;248;387
10;20202;20200;58-200;704;505;499;216;283
11;20202;20200;58-200;1216;923;916;369;547
12;20202;20200;58-200;1029;599;595;304;291
13;20202;20200;58-200;1016;577;573;313;260
14;20202;20200;58-200;1111;747;740;354;386
15;20202;20200;58-200;1312;923;917;426;491
16;20202;20200;58-200;1122;782;775;275;500
17;20202;20200;58-200;991;569;562;255;307
18;20202;20200;58-200;1230;792;782;349;433
19;20202;20200;58-200;1047;699;698;317;381
20;20202;20200;58-200;1308;795;790;360;430
21;20202;20200;58-200;1278;729;725;374;351
22;20202;20200;58-200;191;168;166;21;145
23;20202;20200;58-200;45;19;19;7;12
1;20203;20200;58-250;571;373;369;200;169
2;20203;20200;58-250;1002;549;544;276;268
3;20203;20200;58-250;934;610;602;318;284
4;20203;20200;58-250;1219;706;696;376;320
5;20203;20200;58-250;370;236;231;151;80
6;20203;20200;58-250;343;258;256;152;104
7;20203;20200;58-250;545;329;326;159;167
8;20203;20200;58-250;357;232;229;117;112
9;20203;20200;58-250;1370;854;841;405;436
10;20203;20200;58-250;34;19;19;10;9
11;20203;20200;58-250;45;27;24;17;7
1;20204;20200;58-240;1449;869;861;429;432
2;20204;20200;58-240;1600;945;941;502;439
3;20204;20200;58-240;1418;841;837;498;339
1;20205;20200;58-116;268;162;160;90;70
2;20205;20200;58-116;525;362;358;173;185
3;20205;20200;58-207;420;298;296;138;158
4;20205;20200;58-207;300;202;200;110;90
5;20205;20200;58-207;331;232;230;144;86
6;20205;20200;58-211;783;556;550;326;224
7;20205;20200;58-200;469;278;272;162;110
8;20205;20200;58-217;365;257;255;194;61
9;20205;20200;58-241;1107;765;755;450;305
10;20205;20200;58-262;481;332;327;184;143
11;20205;20200;58-262;930;632;618;293;325
12;20205;20200;58-262;308;202;200;123;77
13;20205;20200;58-116;337;226;222;129;93
14;20205;20200;58-207;239;165;164;95;69
15;20205;20200;58-241;119;112;109;16;93
1;20206;20200;58-212;831;522;516;332;184
2;20206;20200;58-210;492;334;330;204;126
3;20206;20200;58-214;655;454;449;326;123
4;20206;20200;58-210;295;201;201;130;71
5;20206;20200;58-210;1194;796;785;431;354
6;20206;20200;58-210;851;562;559;312;247
7;20206;20200;58-210;347;237;233;164;69
8;20206;20200;58-212;424;308;306;224;82
9;20206;20200;58-210;264;184;179;132;47
10;20206;20200;58-210;205;139;139;103;36
1;20207;20200;58-230;742;481;475;232;243
2;20207;20200;58-230;562;294;292;151;141
3;20207;20200;58-230;817;435;432;245;187
4;20207;20200;58-231;520;333;330;190;140
5;20207;20200;58-230;495;302;301;193;108
6;20207;20200;58-217;571;365;360;207;153
7;20207;20200;58-231;235;154;152;73;79
1;20301;20300;67-200;2366;1713;1701;681;1020
2;20301;20300;67-200;1703;1133;1123;517;606
3;20301;20300;67-200;1735;1056;1049;544;505
4;20301;20300;67-200;1671;1009;995;509;486
5;20301;20300;67-200;865;614;605;312;293
6;20301;20300;67-200;1100;795;783;362;421
7;20301;20300;67-200;1078;763;758;365;393
8;20301;20300;67-200;941;644;639;320;319
9;20301;20300;67-200;1155;813;804;391;413
10;20301;20300;67-200;1100;751;742;324;418
11;20301;20300;67-200;704;472;470;212;258
12;20301;20300;67-200;1317;969;965;421;544
13;20301;20300;67-200;1688;1181;1172;566;606
14;20301;20300;67-200;1675;1122;1109;530;579
15;20301;20300;67-200;1770;1232;1220;576;644
16;20301;20300;67-200;1797;1228;1226;607;619
17;20301;20300;67-200;1743;1221;1214;559;655
18;20301;20300;67-200;1548;1117;1111;552;559
19;20301;20300;67-200;1533;1106;1100;529;571
20;20301;20300;67-200;1662;1100;1091;514;577
21;20301;20300;67-200;1069;653;651;319;332
22;20301;20300;67-200;1476;1030;1024;521;503
23;20301;20300;67-200;1093;781;768;364;404
24;20301;20300;67-200;1263;865;860;411;449
25;20301;20300;67-200;1083;850;843;370;473
26;20301;20300;67-200;1132;778;776;432;344
27;20301;20300;67-200;1837;1295;1283;669;614
28;20301;20300;67-200;411;316;316;145;171
29;20301;20300;67-200;1634;1185;1177;625;552
30;20301;20300;67-200;1499;1033;1027;537;490
31;20301;20300;67-200;1241;823;815;412;403
32;20301;20300;67-200;1049;771;761;389;372
33;20301;20300;67-200;1388;958;947;471;476
34;20301;20300;67-200;282;211;207;32;175
35;20301;20300;67-200;88;51;48;21;27
36;20301;20300;67-200;244;69;69;34;35
1;20302;20300;67-210;1292;973;964;456;508
2;20302;20300;67-210;1290;952;945;575;370
3;20302;20300;67-210;1831;1333;1321;744;577
4;20302;20300;67-200;916;653;648;411;237
1;20303;20300;67-210;1507;1161;1144;588;556
2;20303;20300;67-222;1006;775;766;397;369
3;20303;20300;67-210;681;530;527;264;263
4;20303;20300;67-222;302;218;217;138;79
5;20303;20300;67-222;251;200;199;119;80
6;20303;20300;67-222;266;188;186;104;82
7;20303;20300;67-222;312;195;193;112;81
1;20304;20300;67-240;1393;902;896;539;357
2;20304;20300;67-240;413;267;263;189;74
3;20304;20300;67-240;702;488;483;340;143
4;20304;20300;67-240;453;320;314;174;140
5;20304;20300;67-240;355;207;206;146;60
1;20305;20300;67-221;585;383;381;246;135
2;20305;20300;67-221;589;399;399;306;93
3;20305;20300;67-221;481;289;287;199;88
1;20306;20300;67-231;1308;897;890;631;259
2;20306;20300;67-231;1215;756;748;402;346
1;20401;20400;56-200;1195;748;741;394;347
2;20401;20400;56-200;1566;996;992;433;559
3;20401;20400;56-200;1156;708;701;373;328
4;20401;20400;56-200;936;643;639;283;356
5;20401;20400;56-200;927;477;473;223;250
6;20401;20400;56-200;863;515;509;264;245
7;20401;20400;56-200;1716;1224;1221;512;709
8;20401;20400;56-200;1212;681;675;426;249
9;20401;20400;56-200;1090;642;638;424;214
10;20401;20400;56-200;1156;749;746;458;288
11;20401;20400;56-200;980;517;509;309;200
12;20401;20400;56-200;762;440;438;271;167
13;20401;20400;56-200;330;198;196;106;90
1;20402;20400;56-209;628;389;385;259;126
2;20402;20400;56-209;754;466;463;331;132
3;20402;20400;56-209;539;343;342;268;74
4;20402;20400;56-209;227;133;132;96;36
1;20403;20400;56-215;551;292;291;196;95
2;20403;20400;56-215;576;385;380;270;110
3;20403;20400;56-215;606;328;324;249;75
4;20403;20400;56-215;459;249;248;157;91
5;20403;20400;56-215;267;177;173;115;58
6;20403;20400;56-215;245;164;162;127;35
7;20403;20400;56-215;212;146;146;106;40
8;20403;20400;56-215;257;153;149;118;31
9;20403;20400;56-215;303;200;195;150;45
1;20404;20400;56-210;1001;588;583;372;211
2;20404;20400;56-210;827;513;509;288;221
3;20404;20400;56-210;334;191;188;110;78
4;20404;20400;56-210;370;228;227;149;78
5;20404;20400;56-210;685;381;380;268;112
6;20404;20400;56-210;223;140;139;93;46
7;20404;20400;56-210;349;228;223;158;65
8;20404;20400;56-210;334;221;220;153;67
9;20404;20400;56-210;1145;763;757;330;427
1;20501;20500;59-400;1416;891;887;488;399
2;20501;20500;59-400;2030;1486;1474;628;846
3;20501;20500;59-400;931;634;626;321;305
4;20501;20500;59-400;1324;791;778;411;367
5;20501;20500;59-400;1064;652;647;366;281
6;20501;20500;59-400;1387;789;780;448;332
7;20501;20500;59-400;1117;771;768;376;392
8;20501;20500;59-400;1217;830;823;439;384
9;20501;20500;59-400;1546;1083;1075;535;540
10;20501;20500;59-400;1311;924;921;468;453
11;20501;20500;59-400;1367;1004;992;524;468
12;20501;20500;59-400;1114;759;753;448;305
13;20501;20500;59-400;45;21;21;16;5
14;20501;20500;59-400;88;29;27;17;10
1;20502;20500;59-420;1099;654;644;300;344
2;20502;20500;59-420;970;633;628;283;345
3;20502;20500;59-420;1116;734;729;380;349
4;20502;20500;59-420;612;335;333;145;188
5;20502;20500;59-420;429;283;283;178;105
6;20502;20500;59-420;533;336;331;167;164
7;20502;20500;59-420;661;357;351;223;128
8;20502;20500;59-420;320;202;201;103;98
9;20502;20500;59-420;655;404;400;224;176
10;20502;20500;59-420;310;171;171;110;61
11;20502;20500;59-420;378;244;237;120;117
12;20502;20500;59-420;292;178;175;83;92
13;20502;20500;59-420;35;23;22;16;6
14;20502;20500;59-420;74;14;13;3;10
1;20503;20500;59-424;667;479;473;283;190
2;20503;20500;59-424;280;195;194;145;49
3;20503;20500;59-424;551;305;303;192;111
4;20503;20500;59-424;911;617;611;381;230
5;20503;20500;59-424;193;135;134;91;43
6;20503;20500;59-424;331;227;227;152;75
7;20503;20500;59-424;199;132;132;81;51
8;20503;20500;59-424;179;148;146;85;61
9;20503;20500;59-424;303;208;207;134;73
10;20503;20500;59-424;308;202;202;138;64
1;20504;20500;59-407;889;558;556;325;231
2;20504;20500;59-407;1018;664;660;353;307
3;20504;20500;59-407;1051;696;688;387;301
1;20505;20500;59-411;1605;1095;1088;636;452
2;20505;20500;59-411;1190;762;753;481;272
3;20505;20500;59-411;388;263;261;132;129
1;20506;20500;59-430;1451;937;931;549;382
2;20506;20500;59-430;1455;982;974;528;446
3;20506;20500;59-430;50;20;19;9;10
1;20601;20600;58-540;931;653;647;176;471
2;20601;20600;58-540;895;652;645;199;446
3;20601;20600;58-540;967;757;757;266;491
4;20601;20600;58-540;1179;908;902;256;646
5;20601;20600;58-540;721;508;505;145;360
6;20601;20600;58-540;51;42;41;20;21
1;20602;20600;58-530;522;380;376;148;228
2;20602;20600;58-530;974;572;567;224;343
3;20602;20600;58-530;1516;961;949;350;599
4;20602;20600;58-530;1361;866;859;330;529
5;20602;20600;58-530;910;602;600;209;391
6;20602;20600;58-530;976;557;552;237;315
7;20602;20600;58-530;978;689;685;234;451
8;20602;20600;58-530;48;45;45;19;26
9;20602;20600;58-530;157;68;67;22;45
10;20602;20600;58-530;53;35;31;9;22
1;20603;20600;58-573;1110;732;729;262;467
2;20603;20600;58-573;1321;890;880;350;530
3;20603;20600;58-573;1284;922;913;333;580
4;20603;20600;58-573;780;498;490;202;288
1;20604;20600;58-580;355;235;232;90;142
2;20604;20600;58-580;789;569;567;226;341
3;20604;20600;58-580;774;559;555;220;335
4;20604;20600;58-580;577;425;423;141;282
5;20604;20600;58-580;1310;949;942;301;641
6;20604;20600;58-580;1692;1303;1293;434;859
7;20604;20600;58-580;25;21;21;8;13
8;20604;20600;58-580;44;16;16;3;13
9;20604;20600;58-580;53;17;15;8;7
1;20605;20600;58-508;726;496;489;195;294
2;20605;20600;58-520;364;250;249;103;146
3;20605;20600;58-520;445;280;278;133;145
4;20605;20600;58-520;802;512;506;220;286
5;20605;20600;58-520;835;563;561;176;385
6;20605;20600;58-520;126;109;107;45;62
1;20606;20600;58-521;1433;1072;1066;334;732
2;20606;20600;58-508;1174;832;829;274;555
3;20606;20600;58-508;1178;761;759;326;433
4;20606;20600;58-521;1030;603;597;282;315
5;20606;20600;58-521;1129;823;818;285;533
1;20607;20600;58-533;1434;986;970;354;616
2;20607;20600;58-533;1771;1148;1130;412;718
3;20607;20600;58-508;1508;1039;1031;474;557
4;20607;20600;58-533;468;309;308;128;180
5;20607;20600;58-533;773;486;480;219;261
6;20607;20600;58-508;326;225;224;120;104
7;20607;20600;58-508;570;415;413;185;228
8;20607;20600;58-533;696;438;434;175;259
1;20608;20600;58-562;1660;1137;1130;398;732
2;20608;20600;58-562;408;297;293;106;187
3;20608;20600;58-500;1004;763;760;249;511
4;20608;20600;58-564;1050;712;702;238;464
5;20608;20600;58-535;1433;933;921;347;574
6;20608;20600;58-535;807;493;490;161;329
7;20608;20600;58-564;54;20;20;13;7
1;20609;20600;58-512;1221;741;732;351;381
2;20609;20600;58-512;925;564;558;285;273
3;20609;20600;58-512;502;324;321;127;194
4;20609;20600;58-560;1000;679;675;271;404
5;20609;20600;58-512;344;231;230;108;122
1;20701;20700;58-400;1713;1010;1001;518;483
2;20701;20700;58-400;1615;950;938;478;460
3;20701;20700;58-400;1550;945;935;441;494
4;20701;20700;58-400;1608;1017;1011;475;536
5;20701;20700;58-400;1657;989;986;465;521
6;20701;20700;58-400;1082;712;706;368;338
7;20701;20700;58-400;1918;1308;1295;501;794
8;20701;20700;58-400;1722;1186;1175;426;749
9;20701;20700;58-400;206;165;163;68;95
10;20701;20700;58-400;14;13;12;2;10
1;20702;20700;58-400;371;256;253;103;150
2;20702;20700;58-424;891;551;547;281;266
3;20702;20700;58-400;510;384;378;173;205
4;20702;20700;58-400;365;250;247;119;128
5;20702;20700;58-405;1420;1030;1021;571;450
6;20702;20700;58-400;511;343;337;192;145
7;20702;20700;58-400;614;445;438;189;249
8;20702;20700;58-400;326;185;184;91;93
9;20702;20700;58-400;367;250;248;152;96
10;20702;20700;58-400;360;250;246;154;92
11;20702;20700;58-400;308;186;184;91;93
12;20702;20700;58-400;211;133;130;65;65
13;20702;20700;58-400;178;125;125;61;64
14;20702;20700;58-400;218;142;141;82;59
15;20702;20700;58-400;27;14;14;7;7
1;20703;20700;58-420;1171;766;757;285;472
2;20703;20700;58-420;1610;1022;1012;403;609
3;20703;20700;58-420;1596;1067;1058;399;659
4;20703;20700;58-420;1876;1234;1222;684;538
5;20703;20700;58-420;454;306;304;157;147
6;20703;20700;58-420;430;268;267;146;121
7;20703;20700;58-420;376;251;249;116;133
8;20703;20700;58-420;280;163;161;58;103
9;20703;20700;58-420;264;197;196;103;93
1;20704;20700;58-410;1133;733;727;363;364
2;20704;20700;58-410;666;427;424;228;196
3;20704;20700;58-410;348;212;212;124;88
4;20704;20700;58-410;197;129;128;77;51
5;20704;20700;58-410;220;136;134;61;73
6;20704;20700;58-410;425;272;266;128;138
7;20704;20700;58-410;339;197;197;92;105
1;20801;20800;57-340;564;307;304;144;160
2;20801;20800;57-340;910;548;547;230;317
3;20801;20800;57-340;968;647;637;283;354
4;20801;20800;57-340;1054;1054;1041;413;628
1;20802;20800;57-300;928;612;609;251;358
2;20802;20800;57-300;891;704;698;257;441
3;20802;20800;57-300;960;732;724;271;453
4;20802;20800;57-300;935;524;520;251;269
5;20802;20800;57-300;1016;646;641;287;354
6;20802;20800;57-300;889;616;606;256;350
7;20802;20800;57-300;1103;628;622;345;277
8;20802;20800;57-300;871;524;515;249;266
9;20802;20800;57-300;1158;711;703;363;340
10;20802;20800;57-300;1157;800;792;317;475
11;20802;20800;57-300;1037;659;653;267;386
12;20802;20800;57-300;1028;668;665;292;373
13;20802;20800;57-300;1100;693;690;267;423
14;20802;20800;57-300;991;630;622;277;345
15;20802;20800;57-300;1342;982;977;421;556
16;20802;20800;57-300;1504;1054;1045;491;554
17;20802;20800;57-300;1500;1067;1055;409;646
18;20802;20800;57-300;141;87;84;44;40
19;20802;20800;57-300;574;471;457;44;413
1;20803;20800;57-350;1457;924;921;448;473
2;20803;20800;57-350;1150;770;764;261;503
3;20803;20800;57-350;1432;1097;1092;439;653
4;20803;20800;57-350;1057;777;769;382;387
5;20803;20800;57-350;793;510;506;282;224
6;20803;20800;57-350;571;397;393;198;195
7;20803;20800;57-350;1291;898;890;357;533
8;20803;20800;57-350;175;162;162;84;78
9;20803;20800;57-350;202;181;181;68;113
1;20804;20800;57-400;1070;588;582;260;322
2;20804;20800;57-400;1168;751;739;268;471
3;20804;20800;57-400;1147;647;645;289;356
4;20804;20800;57-400;1889;1129;1121;466;655
5;20804;20800;57-401;1167;648;645;280;365
6;20804;20800;57-401;1088;632;616;301;315
7;20804;20800;57-400;893;556;554;253;301
8;20804;20800;57-402;800;553;550;205;345
9;20804;20800;57-402;1100;786;779;289;490
10;20804;20800;57-402;1000;563;560;262;298
11;20804;20800;57-402;896;523;516;265;251
12;20804;20800;57-402;1721;1160;1152;450;702
13;20804;20800;57-402;1148;831;826;367;459
14;20804;20800;57-402;89;17;17;9;8
15;20804;20800;57-400;91;23;23;7;16
1;20805;20800;57-320;1698;1174;1159;479;680
2;20805;20800;57-320;1573;1094;1086;410;676
3;20805;20800;57-320;2267;1680;1664;666;998
4;20805;20800;57-320;43;14;14;10;4
1;20806;20800;57-500;818;397;394;222;172
2;20806;20800;57-500;1505;862;852;406;446
3;20806;20800;57-500;874;538;534;282;252
4;20806;20800;57-500;1840;1226;1210;535;675
5;20806;20800;57-500;1721;1070;1064;457;607
6;20806;20800;57-500;650;442;432;259;173
7;20806;20800;57-521;1002;668;663;429;234
8;20806;20800;57-500;859;575;574;353;221
9;20806;20800;57-521;743;486;483;268;215
10;20806;20800;57-500;341;244;242;168;74
11;20806;20800;57-500;863;596;595;267;328
12;20806;20800;57-520;490;324;320;113;207
13;20806;20800;57-500;396;270;268;110;158
14;20806;20800;57-500;784;515;509;306;203
15;20806;20800;57-500;291;208;206;74;132
16;20806;20800;57-520;280;209;206;107;99
17;20806;20800;57-520;196;129;128;70;58
18;20806;20800;57-500;27;21;21;7;14
19;20806;20800;57-500;30;14;14;8;6
20;20806;20800;57-500;87;44;43;26;17
1;20807;20800;57-300;381;259;257;120;137
2;20807;20800;57-300;461;274;270;137;133
3;20807;20800;57-312;1129;761;751;399;352
4;20807;20800;57-312;729;469;462;256;206
5;20807;20800;57-360;1534;946;939;540;399
6;20807;20800;57-361;831;507;500;281;219
7;20807;20800;57-362;2030;1263;1254;743;511
8;20807;20800;57-313;906;588;580;293;287
9;20807;20800;57-314;701;425;416;217;199
10;20807;20800;57-314;575;367;359;212;147
11;20807;20800;57-315;541;366;365;214;151
12;20807;20800;57-441;320;216;216;129;87
13;20807;20800;57-315;374;248;246;166;80
14;20807;20800;57-442;877;494;490;285;205
15;20807;20800;57-300;443;306;302;181;121
16;20807;20800;57-312;204;134;132;68;64
17;20807;20800;57-315;178;113;111;68;43
18;20807;20800;57-442;209;129;126;87;39
19;20807;20800;57-300;242;160;157;78;79
1;20808;20800;57-540;798;495;494;284;210
2;20808;20800;57-540;944;687;681;266;415
3;20808;20800;57-540;857;550;545;268;277
4;20808;20800;57-540;949;587;581;275;306
5;20808;20800;57-540;993;699;693;329;364
6;20808;20800;57-540;665;430;425;199;226
7;20808;20800;57-540;760;471;467;257;210
8;20808;20800;57-540;214;118;117;64;53
9;20808;20800;57-540;268;184;183;115;68
10;20808;20800;57-540;60;55;54;33;21
1;20809;20800;57-343;984;643;639;328;311
2;20809;20800;57-343;648;404;403;209;194
1;20810;20800;57-530;996;681;675;323;352
2;20810;20800;57-530;971;612;608;287;321
3;20810;20800;57-530;346;240;238;105;133
4;20810;20800;57-530;298;197;192;104;88
5;20810;20800;57-530;409;245;244;147;97
6;20810;20800;57-520;597;342;340;174;166
7;20810;20800;57-522;844;520;513;277;236
8;20810;20800;57-530;567;385;383;158;225
9;20810;20800;57-530;407;245;243;121;122
1;20811;20800;57-430;526;293;292;122;170
2;20811;20800;57-430;536;327;326;133;193
3;20811;20800;57-430;424;268;268;109;159
4;20811;20800;57-430;500;292;289;119;170
5;20811;20800;57-450;603;371;367;181;186
6;20811;20800;57-450;597;361;356;200;156
7;20811;20800;57-450;463;306;304;138;166
8;20811;20800;57-441;550;379;375;212;163
9;20811;20800;57-441;654;438;435;200;235
10;20811;20800;57-431;490;299;295;133;162
11;20811;20800;57-431;754;476;472;272;200
12;20811;20800;57-432;667;438;435;247;188
13;20811;20800;57-451;641;404;401;175;226
14;20811;20800;57-400;577;374;372;177;195
15;20811;20800;57-441;448;294;291;160;131
16;20811;20800;57-430;73;33;29;18;11
1;20812;20800;57-420;1890;1137;1125;543;582
2;20812;20800;57-420;186;127;126;80;46
3;20812;20800;57-420;871;543;538;339;199
4;20812;20800;57-420;1538;915;908;487;421
5;20812;20800;57-420;450;274;270;165;105
6;20812;20800;57-420;790;482;480;310;170
7;20812;20800;57-420;416;260;258;136;122
8;20812;20800;57-420;313;201;196;143;53
9;20812;20800;57-420;189;116;113;81;32
10;20812;20800;57-420;56;31;27;14;13
1;20813;20800;57-550;889;568;559;232;327
2;20813;20800;57-550;1151;705;696;297;399
3;20813;20800;57-550;1136;695;689;300;389
4;20813;20800;57-550;1131;624;617;275;342
5;20813;20800;57-550;646;436;432;179;253
6;20813;20800;57-550;448;275;273;116;157
7;20813;20800;57-550;56;40;40;26;14
1;20814;20800;57-330;713;436;432;198;234
2;20814;20800;57-330;1314;910;903;379;524
3;20814;20800;57-330;1714;1095;1081;509;572
4;20814;20800;57-320;269;177;177;133;44
5;20814;20800;57-340;646;368;365;205;160
6;20814;20800;57-300;455;250;249;129;120
7;20814;20800;57-320;278;187;186;93;93
1;20901;20900;59-225;1269;850;840;461;379
2;20901;20900;59-225;1829;1141;1135;659;476
3;20901;20900;59-225;1666;1017;1011;554;457
4;20901;20900;59-225;1052;697;691;340;351
5;20901;20900;59-225;1344;885;880;445;435
6;20901;20900;59-225;2004;1378;1373;644;729
7;20901;20900;59-225;56;8;8;4;4
1;20902;20900;59-225;1158;809;806;491;315
2;20902;20900;59-225;956;612;608;389;219
3;20902;20900;59-225;1142;759;754;446;308
4;20902;20900;59-225;423;260;257;131;126
5;20902;20900;59-225;544;344;336;217;119
6;20902;20900;59-225;366;237;237;169;68
7;20902;20900;59-225;909;579;571;401;170
8;20902;20900;59-225;933;623;615;385;230
9;20902;20900;59-225;672;450;448;236;212
1;20903;20900;59-223;577;428;427;238;189
2;20903;20900;59-223;394;282;282;184;98
3;20903;20900;59-223;541;370;365;228;137
4;20903;20900;59-223;288;216;213;143;70
5;20903;20900;59-223;348;203;201;120;81
6;20903;20900;59-223;346;253;248;144;104
1;20904;20900;59-216;282;209;207;112;95
2;20904;20900;59-216;1507;1128;1112;440;672
3;20904;20900;59-216;643;414;414;222;192
4;20904;20900;59-216;1151;905;903;436;467
5;20904;20900;59-216;425;349;340;169;171
6;20904;20900;59-216;263;177;177;100;77
7;20904;20900;59-216;363;293;290;147;143
8;20904;20900;59-216;241;165;164;105;59
9;20904;20900;59-216;302;218;217;125;92
10;20904;20900;59-216;514;425;421;165;256
1;20905;20900;59-241;890;646;638;349;289
2;20905;20900;59-241;408;275;272;180;92
3;20905;20900;59-241;685;524;518;318;200
4;20905;20900;59-241;463;341;337;226;111
5;20905;20900;59-241;504;342;338;194;144
6;20905;20900;59-241;364;247;243;132;111
7;20905;20900;59-241;239;183;183;104;79
8;20905;20900;59-241;251;177;175;128;47
9;20905;20900;59-241;35;21;21;12;9
1;20906;20900;59-222;764;568;562;269;293
2;20906;20900;59-222;591;441;439;235;204
3;20906;20900;59-222;524;353;353;216;137
4;20906;20900;59-222;1374;909;902;512;390
5;20906;20900;59-222;815;583;581;279;302
6;20906;20900;59-222;563;409;406;253;153
7;20906;20900;59-222;455;342;341;204;137
8;20906;20900;59-222;390;298;298;151;147
1;20907;20900;59-230;1200;845;839;403;436
2;20907;20900;59-230;811;501;493;272;221
3;20907;20900;59-230;673;449;441;222;219
4;20907;20900;59-230;491;328;326;155;171
5;20907;20900;59-230;567;359;357;244;113
6;20907;20900;59-230;728;456;452;306;146
7;20907;20900;59-230;321;207;207;148;59
8;20907;20900;59-230;362;219;219;140;79
9;20907;20900;59-230;335;211;208;165;43
1;20908;20900;59-243;823;518;513;328;185
2;20908;20900;59-243;981;559;555;387;168
3;20908;20900;59-243;81;28;26;17;9
1;21001;21000;59-800;912;567;558;253;305
2;21001;21000;59-800;1059;657;656;285;371
3;21001;21000;59-800;972;650;647;267;380
4;21001;21000;59-800;729;468;467;212;255
5;21001;21000;59-800;824;525;523;234;289
6;21001;21000;59-800;971;643;641;230;411
7;21001;21000;59-800;857;537;534;241;293
8;21001;21000;59-800;864;560;552;238;314
9;21001;21000;59-800;975;565;558;255;303
10;21001;21000;59-800;1135;768;761;290;471
11;21001;21000;59-800;1144;788;783;301;482
12;21001;21000;59-800;1077;686;681;313;368
13;21001;21000;59-800;981;692;691;261;430
14;21001;21000;59-800;1031;718;707;296;411
15;21001;21000;59-800;1098;801;798;330;468
16;21001;21000;59-800;40;29;29;16;13
1;21002;21000;59-850;1289;1040;1032;393;639
2;21002;21000;59-850;938;675;669;264;405
3;21002;21000;59-850;787;506;506;170;336
4;21002;21000;59-850;732;461;458;226;232
5;21002;21000;59-850;14;14;13;8;5
1;21003;21000;59-820;1238;738;734;378;356
2;21003;21000;59-820;1365;890;887;391;496
3;21003;21000;59-820;678;397;389;179;210
4;21003;21000;59-814;1040;618;615;334;281
5;21003;21000;59-820;419;224;217;108;109
6;21003;21000;59-820;669;393;392;216;176
7;21003;21000;59-820;385;251;250;112;138
8;21003;21000;59-820;541;288;281;159;122
9;21003;21000;59-820;501;317;313;172;141
10;21003;21000;59-820;255;170;166;105;61
1;21004;21000;59-800;589;359;357;203;154
2;21004;21000;59-800;814;519;513;238;275
3;21004;21000;59-800;264;153;153;91;62
4;21004;21000;59-800;298;206;205;95;110
5;21004;21000;59-800;479;281;278;157;121
6;21004;21000;59-800;1169;732;724;366;358
7;21004;21000;59-800;795;489;484;226;258
8;21004;21000;59-800;495;378;377;149;228
1;21005;21000;59-830;1560;933;919;412;507
2;21005;21000;59-830;1652;1031;1022;467;555
3;21005;21000;59-830;963;634;625;321;304
4;21005;21000;59-830;359;207;206;132;74
5;21005;21000;59-830;229;138;137;56;81
1;21006;21000;59-816;653;406;401;237;164
2;21006;21000;59-816;541;354;350;214;136
1;21007;21000;59-818;1504;1027;1022;539;483
2;21007;21000;59-800;1472;993;979;501;478
3;21007;21000;59-818;364;258;257;171;86
4;21007;21000;59-800;429;240;240;74;166
1;21101;21100;59-300;729;478;472;252;220
2;21101;21100;59-300;441;310;309;151;158
3;21101;21100;59-300;1100;646;641;383;258
4;21101;21100;59-300;1174;711;708;422;286
5;21101;21100;59-300;877;549;537;282;255
6;21101;21100;59-300;706;447;446;256;190
7;21101;21100;59-300;1022;674;670;377;293
8;21101;21100;59-300;1014;688;681;408;273
9;21101;21100;59-300;1004;611;588;304;284
10;21101;21100;59-300;1185;804;796;445;351
11;21101;21100;59-300;938;606;601;331;270
12;21101;21100;59-300;1228;834;825;449;376
13;21101;21100;59-300;1015;679;676;363;313
14;21101;21100;59-300;1209;858;854;405;449
15;21101;21100;59-300;1230;851;846;415;431
16;21101;21100;59-300;1228;857;846;435;411
17;21101;21100;59-300;932;637;634;314;320
18;21101;21100;59-300;1222;873;871;481;390
19;21101;21100;59-300;955;691;686;349;337
20;21101;21100;59-300;935;654;646;346;300
21;21101;21100;59-300;1006;736;728;404;324
22;21101;21100;59-300;1665;1331;1321;616;705
23;21101;21100;59-300;933;675;673;388;285
24;21101;21100;59-300;967;706;696;395;301
25;21101;21100;59-300;1746;1339;1335;626;709
26;21101;21100;59-300;1146;782;779;374;405
27;21101;21100;59-300;1061;796;789;379;410
28;21101;21100;59-300;1159;837;824;357;467
29;21101;21100;59-311;714;535;534;289;245
30;21101;21100;59-300;1030;813;807;379;428
31;21101;21100;59-300;999;745;742;357;385
32;21101;21100;59-300;918;655;651;331;320
33;21101;21100;59-300;727;450;448;204;244
34;21101;21100;59-300;1381;1031;1024;547;477
35;21101;21100;59-300;1047;775;766;434;332
36;21101;21100;59-300;1093;782;772;408;364
37;21101;21100;59-300;1131;816;807;446;361
38;21101;21100;59-300;1275;905;897;492;405
39;21101;21100;59-300;1197;855;850;478;372
40;21101;21100;59-300;1447;1106;1099;530;569
41;21101;21100;59-300;1170;845;841;461;380
42;21101;21100;59-300;1108;824;820;463;357
43;21101;21100;59-300;794;577;573;315;258
44;21101;21100;59-300;816;574;572;321;251
45;21101;21100;59-300;796;608;600;298;302
46;21101;21100;59-300;892;660;656;312;344
47;21101;21100;59-300;1431;1082;1070;552;518
48;21101;21100;59-300;68;55;55;29;26
49;21101;21100;59-300;44;15;15;8;7
50;21101;21100;59-300;113;56;55;31;24
51;21101;21100;59-300;33;33;31;24;7
1;21102;21100;59-311;724;564;558;276;282
2;21102;21100;59-300;570;391;388;280;108
3;21102;21100;59-307;1213;907;903;469;434
4;21102;21100;59-335;1524;1202;1188;595;593
5;21102;21100;59-323;816;578;575;393;182
6;21102;21100;59-323;842;627;623;386;237
7;21102;21100;59-335;1002;730;724;428;296
8;21102;21100;59-307;256;200;197;108;89
9;21102;21100;59-311;799;643;633;337;296
10;21102;21100;59-300;1637;1341;1332;601;731
11;21102;21100;59-323;846;620;612;375;237
12;21102;21100;59-300;244;195;189;89;100
13;21102;21100;59-300;291;213;212;156;56
14;21102;21100;59-300;485;313;311;193;118
15;21102;21100;59-300;344;256;255;140;115
16;21102;21100;59-307;456;294;292;165;127
17;21102;21100;59-300;832;655;652;345;307
18;21102;21100;59-300;570;475;472;221;251
1;21103;21100;59-305;738;492;486;330;156
2;21103;21100;59-305;760;550;544;357;187
3;21103;21100;59-305;732;521;518;331;187
4;21103;21100;59-305;493;317;315;183;132
5;21103;21100;59-305;341;251;251;189;62
6;21103;21100;59-305;376;240;233;156;77
7;21103;21100;59-305;489;357;356;192;164
8;21103;21100;59-305;391;292;291;197;94
9;21103;21100;59-305;309;256;255;121;134
10;21103;21100;59-305;238;154;152;107;45
11;21103;21100;59-305;341;209;208;169;39
12;21103;21100;59-305;284;202;200;149;51
13;21103;21100;59-305;307;212;210;153;57
1;21104;21100;59-330;1139;817;814;492;322
2;21104;21100;59-330;1529;1060;1050;638;412
3;21104;21100;59-330;1280;876;865;556;309
4;21104;21100;59-330;763;495;492;393;99
5;21104;21100;59-330;241;162;162;107;55
6;21104;21100;59-330;418;269;267;165;102
7;21104;21100;59-330;377;244;241;181;60
8;21104;21100;59-330;678;443;442;365;77
9;21104;21100;59-330;228;151;151;127;24
10;21104;21100;59-330;189;130;130;83;47
11;21104;21100;59-330;327;200;199;168;31
12;21104;21100;59-330;16;11;11;7;4
1;21201;21200;59-620;907;577;570;235;335
2;21201;21200;59-620;1083;704;694;269;425
3;21201;21200;59-620;1369;859;848;331;517
4;21201;21200;59-620;1220;669;667;307;360
5;21201;21200;59-620;414;254;253;159;94
6;21201;21200;59-620;906;607;605;388;217
7;21201;21200;59-620;242;144;144;91;53
8;21201;21200;59-620;224;137;137;66;71
9;21201;21200;59-620;214;138;136;65;71
10;21201;21200;59-620;283;186;181;80;101
11;21201;21200;59-620;18;18;18;10;8
1;21202;21200;59-623;1457;868;862;438;424
2;21202;21200;59-623;649;371;364;167;197
3;21202;21200;59-623;498;313;312;184;128
4;21202;21200;59-623;616;372;366;196;170
5;21202;21200;59-623;359;220;220;104;116
6;21202;21200;59-623;389;227;227;138;89
7;21202;21200;59-623;173;101;101;49;52
8;21202;21200;59-623;171;115;113;55;58
9;21202;21200;59-623;107;87;85;40;45
1;21203;21200;59-600;1453;948;937;414;523
2;21203;21200;59-600;732;489;488;182;306
3;21203;21200;59-600;821;548;546;213;333
4;21203;21200;59-600;776;510;510;201;309
5;21203;21200;59-600;1643;1154;1146;438;708
6;21203;21200;59-600;751;496;490;205;285
7;21203;21200;59-600;830;498;493;282;211
8;21203;21200;59-600;810;488;487;311;176
9;21203;21200;59-600;712;396;396;239;157
10;21203;21200;59-600;430;292;291;175;116
11;21203;21200;59-600;784;427;418;259;159
12;21203;21200;59-600;436;239;237;149;88
13;21203;21200;59-600;869;566;560;276;284
14;21203;21200;59-600;282;219;219;87;132
15;21203;21200;59-600;497;318;311;201;110
16;21203;21200;59-600;435;260;259;134;125
17;21203;21200;59-600;8;7;7;2;5
1;21204;21200;59-630;1604;997;987;480;507
2;21204;21200;59-630;1582;948;940;421;519
3;21204;21200;59-630;927;528;521;290;231
4;21204;21200;59-630;451;275;274;128;146
5;21204;21200;59-630;1663;1006;998;444;554
6;21204;21200;59-630;73;54;48;17;31
1;21205;21200;59-610;1266;806;803;384;419
2;21205;21200;59-610;344;203;203;100;103
3;21205;21200;59-610;579;386;384;159;225
4;21205;21200;59-610;417;243;241;116;125
5;21205;21200;59-610;197;104;103;52;51
6;21205;21200;59-610;260;153;150;92;58
7;21205;21200;59-610;44;40;40;25;15
8;21205;21200;59-610;43;19;19;15;4
1;21301;21300;56-330;2151;1473;1457;881;576
2;21301;21300;56-330;458;310;304;212;92
3;21301;21300;56-330;955;630;623;348;275
1;21302;21300;56-320;1509;1001;988;514;474
2;21302;21300;56-321;2103;1377;1374;897;477
3;21302;21300;56-320;937;594;589;396;193
4;21302;21300;56-320;1016;605;599;371;228
5;21302;21300;56-320;512;309;309;177;132
6;21302;21300;56-320;76;42;40;27;13
1;21303;21300;56-300;1759;1072;1063;525;538
2;21303;21300;56-300;2493;1737;1725;692;1033
3;21303;21300;56-300;809;621;618;231;387
4;21303;21300;56-300;2054;1355;1346;604;742
5;21303;21300;56-300;1113;806;801;376;425
6;21303;21300;56-300;373;228;225;156;69
7;21303;21300;56-300;469;290;289;138;151
8;21303;21300;56-300;625;396;394;255;139
9;21303;21300;56-300;403;238;237;167;70
10;21303;21300;56-300;619;362;357;242;115
11;21303;21300;56-300;348;235;233;143;90
12;21303;21300;56-300;607;404;400;197;203
13;21303;21300;56-300;318;197;196;141;55
14;21303;21300;56-300;1422;938;936;559;377
15;21303;21300;56-300;851;571;566;262;304
16;21303;21300;56-300;270;147;145;111;34
17;21303;21300;56-300;364;230;227;142;85
18;21303;21300;56-300;371;221;216;123;93
19;21303;21300;56-300;301;159;155;112;43
20;21303;21300;56-300;213;153;149;90;59
21;21303;21300;56-300;246;174;174;111;63
22;21303;21300;56-300;225;116;115;63;52
23;21303;21300;56-300;357;231;231;140;91
24;21303;21300;56-300;181;140;140;78;62
25;21303;21300;56-300;298;210;207;120;87
26;21303;21300;56-300;350;245;241;135;106
27;21303;21300;56-300;327;222;222;128;94
28;21303;21300;56-300;135;77;77;43;34
1;21401;21400;56-400;1185;862;853;352;501
2;21401;21400;56-400;990;637;629;299;330
3;21401;21400;56-400;1116;722;714;318;396
4;21401;21400;56-400;1282;864;854;383;471
5;21401;21400;56-400;1198;812;799;390;409
6;21401;21400;56-400;1169;761;754;364;390
7;21401;21400;56-400;1050;753;747;347;400
8;21401;21400;56-400;1177;821;819;335;484
9;21401;21400;56-400;1030;727;724;351;373
10;21401;21400;56-400;1335;909;905;365;540
11;21401;21400;56-400;1311;899;892;416;476
12;21401;21400;56-400;1230;920;918;350;568
13;21401;21400;56-400;1285;932;920;366;554
14;21401;21400;56-400;1592;1189;1183;461;722
15;21401;21400;56-400;1375;1028;1023;390;633
16;21401;21400;56-400;1535;1115;1101;432;669
17;21401;21400;56-400;1132;880;874;332;542
18;21401;21400;56-400;1175;784;775;380;395
19;21401;21400;56-400;1471;1107;1100;406;694
20;21401;21400;56-400;1353;1033;1026;391;635
21;21401;21400;56-400;1418;1063;1052;405;647
22;21401;21400;56-400;63;37;37;17;20
23;21401;21400;56-400;149;134;134;30;104
1;21402;21400;56-420;1985;1362;1352;650;702
2;21402;21400;56-420;1447;937;930;517;413
3;21402;21400;56-420;295;193;189;125;64
4;21402;21400;56-420;572;372;369;240;129
5;21402;21400;56-420;354;212;208;132;76
6;21402;21400;56-420;364;239;237;145;92
7;21402;21400;56-420;177;113;112;82;30
8;21402;21400;56-420;282;180;177;113;64
9;21402;21400;56-420;161;100;99;57;42
10;21402;21400;56-420;371;254;252;126;126
11;21402;21400;56-420;169;117;117;56;61
12;21402;21400;56-420;354;188;186;110;76
13;21402;21400;56-420;391;250;247;169;78
14;21402;21400;56-420;224;157;153;107;46
1;21403;21400;56-410;1538;1128;1123;551;572
2;21403;21400;56-410;1537;1121;1107;531;576
3;21403;21400;56-410;1324;950;945;545;400
4;21403;21400;56-410;1213;796;789;459;330
1;21404;21400;56-504;1352;861;856;408;448
2;21404;21400;56-504;1202;752;748;442;306
3;21404;21400;56-504;873;561;556;336;220
1;21405;21400;56-513;838;526;518;235;283
2;21405;21400;56-513;930;588;578;275;303
3;21405;21400;56-513;663;354;351;204;147
4;21405;21400;56-513;893;538;530;276;254
5;21405;21400;56-513;254;160;158;91;67
6;21405;21400;56-513;307;188;183;110;73
1;21406;21400;56-400;761;545;542;242;300
2;21406;21400;56-400;1455;1063;1050;594;456
3;21406;21400;56-400;1531;1057;1050;596;454
4;21406;21400;56-400;519;312;311;143;168
5;21406;21400;56-400;957;637;631;331;300
6;21406;21400;56-400;1535;1037;1033;557;476
7;21406;21400;56-400;1938;1402;1394;574;820
8;21406;21400;56-400;1244;938;931;487;444
9;21406;21400;56-400;664;540;536;186;350
10;21406;21400;56-400;572;345;334;162;172
11;21406;21400;56-400;573;396;396;212;184
1;21407;21400;56-500;1902;1338;1325;545;780
2;21407;21400;56-500;1675;1077;1067;479;588
3;21407;21400;56-500;1627;1172;1167;421;746
4;21407;21400;56-500;1652;1113;1101;432;669
5;21407;21400;56-500;905;556;554;264;290
6;21407;21400;56-500;367;223;223;115;108
7;21407;21400;56-500;931;594;592;289;303
8;21407;21400;56-500;1099;693;687;279;408
9;21407;21400;56-500;447;308;306;150;156
10;21407;21400;56-500;928;696;693;255;438
11;21407;21400;56-500;513;313;312;173;139
12;21407;21400;56-500;252;191;190;81;109
13;21407;21400;56-500;321;197;197;102;95
14;21407;21400;56-500;103;40;39;18;21
1;21408;21400;56-416;1904;1329;1315;659;656
2;21408;21400;56-416;1730;1125;1119;582;537
3;21408;21400;56-416;1930;1305;1298;605;693
4;21408;21400;56-416;1483;879;866;460;406
5;21408;21400;56-416;1783;1165;1151;701;450
6;21408;21400;56-416;757;452;444;232;212
1;21501;21500;55-200;1128;813;812;383;429
2;21501;21500;55-200;1225;872;863;393;470
3;21501;21500;55-200;1357;947;941;429;512
4;21501;21500;55-200;833;570;564;276;288
5;21501;21500;55-200;832;558;553;235;318
6;21501;21500;55-200;1632;1142;1135;521;614
7;21501;21500;55-200;1053;753;747;352;395
8;21501;21500;55-200;1800;1260;1254;566;688
9;21501;21500;55-200;1404;955;943;444;499
10;21501;21500;55-200;1632;1031;1025;497;528
11;21501;21500;55-200;1514;1131;1125;495;630
12;21501;21500;55-200;846;654;650;268;382
13;21501;21500;55-200;1971;1549;1539;608;931
14;21501;21500;55-200;2464;1960;1942;688;1254
15;21501;21500;55-200;1836;1398;1389;599;790
16;21501;21500;55-200;1198;827;822;373;449
17;21501;21500;55-200;1263;903;896;423;473
18;21501;21500;55-200;58;32;31;15;16
19;21501;21500;55-200;102;44;41;20;21
1;21502;21500;55-216;326;230;227;140;87
2;21502;21500;55-216;304;227;227;133;94
3;21502;21500;55-216;157;119;118;65;53
4;21502;21500;55-216;240;153;152;95;57
5;21502;21500;55-216;400;290;286;177;109
6;21502;21500;55-216;357;237;236;153;83
7;21502;21500;55-216;298;213;211;136;75
8;21502;21500;55-216;536;343;339;205;134
9;21502;21500;55-216;278;177;177;128;49
10;21502;21500;55-216;324;231;230;133;97
11;21502;21500;55-216;158;101;98;67;31
12;21502;21500;55-216;160;100;100;72;28
13;21502;21500;55-216;219;144;143;79;64
14;21502;21500;55-216;214;145;144;88;56
1;21503;21500;55-220;641;425;419;295;124
2;21503;21500;55-220;557;342;341;202;139
3;21503;21500;55-220;1193;794;786;520;266
4;21503;21500;55-220;1621;1229;1220;595;625
5;21503;21500;55-220;2466;1859;1841;791;1050
6;21503;21500;55-220;815;447;444;227;217
7;21503;21500;55-220;775;584;580;283;297
8;21503;21500;55-220;1980;1434;1429;690;739
9;21503;21500;55-220;2049;1580;1569;729;840
10;21503;21500;55-220;1504;1108;1095;558;537
11;21503;21500;55-220;1604;1119;1113;603;510
12;21503;21500;55-220;1538;1107;1100;590;510
13;21503;21500;55-220;741;519;518;290;228
1;21504;21500;55-200;1904;1393;1375;673;702
2;21504;21500;55-200;1621;1320;1315;582;733
3;21504;21500;55-200;571;387;381;245;136
4;21504;21500;55-200;784;526;520;399;121
5;21504;21500;55-200;778;502;498;299;199
6;21504;21500;55-200;662;440;436;270;166
7;21504;21500;55-200;681;501;493;249;244
8;21504;21500;55-200;659;511;505;257;248
9;21504;21500;55-200;1065;859;848;343;505
10;21504;21500;55-200;503;356;353;217;136
11;21504;21500;55-200;582;369;367;229;138
12;21504;21500;55-200;727;486;483;327;156
13;21504;21500;55-200;955;710;701;443;258
14;21504;21500;55-200;275;200;198;130;68
15;21504;21500;55-200;175;144;143;92;51
1;21601;21600;59-140;1368;963;958;550;408
2;21601;21600;59-140;597;434;433;273;160
3;21601;21600;59-140;1150;713;706;459;247
4;21601;21600;59-140;1144;712;710;473;237
5;21601;21600;59-140;1210;885;871;540;331
6;21601;21600;59-140;400;292;286;194;92
7;21601;21600;59-140;524;353;351;248;103
8;21601;21600;59-140;763;550;547;469;78
9;21601;21600;59-140;772;598;593;421;172
10;21601;21600;59-140;681;465;461;332;129
11;21601;21600;59-140;697;490;487;366;121
1;21602;21600;59-180;1397;985;975;655;320
2;21602;21600;59-180;413;298;296;211;85
3;21602;21600;59-180;455;309;308;200;108
4;21602;21600;59-180;312;197;196;138;58
5;21602;21600;59-180;233;149;147;116;31
1;21603;21600;59-150;1241;863;858;537;321
2;21603;21600;59-150;888;510;509;350;159
3;21603;21600;59-150;813;537;535;379;156
4;21603;21600;59-150;604;400;394;251;143
5;21603;21600;59-150;225;146;146;110;36
6;21603;21600;59-150;319;224;223;173;50
1;21604;21600;59-100;954;570;566;344;222
2;21604;21600;59-100;971;626;614;288;326
3;21604;21600;59-100;1732;1159;1147;662;485
4;21604;21600;59-100;1273;822;817;487;330
5;21604;21600;59-100;1195;785;780;431;349
6;21604;21600;59-100;1480;943;940;546;394
7;21604;21600;59-100;2462;1841;1822;954;868
8;21604;21600;59-100;947;697;692;394;298
9;21604;21600;59-100;1162;838;828;439;389
10;21604;21600;59-100;1885;1305;1297;790;507
11;21604;21600;59-100;1040;797;786;374;412
12;21604;21600;59-101;1034;717;710;402;308
13;21604;21600;59-101;722;501;499;366;133
14;21604;21600;59-101;442;276;275;209;66
15;21604;21600;59-101;742;553;548;411;137
16;21604;21600;59-101;1071;848;835;517;318
1;21605;21600;59-170;798;531;525;302;223
2;21605;21600;59-170;1166;742;738;472;266
3;21605;21600;59-170;278;194;193;116;77
4;21605;21600;59-170;479;285;283;172;111
5;21605;21600;59-170;378;249;244;175;69
6;21605;21600;59-170;1040;620;615;382;233
7;21605;21600;59-170;1258;819;808;479;329
8;21605;21600;59-170;163;111;107;68;39
9;21605;21600;59-170;316;216;215;173;42
1;21606;21600;59-160;2097;1517;1506;933;573
2;21606;21600;59-160;628;380;379;246;133
3;21606;21600;59-160;316;241;239;158;81
4;21606;21600;59-160;369;251;247;158;89
5;21606;21600;59-160;461;302;302;192;110
1;21701;21700;57-160;1345;984;976;596;380
2;21701;21700;57-160;1224;854;848;556;292
3;21701;21700;57-160;836;580;578;419;159
4;21701;21700;57-160;595;383;381;251;130
1;21702;21700;57-150;664;436;433;309;124
2;21702;21700;57-150;530;362;358;208;150
3;21702;21700;57-150;385;224;221;129;92
4;21702;21700;57-150;347;237;232;151;81
5;21702;21700;57-150;514;314;313;205;108
6;21702;21700;57-150;284;175;172;107;65
7;21702;21700;57-150;486;322;320;206;114
1;21703;21700;57-130;903;622;617;381;236
2;21703;21700;57-130;553;380;379;210;169
3;21703;21700;57-130;437;298;297;171;126
4;21703;21700;57-130;300;208;206;148;58
5;21703;21700;57-130;652;395;392;287;105
6;21703;21700;57-130;222;138;138;90;48
7;21703;21700;57-130;168;122;120;82;38
8;21703;21700;57-130;218;154;154;120;34
9;21703;21700;57-130;159;86;84;68;16
1;21704;21700;57-100;1340;900;892;434;458
2;21704;21700;57-100;1394;959;951;397;554
3;21704;21700;57-100;1427;1023;1016;446;570
4;21704;21700;57-100;1386;926;919;417;502
5;21704;21700;57-100;1114;807;801;301;500
6;21704;21700;57-100;1268;856;850;370;480
7;21704;21700;57-100;1267;877;870;421;449
8;21704;21700;57-100;501;337;335;154;181
9;21704;21700;57-100;586;396;390;192;198
10;21704;21700;57-100;750;538;535;326;209
11;21704;21700;57-100;1037;749;740;419;321
12;21704;21700;57-100;589;366;362;248;114
13;21704;21700;57-100;658;404;398;254;144
14;21704;21700;57-100;325;208;208;122;86
15;21704;21700;57-100;658;466;462;250;212
16;21704;21700;57-100;708;563;557;215;342
17;21704;21700;57-100;333;238;236;168;68
18;21704;21700;57-100;472;346;345;191;154
19;21704;21700;57-100;230;166;165;95;70
20;21704;21700;57-100;509;388;384;205;179
21;21704;21700;57-100;100;30;29;13;16
22;21704;21700;57-100;670;487;480;52;428
1;21705;21700;57-120;1715;1124;1113;665;448
2;21705;21700;57-120;779;546;538;396;142
3;21705;21700;57-120;712;469;467;352;115
4;21705;21700;57-120;631;394;392;256;136
5;21705;21700;57-120;559;379;378;265;113
6;21705;21700;57-120;331;230;228;164;64
7;21705;21700;57-120;288;184;182;123;59
8;21705;21700;57-120;355;235;230;156;74
1;21801;21800;55-311;1282;899;888;514;374
2;21801;21800;55-311;458;301;292;225;67
3;21801;21800;55-311;999;702;696;420;276
4;21801;21800;55-311;957;600;596;381;215
5;21801;21800;55-311;347;256;251;195;56
6;21801;21800;55-311;1044;627;621;406;215
7;21801;21800;55-311;402;311;306;152;154
1;21802;21800;55-320;1182;771;760;441;319
2;21802;21800;55-320;1123;770;763;459;304
3;21802;21800;55-320;396;286;281;149;132
4;21802;21800;55-320;416;255;255;151;104
5;21802;21800;55-320;316;215;213;147;66
6;21802;21800;55-320;263;185;184;127;57
7;21802;21800;55-320;306;193;192;114;78
8;21802;21800;55-320;348;234;230;140;90
1;21803;21800;55-330;1738;1296;1290;586;704
2;21803;21800;55-330;1020;777;762;305;457
3;21803;21800;55-330;1629;1268;1257;442;815
4;21803;21800;55-330;2117;1765;1747;685;1062
5;21803;21800;55-330;442;290;289;151;138
6;21803;21800;55-330;2232;1890;1881;679;1202
7;21803;21800;55-330;770;473;469;266;203
8;21803;21800;55-330;1155;846;840;380;460
9;21803;21800;55-330;938;637;629;315;314
10;21803;21800;55-330;1039;856;849;335;514
11;21803;21800;55-330;699;510;509;274;235
12;21803;21800;55-330;1341;1032;1014;449;565
13;21803;21800;55-330;554;426;420;256;164
1;21804;21800;55-300;1081;813;803;337;466
2;21804;21800;55-300;994;695;693;308;385
3;21804;21800;55-300;1163;805;800;369;431
4;21804;21800;55-300;988;681;670;302;368
5;21804;21800;55-300;826;510;509;253;256
6;21804;21800;55-300;902;638;636;250;386
7;21804;21800;55-300;1027;794;791;292;499
8;21804;21800;55-300;263;153;149;101;48
9;21804;21800;55-300;261;161;160;72;88
10;21804;21800;55-300;1409;986;975;549;426
11;21804;21800;55-300;292;218;215;154;61
12;21804;21800;55-300;1184;783;780;413;367
13;21804;21800;55-300;407;258;255;161;94
14;21804;21800;55-300;207;159;157;79;78
15;21804;21800;55-300;363;248;248;158;90
16;21804;21800;55-300;611;416;414;244;170
17;21804;21800;55-300;359;216;214;110;104
18;21804;21800;55-300;200;123;123;82;41
19;21804;21800;55-300;329;223;221;135;86
20;21804;21800;55-300;266;193;192;111;81
21;21804;21800;55-300;315;224;221;113;108
22;21804;21800;55-300;342;240;238;135;103
23;21804;21800;55-300;172;126;125;92;33
24;21804;21800;55-300;253;188;187;146;41
25;21804;21800;55-300;275;172;172;102;70
26;21804;21800;55-300;218;141;139;86;53
27;21804;21800;55-300;246;172;171;91;80
1;21805;21800;55-340;1209;820;806;509;297
2;21805;21800;55-340;1006;674;670;432;238
3;21805;21800;55-340;830;556;552;423;129
4;21805;21800;55-340;811;560;556;384;172
1;21901;21900;58-105;1610;1181;1167;403;764
2;21901;21900;58-100;1722;1279;1268;540;728
3;21901;21900;58-100;2182;1680;1664;626;1038
4;21901;21900;58-100;1612;1049;1038;427;611
5;21901;21900;58-100;1777;1157;1140;415;725
6;21901;21900;58-100;1602;1001;991;406;585
7;21901;21900;58-100;1543;1000;986;382;604
8;21901;21900;58-105;1458;1032;1024;430;594
9;21901;21900;58-105;1648;1135;1130;473;657
10;21901;21900;58-105;1618;1233;1221;483;738
11;21901;21900;58-105;1776;1293;1283;519;764
12;21901;21900;58-105;1851;1353;1341;518;823
13;21901;21900;58-100;1637;1197;1176;446;730
14;21901;21900;58-100;2062;1525;1504;537;967
15;21901;21900;58-100;1652;1287;1270;466;804
16;21901;21900;58-100;1705;1096;1080;426;654
17;21901;21900;58-100;1705;1114;1108;455;653
18;21901;21900;58-100;1651;1031;1019;461;558
19;21901;21900;58-100;1491;956;949;402;547
20;21901;21900;58-100;1648;1178;1166;485;681
21;21901;21900;58-100;1477;988;978;379;599
22;21901;21900;58-100;1587;1103;1092;433;659
23;21901;21900;58-100;2046;1564;1553;570;983
24;21901;21900;58-100;107;74;72;35;37
25;21901;21900;58-100;236;205;203;32;171
1;21902;21900;58-160;1068;764;761;257;504
2;21902;21900;58-160;1192;884;876;330;546
3;21902;21900;58-160;1001;765;756;299;457
4;21902;21900;58-160;782;547;544;230;314
5;21902;21900;58-160;859;651;647;202;445
6;21902;21900;58-160;1223;777;771;323;448
7;21902;21900;58-160;737;467;464;201;263
8;21902;21900;58-160;834;539;527;254;273
9;21902;21900;58-160;776;529;526;205;321
10;21902;21900;58-160;1183;696;691;405;286
11;21902;21900;58-160;1011;532;525;304;221
12;21902;21900;58-160;1245;808;802;344;458
13;21902;21900;58-160;1051;706;704;337;367
14;21902;21900;58-160;1626;1103;1088;465;623
15;21902;21900;58-160;1511;992;981;459;522
16;21902;21900;58-160;108;16;16;8;8
1;21903;21900;58-170;369;254;253;113;140
2;21903;21900;58-170;816;554;548;339;209
3;21903;21900;58-173;437;300;295;166;129
4;21903;21900;58-173;726;464;460;278;182
5;21903;21900;58-173;273;151;150;90;60
6;21903;21900;58-170;124;88;88;55;33
7;21903;21900;58-173;298;204;201;116;85
8;21903;21900;58-173;288;173;173;118;55
9;21903;21900;58-173;264;143;141;88;53
10;21903;21900;58-173;193;130;129;76;53
1;21904;21900;58-140;708;453;450;254;196
2;21904;21900;58-140;1117;653;650;319;331
3;21904;21900;58-140;1136;737;734;363;371
4;21904;21900;58-140;810;454;447;284;163
5;21904;21900;58-140;733;416;414;250;164
6;21904;21900;58-140;556;392;390;214;176
7;21904;21900;58-140;369;269;267;125;142
8;21904;21900;58-140;310;204;203;133;70
9;21904;21900;58-140;495;265;261;142;119
10;21904;21900;58-140;536;390;386;189;197
11;21904;21900;58-140;363;256;254;96;158
12;21904;21900;58-140;307;196;194;120;74
13;21904;21900;58-140;248;176;175;99;76
1;21905;21900;58-124;325;226;226;122;104
2;21905;21900;58-124;580;437;433;337;96
3;21905;21900;58-124;333;223;217;125;92
4;21905;21900;58-124;277;203;201;122;79
5;21905;21900;58-124;373;252;249;154;95
6;21905;21900;58-124;428;307;298;163;135
7;21905;21900;58-124;702;522;519;242;277
8;21905;21900;58-124;377;259;254;131;123
9;21905;21900;58-124;196;106;105;72;33
10;21905;21900;58-124;245;204;203;114;89
11;21905;21900;58-124;425;258;256;182;74
12;21905;21900;58-124;475;333;330;210;120
13;21905;21900;58-124;274;190;188;114;74
1;21906;21900;58-150;761;557;550;229;321
2;21906;21900;58-150;799;572;571;282;289
3;21906;21900;58-150;915;620;612;290;322
4;21906;21900;58-150;773;506;499;229;270
5;21906;21900;58-150;453;290;288;158;130
6;21906;21900;58-150;1163;832;820;382;438
7;21906;21900;58-150;1197;828;824;387;437
8;21906;21900;58-150;1138;688;681;292;389
9;21906;21900;58-150;893;561;558;259;299
10;21906;21900;58-150;639;425;424;218;206
11;21906;21900;58-150;924;598;592;306;286
12;21906;21900;58-150;844;595;594;300;294
13;21906;21900;58-150;813;461;456;276;180
14;21906;21900;58-152;914;617;613;382;231
15;21906;21900;58-120;597;367;363;219;144
16;21906;21900;58-120;267;171;170;116;54
17;21906;21900;58-120;754;508;498;311;187
18;21906;21900;58-150;201;143;141;75;66
19;21906;21900;58-150;500;329;327;190;137
20;21906;21900;58-150;467;286;284;171;113
21;21906;21900;58-152;488;294;293;153;140
22;21906;21900;58-150;214;158;157;105;52
23;21906;21900;58-150;368;237;236;154;82
24;21906;21900;58-141;725;474;469;285;184
25;21906;21900;58-141;791;518;515;302;213
26;21906;21900;58-150;160;110;106;67;39
27;21906;21900;58-150;180;86;86;52;34
28;21906;21900;58-150;256;162;161;99;62
29;21906;21900;58-150;228;153;150;97;53
1;21907;21900;58-114;1002;694;691;309;382
2;21907;21900;58-111;697;459;456;236;220
3;21907;21900;58-112;941;674;662;351;311
4;21907;21900;58-113;862;523;522;340;182
5;21907;21900;58-160;783;515;512;266;246
6;21907;21900;58-100;803;535;534;244;290
7;21907;21900;58-125;1536;1123;1116;462;654
8;21907;21900;58-100;886;653;648;242;406
9;21907;21900;58-125;355;243;243;119;124
10;21907;21900;58-100;1296;884;874;413;461
11;21907;21900;58-114;1169;889;881;412;469
12;21907;21900;58-112;781;563;559;236;323
13;21907;21900;58-113;787;506;498;280;218
14;21907;21900;58-125;483;320;318;135;183
15;21907;21900;58-100;607;427;423;204;219
16;21907;21900;58-100;456;323;316;157;159
1;21908;21900;58-130;608;445;444;191;253
2;21908;21900;58-130;494;365;363;143;220
3;21908;21900;58-130;547;356;355;137;218
4;21908;21900;58-130;809;561;558;237;321
5;21908;21900;58-130;1091;641;635;343;292
6;21908;21900;58-130;1262;762;753;423;330
7;21908;21900;58-115;428;289;288;186;102
8;21908;21900;58-130;738;443;441;217;224
9;21908;21900;58-130;965;660;654;329;325
10;21908;21900;58-130;679;449;445;289;156
11;21908;21900;58-130;644;397;390;238;152
12;21908;21900;58-130;350;272;269;134;135
13;21908;21900;58-130;312;214;213;133;80
14;21908;21900;58-130;194;144;141;105;36
15;21908;21900;58-130;91;65;58;33;25
1;22001;22000;55-120;943;675;667;302;365
2;22001;22000;55-120;1137;853;839;342;497
3;22001;22000;55-120;1107;869;859;365;494
4;22001;22000;55-120;1311;1047;1031;346;685
5;22001;22000;55-120;1079;822;816;331;485
6;22001;22000;55-120;1148;841;832;307;525
7;22001;22000;55-120;1278;924;911;477;434
8;22001;22000;55-120;715;490;489;237;252
9;22001;22000;55-120;935;769;762;467;295
10;22001;22000;55-120;540;409;407;204;203
11;22001;22000;55-120;767;564;557;254;303
12;22001;22000;55-120;1059;775;768;321;447
13;22001;22000;55-120;730;586;576;229;347
14;22001;22000;55-120;377;279;278;164;114
15;22001;22000;55-120;342;250;247;155;92
16;22001;22000;55-120;318;236;234;130;104
17;22001;22000;55-120;650;520;517;228;289
18;22001;22000;55-120;799;572;570;308;262
19;22001;22000;55-120;370;276;275;144;131
20;22001;22000;55-120;284;222;221;132;89
21;22001;22000;55-120;87;28;28;15;13
22;22001;22000;55-120;76;26;26;16;10
23;22001;22000;55-120;30;13;13;6;7
24;22001;22000;55-120;40;8;8;5;3
25;22001;22000;55-120;34;7;7;2;5
1;22002;22000;55-110;1624;1054;1042;598;444
2;22002;22000;55-110;1378;967;962;577;385
3;22002;22000;55-110;615;410;401;310;91
4;22002;22000;55-110;314;205;204;130;74
5;22002;22000;55-110;351;241;241;179;62
6;22002;22000;55-110;283;201;194;146;48
7;22002;22000;55-110;310;224;223;157;66
8;22002;22000;55-110;603;401;399;270;129
9;22002;22000;55-110;312;217;216;134;82
10;22002;22000;55-110;368;257;253;140;113
11;22002;22000;55-110;422;271;267;174;93
12;22002;22000;55-110;357;245;243;124;119
13;22002;22000;55-110;292;207;205;134;71
1;22003;22000;55-100;415;292;288;169;119
2;22003;22000;55-100;1114;871;860;295;565
3;22003;22000;55-100;296;207;205;115;90
4;22003;22000;55-100;320;234;228;133;95
5;22003;22000;55-100;421;311;308;174;134
6;22003;22000;55-100;443;315;314;154;160
7;22003;22000;55-100;306;203;203;134;69
8;22003;22000;55-100;264;185;184;96;88
9;22003;22000;55-100;552;352;345;214;131
10;22003;22000;55-100;283;181;178;92;86
11;22003;22000;55-100;351;241;238;152;86
12;22003;22000;55-100;1319;1042;1033;444;589
13;22003;22000;55-100;1898;1448;1432;637;795
14;22003;22000;55-100;1218;958;949;438;511
15;22003;22000;55-100;783;581;578;254;324
16;22003;22000;55-100;1697;1261;1248;606;642
17;22003;22000;55-100;1925;1579;1564;643;921
18;22003;22000;55-100;1083;824;817;358;459
19;22003;22000;55-100;218;174;171;78;93
20;22003;22000;55-100;214;160;159;77;82
21;22003;22000;55-100;249;158;157;108;49
22;22003;22000;55-100;304;236;235;155;80
23;22003;22000;55-100;305;196;195;134;61
24;22003;22000;55-100;263;187;187;91;96
25;22003;22000;55-100;273;203;200;132;68
26;22003;22000;55-100;262;192;191;144;47
27;22003;22000;55-100;183;135;134;52;82
28;22003;22000;55-100;420;252;252;178;74
29;22003;22000;55-100;279;188;187;134;53
30;22003;22000;55-100;430;327;324;154;170
31;22003;22000;55-100;258;165;164;118;46
32;22003;22000;55-100;350;260;257;145;112
33;22003;22000;55-100;142;80;80;40;40
1;22004;22000;55-114;1086;818;805;405;400
2;22004;22000;51-180;923;741;729;339;390
3;22004;22000;55-114;785;524;521;292;229
4;22004;22000;55-114;536;431;430;190;240
5;22004;22000;55-114;1042;818;812;444;368
6;22004;22000;55-114;985;803;795;331;464
7;22004;22000;55-114;248;193;188;91;97
8;22004;22000;55-114;310;243;239;127;112
9;22004;22000;51-180;557;464;460;165;295
10;22004;22000;51-180;925;786;776;356;420
11;22004;22000;55-114;415;272;266;144;122
12;22004;22000;55-114;641;538;535;246;289
13;22004;22000;55-114;391;326;323;126;197
14;22004;22000;55-114;215;128;127;72;55
1;22005;22000;55-106;1736;1201;1191;591;600
2;22005;22000;55-106;1116;729;722;423;299
3;22005;22000;55-106;1121;721;713;393;320
4;22005;22000;55-106;361;229;225;144;81
5;22005;22000;55-106;366;263;260;166;94
1;22006;22000;55-140;1717;1158;1152;490;662
2;22006;22000;55-140;1546;1081;1071;527;544
3;22006;22000;55-140;1509;1019;1014;493;521
4;22006;22000;55-140;414;257;254;190;64
5;22006;22000;55-140;775;475;472;261;211
6;22006;22000;55-140;544;347;343;152;191
7;22006;22000;55-140;430;283;281;191;90
8;22006;22000;55-140;432;268;266;142;124
9;22006;22000;55-140;498;334;331;183;148
10;22006;22000;55-140;519;350;348;232;116
11;22006;22000;55-140;239;119;118;84;34
12;22006;22000;55-140;196;146;146;81;65
13;22006;22000;55-140;282;195;192;98;94
14;22006;22000;55-140;330;234;233;143;90
15;22006;22000;55-140;325;203;203;141;62
16;22006;22000;55-140;216;141;140;99;41
17;22006;22000;55-140;635;386;384;261;123
18;22006;22000;55-140;320;177;177;115;62
19;22006;22000;55-140;43;39;39;24;15
20;22006;22000;55-140;19;11;11;5;6
1;22101;22100;58-371;1501;941;935;320;615
2;22101;22100;58-371;1474;956;949;332;617
3;22101;22100;58-370;723;435;432;209;223
4;22101;22100;58-370;1506;802;793;321;472
5;22101;22100;58-370;1496;858;849;330;519
6;22101;22100;58-370;1366;746;734;346;388
7;22101;22100;58-372;1116;624;617;280;337
8;22101;22100;58-372;740;417;406;182;224
9;22101;22100;58-370;556;349;346;168;178
1;22102;22100;58-330;661;446;440;158;282
2;22102;22100;58-330;629;398;393;150;243
3;22102;22100;58-330;700;494;489;155;334
4;22102;22100;58-330;572;386;384;145;239
5;22102;22100;58-330;765;498;490;211;279
1;22103;22100;58-310;894;711;706;203;503
2;22103;22100;58-310;789;603;598;182;416
3;22103;22100;58-310;734;552;543;199;344
4;22103;22100;58-310;925;750;745;224;521
5;22103;22100;58-310;787;522;512;184;328
1;22104;22100;58-379;559;333;331;168;163
2;22104;22100;58-379;728;493;484;271;213
3;22104;22100;58-379;516;339;337;192;145
4;22104;22100;58-379;369;243;243;130;113
5;22104;22100;58-379;1168;830;819;397;422
6;22104;22100;58-379;421;290;284;153;131
1;22105;22100;58-340;1684;981;970;428;542
2;22105;22100;58-340;1785;1200;1185;471;714
3;22105;22100;58-340;1316;801;793;365;428
4;22105;22100;58-340;718;400;397;189;208
5;22105;22100;58-340;315;195;194;73;121
6;22105;22100;58-340;378;254;252;93;159
1;22106;22100;58-350;419;251;251;123;128
2;22106;22100;58-350;566;323;317;142;175
3;22106;22100;58-350;569;344;339;153;186
4;22106;22100;58-350;669;416;410;197;213
5;22106;22100;58-350;751;448;442;231;211
6;22106;22100;58-350;573;340;339;127;212
7;22106;22100;58-350;578;378;377;136;241
8;22106;22100;58-350;502;390;383;88;295
9;22106;22100;58-351;113;27;27;10;17
1;22107;22100;58-312;1032;724;721;304;417
2;22107;22100;58-312;338;241;240;116;124
3;22107;22100;58-311;757;510;499;196;303
4;22107;22100;58-371;284;176;175;93;82
5;22107;22100;58-312;385;230;230;126;104
6;22107;22100;58-311;276;182;181;72;109
7;22107;22100;58-160;243;177;176;107;69
1;22108;22100;58-320;810;460;456;241;215
2;22108;22100;58-320;843;479;473;212;261
3;22108;22100;58-321;824;553;547;249;298
4;22108;22100;58-321;680;475;470;198;272
5;22108;22100;58-308;1069;706;698;318;380
1;22201;22200;56-120;1836;1261;1256;538;718
2;22201;22200;56-120;1171;789;781;374;407
3;22201;22200;56-120;1569;1096;1088;523;565
4;22201;22200;56-120;1462;1072;1060;474;586
5;22201;22200;56-120;1088;836;826;377;449
6;22201;22200;56-120;464;305;303;215;88
7;22201;22200;56-120;517;351;346;171;175
8;22201;22200;56-120;1065;622;615;399;216
9;22201;22200;56-120;668;455;451;220;231
10;22201;22200;56-120;1647;1180;1171;543;628
11;22201;22200;56-120;602;450;441;166;275
12;22201;22200;56-120;21;15;14;9;5
1;22202;22200;56-160;1282;890;881;561;320
2;22202;22200;56-160;881;568;564;393;171
3;22202;22200;56-160;725;413;405;292;113
4;22202;22200;56-160;1415;904;897;668;229
5;22202;22200;56-160;345;232;229;157;72
6;22202;22200;56-160;589;382;380;296;84
7;22202;22200;56-160;267;167;166;116;50
8;22202;22200;56-160;259;163;160;117;43
9;22202;22200;56-160;415;260;257;190;67
1;22203;22200;56-100;2390;1680;1656;831;825
2;22203;22200;56-100;1187;729;723;383;340
3;22203;22200;56-100;2164;1521;1515;738;777
4;22203;22200;56-100;1470;1035;1027;479;548
5;22203;22200;56-100;1437;1022;1016;496;520
6;22203;22200;56-100;1206;768;763;362;401
7;22203;22200;56-100;432;296;291;200;91
8;22203;22200;56-100;1901;1222;1217;688;529
9;22203;22200;56-100;916;574;571;338;233
10;22203;22200;56-100;639;436;434;297;137
11;22203;22200;56-100;467;326;323;272;51
12;22203;22200;56-100;898;587;580;394;186
13;22203;22200;56-100;500;313;310;223;87
14;22203;22200;56-100;314;236;233;142;91
15;22203;22200;56-100;464;316;310;213;97
16;22203;22200;56-100;911;771;758;54;704
17;22203;22200;56-100;68;9;8;6;2
18;22203;22200;56-100;258;84;80;65;15
19;22203;22200;56-100;12;12;12;5;7
20;22203;22200;56-100;21;20;20;12;8
1;22301;22300;55-003;1998;1619;1604;652;952
2;22301;22300;55-002;2758;2246;2223;786;1437
3;22301;22300;55-003;2044;1746;1733;610;1123
4;22301;22300;55-003;2910;2345;2320;939;1381
5;22301;22300;55-003;913;683;672;358;314
6;22301;22300;55-002;1141;951;943;366;577
7;22301;22300;55-002;2790;2430;2415;710;1705
8;22301;22300;55-003;1450;1232;1219;428;791
9;22301;22300;55-003;871;660;652;271;381
1;22302;22300;55-095;1460;1156;1146;472;674
2;22302;22300;55-093;735;560;559;239;320
3;22302;22300;55-093;1539;1239;1224;493;731
4;22302;22300;55-093;2389;1995;1972;611;1361
5;22302;22300;55-095;854;602;598;435;163
6;22302;22300;55-095;989;769;763;378;385
7;22302;22300;55-095;1048;838;826;417;409
8;22302;22300;55-095;1082;868;863;373;490
9;22302;22300;55-095;866;605;598;383;215
10;22302;22300;55-095;2284;1926;1898;669;1229
11;22302;22300;55-095;1113;878;869;469;400
12;22302;22300;51-361;2405;2055;2036;642;1394
13;22302;22300;55-093;524;419;416;182;234
14;22302;22300;55-093;2074;1706;1692;530;1162
15;22302;22300;55-095;1254;976;969;439;530
16;22302;22300;55-093;328;220;218;107;111
17;22302;22300;51-217;584;484;480;162;318
18;22302;22300;55-093;1396;1191;1180;331;849
19;22302;22300;55-093;1315;1153;1145;339;806
20;22302;22300;55-093;432;318;314;171;143
21;22302;22300;55-095;241;193;189;62;127
22;22302;22300;55-095;331;245;244;155;89
23;22302;22300;55-093;299;217;215;97;118
24;22302;22300;55-093;264;207;205;98;107
25;22302;22300;55-093;358;270;262;146;116
26;22302;22300;55-093;486;407;404;167;237
27;22302;22300;55-095;1621;1355;1348;484;864
28;22302;22300;55-095;1303;1077;1069;328;741
29;22302;22300;51-361;512;424;419;150;269
30;22302;22300;55-093;16;16;16;8;8
1;22303;22300;55-065;1659;1261;1247;742;505
2;22303;22300;55-065;571;395;392;274;118
3;22303;22300;55-065;260;186;181;91;90
1;22304;22300;55-080;1681;1328;1322;560;762
2;22304;22300;55-080;1878;1489;1471;650;821
3;22304;22300;55-080;1397;1004;993;496;497
4;22304;22300;55-080;1876;1670;1655;391;1264
5;22304;22300;55-080;1670;1341;1334;460;874
6;22304;22300;55-080;1100;934;923;277;646
7;22304;22300;55-080;439;356;356;167;189
8;22304;22300;55-080;1302;1011;1005;448;557
9;22304;22300;55-080;1480;1111;1102;402;700
10;22304;22300;55-080;1139;770;762;462;300
11;22304;22300;55-080;1358;955;951;576;375
12;22304;22300;55-080;918;635;625;373;252
13;22304;22300;55-080;1817;1546;1531;458;1073
14;22304;22300;55-080;587;448;443;208;235
15;22304;22300;55-080;248;174;174;117;57
16;22304;22300;55-080;372;276;273;137;136
17;22304;22300;55-080;242;197;192;111;81
18;22304;22300;55-080;479;382;378;245;133
19;22304;22300;55-080;717;566;562;223;339
20;22304;22300;52-327;239;152;150;69;81
21;22304;22300;55-080;50;17;17;5;12
1;22305;22300;55-040;1916;1580;1567;435;1132
2;22305;22300;55-040;1729;1449;1437;449;988
3;22305;22300;55-040;474;350;346;157;189
4;22305;22300;55-040;1878;1462;1448;643;805
5;22305;22300;55-040;852;550;542;317;225
6;22305;22300;55-040;593;427;427;195;232
7;22305;22300;55-040;505;364;363;176;187
8;22305;22300;55-040;436;309;308;227;81
9;22305;22300;55-040;1083;878;870;356;514
10;22305;22300;52-200;1486;1239;1223;293;930
11;22305;22300;52-200;1600;1401;1399;327;1072
12;22305;22300;55-040;1062;897;891;212;679
13;22305;22300;55-040;794;658;653;180;473
14;22305;22300;55-040;448;342;336;143;193
15;22305;22300;55-040;273;234;229;67;162
16;22305;22300;55-040;213;152;151;91;60
17;22305;22300;55-040;253;181;179;91;88
18;22305;22300;55-040;340;296;292;97;195
19;22305;22300;55-040;380;284;283;159;124
20;22305;22300;55-040;257;183;181;106;75
21;22305;22300;55-040;234;176;175;114;61
22;22305;22300;55-040;454;385;383;140;243
1;22306;22300;55-081;341;257;256;142;114
2;22306;22300;55-081;349;251;249;139;110
3;22306;22300;55-081;404;293;290;129;161
4;22306;22300;55-081;466;314;311;180;131
5;22306;22300;55-081;547;390;390;223;167
6;22306;22300;55-081;451;317;309;165;144
7;22306;22300;55-081;405;276;272;158;114
8;22306;22300;55-081;64;31;30;20;10
1;22307;22300;55-050;2303;1676;1658;755;903
2;22307;22300;55-050;1554;1180;1171;469;702
3;22307;22300;55-050;1758;1265;1253;607;646
4;22307;22300;55-050;1017;679;671;436;235
5;22307;22300;55-050;1485;991;982;539;443
6;22307;22300;55-050;570;371;369;225;144
7;22307;22300;55-050;714;461;458;262;196
8;22307;22300;55-050;1000;763;759;404;355
1;22308;22300;55-010;645;503;495;208;287
2;22308;22300;55-010;802;638;634;266;368
3;22308;22300;55-010;1062;824;816;363;453
4;22308;22300;55-010;337;261;259;138;121
5;22308;22300;55-010;869;689;682;201;481
6;22308;22300;55-010;662;494;487;245;242
7;22308;22300;55-011;1905;1564;1541;529;1012
8;22308;22300;55-011;1049;812;806;358;448
9;22308;22300;55-011;1761;1396;1379;538;841
10;22308;22300;55-011;712;492;486;202;284
11;22308;22300;55-011;2035;1667;1652;588;1064
12;22308;22300;55-010;1314;1079;1067;394;673
13;22308;22300;55-010;1469;1180;1167;423;744
14;22308;22300;50-458;356;233;232;107;125
15;22308;22300;52-116;1538;1350;1332;363;969
16;22308;22300;55-010;1094;934;924;295;629
17;22308;22300;55-010;1679;1417;1402;531;871
18;22308;22300;55-010;321;224;219;113;106
19;22308;22300;52-116;301;254;252;84;168
20;22308;22300;55-010;516;428;422;180;242
1;22309;22300;55-020;794;596;592;321;271
2;22309;22300;55-020;612;404;397;233;164
3;22309;22300;55-020;774;541;534;303;231
4;22309;22300;55-020;981;790;787;231;556
5;22309;22300;55-020;362;277;272;108;164
6;22309;22300;55-020;773;579;576;225;351
7;22309;22300;52-200;1672;1410;1396;379;1017
8;22309;22300;55-020;359;289;285;85;200
9;22309;22300;55-020;638;436;431;269;162
10;22309;22300;55-020;518;328;326;197;129
11;22309;22300;55-020;1025;752;746;341;405
12;22309;22300;55-020;1308;1063;1055;426;629
1;22401;22400;57-256;918;572;562;272;290
2;22401;22400;57-256;1012;687;682;294;388
3;22401;22400;57-255;577;355;351;202;149
4;22401;22400;57-257;441;308;304;158;146
5;22401;22400;57-256;202;128;126;74;52
6;22401;22400;57-256;184;139;136;77;59
7;22401;22400;57-256;301;209;209;119;90
8;22401;22400;57-256;259;143;142;79;63
1;22402;22400;57-211;412;243;238;107;131
2;22402;22400;57-211;824;515;512;337;175
3;22402;22400;57-210;647;395;393;271;122
4;22402;22400;57-211;341;202;200;137;63
1;22403;22400;57-230;958;620;611;288;323
2;22403;22400;57-230;1068;651;646;353;293
3;22403;22400;57-230;390;249;247;129;118
4;22403;22400;57-230;375;212;207;115;92
5;22403;22400;57-220;347;202;199;135;64
6;22403;22400;57-230;466;292;289;179;110
7;22403;22400;57-230;465;288;288;183;105
8;22403;22400;57-230;642;436;433;191;242
9;22403;22400;57-230;942;625;621;290;331
10;22403;22400;57-230;308;184;182;100;82
1;22404;22400;57-214;775;470;457;285;172
2;22404;22400;58-262;750;403;402;209;193
3;22404;22400;57-208;657;415;412;277;135
4;22404;22400;57-215;879;544;538;237;301
5;22404;22400;57-213;692;402;399;228;171
6;22404;22400;57-213;225;139;139;91;48
1;22405;22400;57-200;456;239;238;151;87
2;22405;22400;57-200;883;507;501;240;261
3;22405;22400;57-200;673;385;384;197;187
4;22405;22400;57-200;892;468;461;248;213
5;22405;22400;57-200;726;491;484;214;270
6;22405;22400;57-200;728;488;484;208;276
7;22405;22400;57-200;688;447;444;193;251
8;22405;22400;57-200;731;486;483;224;259
9;22405;22400;57-200;636;458;454;170;284
10;22405;22400;57-200;689;457;456;203;253
11;22405;22400;57-200;1200;778;772;309;463
12;22405;22400;57-200;1028;715;713;334;379
13;22405;22400;57-200;1151;885;877;341;536
14;22405;22400;57-200;1001;625;624;394;230
15;22405;22400;57-200;352;210;208;134;74
16;22405;22400;57-200;965;628;617;373;244
17;22405;22400;57-200;913;600;596;328;268
18;22405;22400;57-200;438;273;268;152;116
19;22405;22400;57-200;455;282;279;198;81
20;22405;22400;57-200;889;601;595;321;274
21;22405;22400;57-200;114;63;57;25;32
22;22405;22400;57-200;10;9;9;4;5
23;22405;22400;57-200;14;10;9;3;6
1;22406;22400;57-220;786;515;510;266;244
2;22406;22400;57-220;936;608;606;327;279
3;22406;22400;57-220;796;484;483;269;214
4;22406;22400;57-220;732;474;473;243;230
5;22406;22400;57-220;752;455;449;242;207
6;22406;22400;57-220;1389;771;759;399;360
7;22406;22400;57-220;642;357;354;200;154
8;22406;22400;57-224;215;132;131;80;51
9;22406;22400;57-220;367;229;228;133;95
10;22406;22400;57-210;214;151;150;119;31
11;22406;22400;57-210;506;297;295;192;103
12;22406;22400;57-223;416;258;258;151;107
13;22406;22400;57-222;429;275;274;181;93
14;22406;22400;57-222;422;250;248;177;71
15;22406;22400;57-223;433;265;263;181;82
16;22406;22400;57-221;272;161;161;90;71
17;22406;22400;57-210;880;602;599;337;262
18;22406;22400;57-220;556;323;319;212;107
19;22406;22400;57-220;411;275;273;163;110
20;22406;22400;57-224;303;186;185;79;106
21;22406;22400;57-210;389;267;265;188;77
22;22406;22400;57-210;292;172;167;115;52
23;22406;22400;57-220;83;48;44;25;19
24;22406;22400;57-210;55;22;19;10;9
25;22406;22400;57-220;87;46;45;30;15
26;22406;22400;57-220;24;18;18;10;8
1;22407;22400;57-250;647;421;419;195;224
2;22407;22400;57-250;644;379;377;193;184
3;22407;22400;57-250;633;457;455;196;259
4;22407;22400;57-250;267;145;145;90;55
5;22407;22400;57-250;368;228;226;135;91
6;22407;22400;57-250;185;108;107;67;40
7;22407;22400;57-251;478;273;272;159;113
1;22501;22500;59-970;1440;914;906;445;461
2;22501;22500;59-970;1503;953;939;466;473
1;22502;22500;59-900;1822;1286;1280;509;771
2;22502;22500;59-900;1740;1207;1197;450;747
3;22502;22500;59-900;1532;1078;1072;408;664
4;22502;22500;59-900;1448;900;887;348;539
5;22502;22500;59-900;1287;860;854;395;459
6;22502;22500;59-900;1313;906;902;383;519
7;22502;22500;59-900;1223;788;783;324;459
8;22502;22500;59-900;1266;928;923;392;531
9;22502;22500;59-900;1137;781;777;327;450
10;22502;22500;59-900;1274;882;871;421;450
11;22502;22500;59-900;1293;896;887;392;495
12;22502;22500;59-900;1375;1040;1036;423;613
13;22502;22500;59-900;1163;772;769;375;394
14;22502;22500;59-900;1569;1184;1174;461;713
15;22502;22500;59-900;1306;926;920;451;469
16;22502;22500;59-900;1392;1042;1037;471;566
17;22502;22500;59-900;67;35;35;20;15
18;22502;22500;59-900;82;51;51;22;29
19;22502;22500;59-900;89;39;39;21;18
20;22502;22500;59-900;51;44;43;18;25
1;22503;22500;59-921;214;133;132;72;60
2;22503;22500;59-921;591;332;330;180;150
3;22503;22500;59-921;1129;698;691;383;308
4;22503;22500;59-922;560;308;304;178;126
5;22503;22500;59-915;524;314;309;211;98
6;22503;22500;59-916;297;180;177;116;61
7;22503;22500;59-916;678;432;428;257;171
8;22503;22500;59-916;605;323;318;220;98
9;22503;22500;59-920;775;437;434;268;166
10;22503;22500;59-920;791;480;470;236;234
11;22503;22500;59-920;847;536;529;272;257
12;22503;22500;59-920;902;607;604;327;277
13;22503;22500;59-920;902;615;612;374;238
14;22503;22500;59-920;732;460;454;250;204
15;22503;22500;59-920;730;460;453;263;190
16;22503;22500;59-920;793;551;544;237;307
17;22503;22500;59-920;750;460;456;243;213
18;22503;22500;59-920;793;541;533;248;285
19;22503;22500;59-920;770;563;551;301;250
20;22503;22500;59-920;756;513;510;284;226
21;22503;22500;59-920;711;479;475;255;220
22;22503;22500;59-920;631;441;436;258;178
23;22503;22500;59-921;290;225;224;126;98
24;22503;22500;59-916;171;106;105;67;38
25;22503;22500;59-916;165;131;128;88;40
26;22503;22500;59-920;43;26;25;11;14
27;22503;22500;59-921;166;73;71;28;43
28;22503;22500;59-920;35;11;11;2;9
1;22504;22500;59-930;1011;665;660;285;375
2;22504;22500;59-930;749;470;467;237;230
3;22504;22500;59-930;779;469;467;258;209
4;22504;22500;59-930;636;333;332;181;151
5;22504;22500;59-930;815;503;498;228;270
6;22504;22500;59-930;379;190;188;114;74
7;22504;22500;59-930;548;321;319;209;110
8;22504;22500;59-930;577;331;327;181;146
9;22504;22500;59-950;515;314;309;139;170
10;22504;22500;59-950;449;251;249;143;106
1;22505;22500;59-975;554;367;360;226;134
2;22505;22500;59-975;943;619;615;386;229
3;22505;22500;59-970;266;170;167;109;58
4;22505;22500;59-970;503;325;319;197;122
5;22505;22500;59-975;525;365;362;242;120
6;22505;22500;59-975;304;180;179;120;59
7;22505;22500;59-970;211;124;124;88;36
8;22505;22500;59-975;560;345;343;217;126
9;22505;22500;59-970;298;182;178;107;71
10;22505;22500;59-975;257;157;156;110;46
1;22506;22500;59-940;773;487;482;275;207
2;22506;22500;59-940;1220;844;839;406;433
3;22506;22500;59-940;175;105;105;73;32
4;22506;22500;59-940;729;452;451;272;179
5;22506;22500;59-950;279;149;149;56;93
6;22506;22500;59-950;732;423;419;184;235
7;22506;22500;59-950;469;241;240;109;131
8;22506;22500;59-940;1216;742;737;456;281
9;22506;22500;59-950;198;127;127;68;59
10;22506;22500;59-940;161;104;102;45;57
1;22507;22500;59-900;613;443;440;196;244
2;22507;22500;59-900;598;419;414;182;232
3;22507;22500;59-900;618;423;420;209;211
4;22507;22500;59-900;260;169;168;92;76
5;22507;22500;59-900;251;151;148;88;60
6;22507;22500;59-900;369;220;219;140;79
7;22507;22500;59-900;296;181;179;83;96
8;22507;22500;59-900;567;386;383;178;205
9;22507;22500;59-900;385;244;244;140;104
10;22507;22500;59-900;227;136;136;80;56
11;22507;22500;59-900;336;219;217;110;107
12;22507;22500;59-900;470;298;295;187;108
13;22507;22500;59-900;305;165;161;88;73
14;22507;22500;59-900;393;255;252;104;148
15;22507;22500;59-900;656;453;451;238;213
16;22507;22500;59-900;246;157;156;90;66
17;22507;22500;59-900;289;211;207;109;98
1;22601;22600;59-550;1203;717;715;280;435
2;22601;22600;59-550;722;452;451;201;250
3;22601;22600;59-550;699;403;394;182;212
1;22602;22600;59-500;897;604;598;226;372
2;22602;22600;59-500;1375;959;955;402;553
3;22602;22600;59-500;1361;808;805;403;402
4;22602;22600;59-500;1516;1109;1094;441;653
5;22602;22600;59-500;1232;742;738;365;373
6;22602;22600;59-500;717;488;486;186;300
7;22602;22600;59-500;1409;1044;1036;418;618
8;22602;22600;59-500;738;486;482;238;244
9;22602;22600;59-500;1481;1015;1012;439;573
10;22602;22600;59-500;82;45;45;24;21
11;22602;22600;59-500;77;70;69;39;30
1;22603;22600;59-524;217;144;142;92;50
2;22603;22600;59-524;713;438;437;216;221
3;22603;22600;59-524;360;209;208;136;72
4;22603;22600;59-524;544;324;323;201;122
5;22603;22600;59-524;278;183;180;137;43
6;22603;22600;59-524;692;407;404;239;165
7;22603;22600;59-524;515;335;334;179;155
1;22604;22600;59-540;1722;1014;1001;491;510
2;22604;22600;59-540;968;568;560;320;240
3;22604;22600;59-540;422;251;249;138;111
4;22604;22600;59-540;384;226;226;122;104
5;22604;22600;59-540;484;273;273;162;111
6;22604;22600;59-540;297;160;157;55;102
7;22604;22600;59-540;474;322;321;146;175
8;22604;22600;59-540;401;238;236;127;109
9;22604;22600;59-540;307;186;185;107;78
1;22605;22600;59-516;395;229;229;153;76
2;22605;22600;59-516;358;246;243;177;66
3;22605;22600;59-516;314;186;185;132;53
4;22605;22600;59-516;641;416;410;279;131
5;22605;22600;59-516;1023;681;678;495;183
6;22605;22600;59-516;531;359;352;222;130
7;22605;22600;59-516;231;135;134;90;44
8;22605;22600;59-516;344;218;218;159;59
1;22606;22600;59-500;659;440;438;205;233
2;22606;22600;59-500;818;581;577;313;264
3;22606;22600;59-500;605;390;389;277;112
4;22606;22600;59-500;919;693;686;350;336
5;22606;22600;59-500;564;358;356;241;115
6;22606;22600;59-500;599;395;388;224;164
7;22606;22600;59-500;834;548;542;243;299
8;22606;22600;59-500;190;129;129;65;64
1;26101;26100;58-500;327;208;208;84;124
2;26101;26100;58-500;1335;980;974;340;634
3;26101;26100;58-500;1586;1080;1071;384;687
4;26101;26100;58-500;997;619;614;230;384
5;26101;26100;58-500;1505;991;977;405;572
6;26101;26100;58-500;1229;861;855;310;545
7;26101;26100;58-500;1493;943;938;328;610
8;26101;26100;58-500;696;455;452;169;283
9;26101;26100;58-500;475;378;378;141;237
10;26101;26100;58-500;1604;1105;1095;353;742
11;26101;26100;58-500;1212;872;871;337;534
12;26101;26100;58-506;845;571;562;194;368
13;26101;26100;58-506;1053;725;724;228;496
14;26101;26100;58-506;1177;859;857;283;574
15;26101;26100;58-506;1112;768;766;321;445
16;26101;26100;58-506;1513;1044;1031;389;642
17;26101;26100;58-506;1714;1179;1171;433;738
18;26101;26100;58-506;1879;1432;1424;440;984
19;26101;26100;58-506;1702;1224;1215;386;829
20;26101;26100;58-506;1993;1537;1527;483;1044
21;26101;26100;58-506;1681;1247;1235;416;819
22;26101;26100;58-506;1581;1145;1137;381;756
23;26101;26100;58-506;1306;946;941;352;589
24;26101;26100;58-500;1368;943;933;300;633
25;26101;26100;58-500;674;410;407;164;243
26;26101;26100;58-500;1719;1241;1234;397;837
27;26101;26100;58-500;1436;903;898;383;515
28;26101;26100;58-500;1517;1158;1150;338;812
29;26101;26100;58-500;1396;1026;1020;328;692
30;26101;26100;58-500;1218;805;802;305;497
31;26101;26100;58-500;1708;1174;1163;379;784
32;26101;26100;58-560;1177;862;855;330;525
33;26101;26100;58-560;1482;1043;1038;358;680
34;26101;26100;58-560;1647;1259;1253;425;828
35;26101;26100;58-560;1831;1262;1243;432;811
36;26101;26100;58-560;1477;1029;1018;383;635
37;26101;26100;58-560;1604;1184;1172;366;806
38;26101;26100;58-560;1351;869;865;362;503
39;26101;26100;58-570;1713;1206;1196;471;725
40;26101;26100;58-570;1105;746;740;305;435
41;26101;26100;58-570;449;320;318;105;213
42;26101;26100;58-500;75;22;22;18;4
43;26101;26100;58-506;520;114;113;39;74
44;26101;26100;58-500;269;208;204;33;171
45;26101;26100;58-560;82;69;67;22;45
46;26101;26100;58-560;258;224;223;100;123
47;26101;26100;58-560;123;111;108;34;74
48;26101;26100;58-560;170;155;155;67;88
49;26101;26100;58-500;49;13;13;3;10
1;26201;26200;59-220;2147;1600;1586;721;865
2;26201;26200;59-220;1556;1029;1014;432;582
3;26201;26200;59-220;1507;1025;1013;430;583
4;26201;26200;59-220;1421;908;901;376;525
5;26201;26200;59-220;1338;827;818;367;451
6;26201;26200;59-220;1198;793;779;363;416
7;26201;26200;59-220;1692;1298;1288;508;780
8;26201;26200;59-220;1600;1090;1081;467;614
9;26201;26200;59-220;1403;890;885;463;422
10;26201;26200;59-220;997;540;533;282;251
11;26201;26200;59-220;1211;562;558;344;214
12;26201;26200;59-220;1600;874;865;475;390
13;26201;26200;59-220;1746;1248;1236;636;600
14;26201;26200;59-220;1511;1102;1097;528;569
15;26201;26200;59-220;1304;934;934;437;497
16;26201;26200;59-220;1404;1045;1032;405;627
17;26201;26200;59-220;1599;1216;1207;561;646
18;26201;26200;59-220;2133;1741;1734;661;1073
19;26201;26200;59-220;1288;958;953;435;518
20;26201;26200;59-220;1313;974;969;431;538
21;26201;26200;59-220;1307;947;936;443;493
22;26201;26200;59-220;1327;931;920;446;474
23;26201;26200;59-220;1140;775;768;295;473
24;26201;26200;59-220;1554;1153;1143;477;666
25;26201;26200;59-220;955;676;669;308;361
26;26201;26200;59-220;1353;977;969;438;531
27;26201;26200;59-220;1047;761;755;314;441
28;26201;26200;59-220;1725;1289;1283;545;738
29;26201;26200;59-220;1142;812;802;329;473
30;26201;26200;59-220;880;525;519;264;255
31;26201;26200;59-220;1135;714;711;348;363
32;26201;26200;59-220;721;462;459;250;209
33;26201;26200;59-220;915;615;609;253;356
34;26201;26200;59-220;620;432;423;203;220
35;26201;26200;59-220;900;563;555;270;285
36;26201;26200;59-220;1590;901;896;475;421
37;26201;26200;59-220;2046;1473;1461;661;800
38;26201;26200;59-220;1340;777;773;397;376
39;26201;26200;59-220;1210;697;692;334;358
40;26201;26200;59-220;1356;789;780;402;378
41;26201;26200;59-220;1385;961;952;456;496
42;26201;26200;59-220;1251;914;905;403;502
43;26201;26200;59-220;1471;922;912;462;450
44;26201;26200;59-220;1488;969;965;424;541
45;26201;26200;59-220;1334;936;926;364;562
46;26201;26200;59-220;1824;1329;1319;536;783
47;26201;26200;59-220;1985;1414;1396;580;816
48;26201;26200;59-220;1315;1061;1053;360;693
49;26201;26200;59-220;52;29;27;14;13
50;26201;26200;59-220;265;160;158;88;70
1;26401;26400;50-057;1446;1067;1055;348;707
2;26401;26400;50-138;1640;1234;1219;389;830
3;26401;26400;50-153;1071;832;825;308;517
4;26401;26400;50-153;1355;977;965;386;579
5;26401;26400;50-082;1172;827;822;285;537
6;26401;26400;50-136;1158;849;839;295;544
7;26401;26400;50-337;617;464;461;275;186
8;26401;26400;53-604;1555;1213;1197;430;767
9;26401;26400;53-603;2512;2065;2046;545;1501
10;26401;26400;53-603;1288;885;873;345;528
11;26401;26400;53-509;1428;1122;1112;395;717
12;26401;26400;50-035;1332;1011;998;330;668
13;26401;26400;50-028;1553;1187;1172;393;779
14;26401;26400;50-002;1585;1206;1187;409;778
15;26401;26400;50-039;1121;829;813;230;583
16;26401;26400;53-446;1308;942;930;368;562
17;26401;26400;53-446;1491;1077;1069;378;691
18;26401;26400;53-446;1300;959;955;346;609
19;26401;26400;53-426;1301;932;921;338;583
20;26401;26400;53-424;1566;1152;1139;483;656
21;26401;26400;53-424;1553;1153;1143;438;705
22;26401;26400;53-426;1504;1143;1128;350;778
23;26401;26400;53-426;1046;749;743;295;448
24;26401;26400;53-424;2555;2051;2025;588;1437
25;26401;26400;53-410;1575;1145;1131;340;791
26;26401;26400;53-410;1304;956;943;344;599
27;26401;26400;53-410;1559;1212;1205;352;853
28;26401;26400;53-232;1216;923;909;356;553
29;26401;26400;53-230;1730;1356;1343;444;899
30;26401;26400;53-230;1702;1327;1317;465;852
31;26401;26400;53-235;1659;1279;1270;454;816
32;26401;26400;53-206;2134;1750;1735;415;1320
33;26401;26400;53-206;2295;2009;1996;398;1598
34;26401;26400;50-209;1144;750;746;316;430
35;26401;26400;50-209;1392;850;841;352;489
36;26401;26400;50-248;1537;981;965;414;551
37;26401;26400;50-238;1339;910;902;377;525
38;26401;26400;50-254;1586;1092;1075;464;611
39;26401;26400;50-254;1105;775;767;313;454
40;26401;26400;50-209;1734;1109;1091;450;641
41;26401;26400;50-209;1401;952;937;349;588
42;26401;26400;50-209;3047;2345;2315;564;1751
43;26401;26400;50-238;2086;1467;1446;518;928
44;26401;26400;50-238;1776;1263;1252;474;778
45;26401;26400;50-236;1491;1040;1027;434;593
46;26401;26400;50-227;1763;1314;1302;478;824
47;26401;26400;50-227;1194;815;807;326;481
48;26401;26400;50-227;1726;1253;1236;395;841
49;26401;26400;51-518;1934;1569;1551;601;950
50;26401;26400;51-518;1974;1670;1648;472;1176
51;26401;26400;51-502;1337;1148;1136;303;833
52;26401;26400;51-502;2372;2126;2094;456;1638
53;26401;26400;50-320;1128;908;895;294;601
54;26401;26400;50-326;1604;1100;1094;433;661
55;26401;26400;50-301;1706;1232;1224;400;824
56;26401;26400;50-301;1590;1108;1097;420;677
57;26401;26400;50-301;1705;1224;1206;370;836
58;26401;26400;50-303;1542;1225;1214;386;828
59;26401;26400;50-303;2149;1706;1686;483;1203
60;26401;26400;50-303;1830;1522;1499;403;1096
61;26401;26400;50-315;1650;1205;1191;421;770
62;26401;26400;50-337;1200;846;834;290;544
63;26401;26400;50-315;808;574;568;182;386
64;26401;26400;50-315;1510;1049;1039;401;638
65;26401;26400;50-318;1955;1424;1410;491;919
66;26401;26400;50-318;1744;1216;1206;442;764
67;26401;26400;50-337;1694;1285;1262;447;815
68;26401;26400;50-315;1809;1420;1409;413;996
69;26401;26400;50-345;1634;1308;1291;424;867
70;26401;26400;50-351;1738;1252;1237;518;719
71;26401;26400;50-354;1775;1367;1354;512;842
72;26401;26400;50-372;1871;1440;1418;529;889
73;26401;26400;50-372;1966;1558;1542;482;1060
74;26401;26400;50-363;1562;1226;1209;371;838
75;26401;26400;50-359;1791;1283;1269;466;803
76;26401;26400;51-609;1308;1089;1079;354;725
77;26401;26400;51-609;1075;909;902;247;655
78;26401;26400;51-616;623;510;500;180;320
79;26401;26400;51-690;1714;1411;1393;373;1020
80;26401;26400;51-670;1361;1069;1058;311;747
81;26401;26400;51-690;1300;1025;1011;312;699
82;26401;26400;51-690;1626;1285;1264;354;910
83;26401;26400;51-670;2428;2000;1980;585;1395
84;26401;26400;51-642;1897;1521;1511;492;1019
85;26401;26400;51-662;1078;855;843;256;587
86;26401;26400;51-661;2100;1734;1718;540;1178
87;26401;26400;51-661;1394;1137;1127;359;768
88;26401;26400;51-651;1263;1007;993;271;722
89;26401;26400;53-335;1572;1220;1203;388;815
90;26401;26400;53-302;1529;1193;1180;389;791
91;26401;26400;53-302;1341;1015;1006;356;650
92;26401;26400;53-523;1677;1340;1332;421;911
93;26401;26400;50-089;1692;1309;1290;436;854
94;26401;26400;50-089;1053;811;799;272;527
95;26401;26400;53-335;1563;1224;1215;411;804
96;26401;26400;53-312;1491;1163;1154;394;760
97;26401;26400;53-312;1433;1148;1136;381;755
98;26401;26400;53-330;1191;899;891;318;573
99;26401;26400;53-330;1260;972;961;318;643
100;26401;26400;53-415;1542;1127;1113;367;746
101;26401;26400;53-415;979;671;657;265;392
102;26401;26400;53-320;1197;909;901;270;631
103;26401;26400;53-320;1301;995;978;320;658
104;26401;26400;53-148;1575;1274;1258;346;912
105;26401;26400;53-148;1545;1214;1199;444;755
106;26401;26400;53-148;1150;907;900;283;617
107;26401;26400;53-140;1551;1225;1209;395;814
108;26401;26400;50-550;2436;1975;1956;544;1412
109;26401;26400;53-135;1452;1151;1145;313;832
110;26401;26400;50-538;2036;1708;1692;487;1205
111;26401;26400;50-536;1706;1374;1357;383;974
112;26401;26400;50-551;2082;1734;1719;501;1218
113;26401;26400;50-540;1738;1384;1375;487;888
114;26401;26400;50-540;1857;1386;1369;532;837
115;26401;26400;50-536;1743;1467;1451;421;1030
116;26401;26400;50-540;1661;1320;1310;379;931
117;26401;26400;50-540;1491;1223;1209;354;855
118;26401;26400;50-524;1601;1221;1209;458;751
119;26401;26400;50-525;1338;987;980;386;594
120;26401;26400;50-527;1712;1349;1336;428;908
121;26401;26400;50-547;1360;1034;1024;375;649
122;26401;26400;50-550;1594;1248;1229;410;819
123;26401;26400;50-527;1586;1155;1147;377;770
124;26401;26400;50-518;1904;1449;1436;570;866
125;26401;26400;50-518;1468;1106;1096;373;723
126;26401;26400;50-551;1664;1324;1305;454;851
127;26401;26400;50-550;1612;1272;1261;482;779
128;26401;26400;50-505;1970;1628;1616;403;1213
129;26401;26400;50-505;1678;1372;1358;385;973
130;26401;26400;50-513;2921;2476;2450;679;1771
131;26401;26400;50-425;1900;1441;1429;420;1009
132;26401;26400;50-425;1355;923;912;330;582
133;26401;26400;50-430;2016;1428;1410;506;904
134;26401;26400;50-430;1395;1395;1382;545;837
135;26401;26400;50-448;2030;1484;1469;519;950
136;26401;26400;50-433;1566;1087;1078;414;664
137;26401;26400;50-451;1454;1183;1172;335;837
138;26401;26400;50-416;1447;1095;1089;365;724
139;26401;26400;50-447;1448;963;953;358;595
140;26401;26400;50-447;1087;779;772;279;493
141;26401;26400;50-448;1826;1276;1257;516;741
142;26401;26400;52-016;2188;1834;1818;565;1253
143;26401;26400;52-024;1660;1239;1226;378;848
144;26401;26400;52-121;2119;1576;1553;602;951
145;26401;26400;52-120;2482;1971;1943;746;1197
146;26401;26400;52-120;2056;1534;1520;580;940
147;26401;26400;52-130;1599;1368;1349;329;1020
148;26401;26400;52-129;1894;1583;1567;456;1111
149;26401;26400;52-235;1749;1475;1448;366;1082
150;26401;26400;52-231;2300;1891;1865;549;1316
151;26401;26400;52-231;2045;1768;1749;351;1398
152;26401;26400;52-231;1576;1347;1338;368;970
153;26401;26400;52-214;1774;1543;1521;434;1087
154;26401;26400;52-214;1497;1241;1235;349;886
155;26401;26400;52-214;2137;1812;1794;432;1362
156;26401;26400;53-140;2153;1758;1732;545;1187
157;26401;26400;53-006;2022;1651;1633;443;1190
158;26401;26400;53-006;1655;1451;1440;317;1123
159;26401;26400;53-024;2602;2262;2233;609;1624
160;26401;26400;53-025;2009;1704;1682;487;1195
161;26401;26400;53-024;2210;1898;1869;428;1441
162;26401;26400;53-025;1835;1571;1559;299;1260
163;26401;26400;52-314;2149;1716;1705;548;1157
164;26401;26400;52-314;2326;2012;1989;471;1518
165;26401;26400;52-314;1656;1359;1346;352;994
166;26401;26400;52-401;2334;1932;1908;496;1412
167;26401;26400;52-401;2050;1699;1677;452;1225
168;26401;26400;52-429;1914;1632;1620;441;1179
169;26401;26400;53-628;2090;1638;1624;461;1163
170;26401;26400;53-628;982;751;742;284;458
171;26401;26400;53-628;1212;944;928;292;636
172;26401;26400;53-641;1120;902;892;285;607
173;26401;26400;53-641;1284;1028;1021;336;685
174;26401;26400;53-630;984;773;760;246;514
175;26401;26400;53-680;2114;1550;1536;521;1015
176;26401;26400;53-630;974;752;734;248;486
177;26401;26400;53-644;1221;944;940;325;615
178;26401;26400;53-644;1198;920;914;276;638
179;26401;26400;53-630;1250;932;922;304;618
180;26401;26400;53-680;1510;1119;1101;358;743
181;26401;26400;53-680;1413;1018;1002;341;661
182;26401;26400;54-218;1954;1648;1623;494;1129
183;26401;26400;54-218;1584;1254;1242;436;806
184;26401;26400;54-218;1786;1419;1398;495;903
185;26401;26400;54-130;1815;1450;1437;434;1003
186;26401;26400;54-130;1952;1596;1571;498;1073
187;26401;26400;54-130;2052;1712;1699;526;1173
188;26401;26400;54-130;2115;1778;1757;539;1218
189;26401;26400;54-130;1845;1466;1450;499;951
190;26401;26400;54-130;1547;1198;1192;452;740
191;26401;26400;54-130;1455;1165;1148;398;750
192;26401;26400;54-130;1611;1302;1286;447;839
193;26401;26400;54-134;1407;1124;1110;444;666
194;26401;26400;54-139;1232;935;924;343;581
195;26401;26400;54-139;2393;1809;1786;735;1051
196;26401;26400;54-150;1765;1448;1435;508;927
197;26401;26400;54-151;1847;1417;1397;481;916
198;26401;26400;54-151;1701;1288;1273;464;809
199;26401;26400;54-151;1332;1071;1060;411;649
200;26401;26400;54-152;1512;1196;1180;385;795
201;26401;26400;54-152;1737;1376;1360;461;899
202;26401;26400;54-152;1425;1188;1176;408;768
203;26401;26400;54-220;1444;1155;1139;338;801
204;26401;26400;54-220;1430;1168;1153;364;789
205;26401;26400;54-242;1705;1425;1413;450;963
206;26401;26400;54-242;2650;2174;2153;651;1502
207;26401;26400;54-242;1224;962;958;277;681
208;26401;26400;54-220;1496;1173;1164;414;750
209;26401;26400;54-402;1752;1324;1316;530;786
210;26401;26400;54-402;1292;958;951;406;545
211;26401;26400;54-406;1417;1139;1127;372;755
212;26401;26400;54-406;1569;1282;1270;464;806
213;26401;26400;54-615;2128;1778;1762;535;1227
214;26401;26400;54-611;1900;1585;1577;497;1080
215;26401;26400;54-611;1971;1597;1589;469;1120
216;26401;26400;54-611;2175;1829;1811;454;1357
217;26401;26400;54-438;1691;1299;1287;493;794
218;26401;26400;54-438;1426;1103;1093;422;671
219;26401;26400;54-438;1195;942;936;329;607
220;26401;26400;54-438;1664;1194;1187;487;700
221;26401;26400;54-436;1778;1331;1319;458;861
222;26401;26400;54-438;1435;1130;1114;437;677
223;26401;26400;54-438;1195;896;889;375;514
224;26401;26400;54-436;1351;1101;1088;422;666
225;26401;26400;54-320;1407;1111;1104;435;669
226;26401;26400;54-320;1636;1303;1291;421;870
227;26401;26400;54-320;1401;1103;1083;386;697
228;26401;26400;54-510;1681;1342;1331;399;932
229;26401;26400;54-512;1482;1235;1220;403;817
230;26401;26400;54-530;1897;1487;1468;704;764
231;26401;26400;54-076;2136;1593;1578;645;933
232;26401;26400;54-047;1870;1432;1421;501;920
233;26401;26400;54-018;1665;1266;1254;444;810
234;26401;26400;54-018;2105;1698;1673;544;1129
235;26401;26400;54-018;1644;1121;1112;473;639
236;26401;26400;54-031;2195;1799;1780;578;1202
237;26401;26400;54-031;1336;1083;1072;439;633
238;26401;26400;54-047;1963;1495;1475;547;928
239;26401;26400;54-047;1892;1523;1505;505;1000
240;26401;26400;54-047;2021;1563;1555;536;1019
241;26401;26400;54-034;1852;1560;1529;504;1025
242;26401;26400;54-101;1870;1559;1545;431;1114
243;26401;26400;54-104;2059;1741;1723;481;1242
244;26401;26400;54-104;2176;1835;1818;477;1341
245;26401;26400;54-104;2267;1855;1840;513;1327
246;26401;26400;54-061;2002;1672;1652;586;1066
247;26401;26400;54-061;1595;1212;1202;486;716
248;26401;26400;51-410;1959;1534;1516;489;1027
249;26401;26400;51-160;2296;1772;1755;516;1239
250;26401;26400;51-151;1611;1265;1255;394;861
251;26401;26400;51-160;1847;1533;1524;471;1053
252;26401;26400;51-151;1446;1092;1087;387;700
253;26401;26400;51-151;1347;1090;1072;384;688
254;26401;26400;51-124;1696;1323;1312;489;823
255;26401;26400;51-124;1654;1307;1300;446;854
256;26401;26400;51-112;958;719;713;277;436
257;26401;26400;51-112;1511;1184;1174;441;733
258;26401;26400;51-112;852;668;665;207;458
259;26401;26400;51-109;1575;1214;1200;386;814
260;26401;26400;51-109;1565;1290;1277;421;856
261;26401;26400;51-112;680;561;555;199;356
262;26401;26400;51-112;1392;1108;1096;283;813
263;26401;26400;51-112;1732;1425;1408;477;931
264;26401;26400;51-424;1394;1136;1124;447;677
265;26401;26400;51-410;842;687;681;269;412
266;26401;26400;51-314;2192;1784;1765;634;1131
267;26401;26400;51-354;1897;1524;1504;509;995
268;26401;26400;51-354;1848;1421;1406;486;920
269;26401;26400;51-354;1591;1256;1234;458;776
270;26401;26400;51-354;1890;1447;1429;548;881
271;26401;26400;51-319;1555;1083;1072;480;592
272;26401;26400;51-319;2150;1687;1663;660;1003
273;26401;26400;51-314;2138;1757;1729;541;1188
274;26401;26400;51-206;2492;1960;1931;769;1162
275;26401;26400;51-206;2086;1663;1647;609;1038
276;26401;26400;51-216;1702;1271;1263;604;659
277;26401;26400;51-215;2028;1648;1627;585;1042
278;26401;26400;51-211;1862;1503;1484;684;800
279;26401;26400;51-168;2014;1607;1586;581;1005
280;26401;26400;51-168;2097;1806;1784;532;1252
281;26401;26400;51-124;1729;1434;1417;530;887
282;26401;26400;51-180;1899;1573;1559;450;1109
283;26401;26400;51-180;1417;1156;1145;437;708
284;26401;26400;51-180;2450;2134;2120;666;1454
285;26401;26400;51-180;2359;1889;1864;695;1169
286;26401;26400;51-004;2196;1762;1746;597;1149
287;26401;26400;50-304;2382;2096;2061;432;1629
288;26401;26400;50-536;1370;1225;1207;299;908
289;26401;26400;50-505;2305;2007;1975;567;1408
290;26401;26400;52-024;1666;1310;1302;404;898
291;26401;26400;52-235;2548;2251;2221;610;1611
292;26401;26400;52-235;1869;1602;1590;420;1170
293;26401;26400;53-033;1963;1644;1626;396;1230
294;26401;26400;54-611;1838;1501;1485;467;1018
295;26401;26400;54-018;1399;1025;1012;438;574
296;26401;26400;54-031;1363;1112;1107;365;742
297;26401;26400;54-061;1799;1514;1498;424;1074
298;26401;26400;54-104;2106;1765;1749;477;1272
299;26401;26400;54-061;1759;1405;1395;502;893
300;26401;26400;51-109;1790;1544;1526;350;1176
301;26401;26400;51-124;1816;1492;1470;517;953
302;26401;26400;50-329;73;54;52;47;5
303;26401;26400;50-046;652;630;603;82;521
304;26401;26400;53-439;192;108;107;45;62
305;26401;26400;53-239;540;424;409;59;350
306;26401;26400;50-233;91;39;39;15;24
307;26401;26400;50-226;172;86;84;45;39
308;26401;26400;50-211;648;529;520;91;429
309;26401;26400;50-367;71;58;58;14;44
310;26401;26400;53-413;138;107;103;39;64
311;26401;26400;50-981;301;165;161;63;98
312;26401;26400;50-556;233;131;131;53;78
313;26401;26400;50-556;229;166;166;68;98
314;26401;26400;50-528;124;55;54;10;44
315;26401;26400;52-018;91;52;47;22;25
316;26401;26400;52-114;120;60;60;30;30
317;26401;26400;52-433;169;79;77;47;30
318;26401;26400;54-131;122;63;56;45;11
319;26401;26400;54-239;60;22;19;8;11
320;26401;26400;54-049;229;182;182;78;104
321;26401;26400;54-106;126;61;57;28;29
322;26401;26400;51-149;503;142;140;53;87
323;26401;26400;51-124;17;13;12;7;5
324;26401;26400;51-124;267;154;151;72;79
325;26401;26400;51-124;52;40;40;25;15
326;26401;26400;51-317;41;29;27;9;18
327;26401;26400;51-128;77;77;77;31;46
328;26401;26400;51-134;57;46;45;18;27
329;26401;26400;51-180;47;23;22;13;9
330;26401;26400;50-446;100;46;46;10;36
331;26401;26400;50-357;51;37;33;26;7
1;26501;26500;58-306;415;271;270;143;127
2;26501;26500;58-306;1536;1149;1143;343;800
3;26501;26500;58-306;913;543;536;215;321
4;26501;26500;58-307;1472;989;980;364;616
5;26501;26500;58-309;1105;848;844;269;575
6;26501;26500;58-309;1996;1466;1450;508;942
7;26501;26500;58-309;1943;1323;1310;475;835
8;26501;26500;58-309;1176;776;771;281;490
9;26501;26500;58-309;1410;973;970;389;581
10;26501;26500;58-309;1392;919;905;372;533
11;26501;26500;58-309;774;554;553;169;384
12;26501;26500;58-309;1218;863;857;238;619
13;26501;26500;58-309;1354;874;868;366;502
14;26501;26500;58-316;1406;1024;1018;328;690
15;26501;26500;58-316;1736;1299;1288;449;839
16;26501;26500;58-316;1594;1215;1207;386;821
17;26501;26500;58-316;1554;1119;1111;390;721
18;26501;26500;58-316;1155;869;864;315;549
19;26501;26500;58-316;1646;1214;1202;430;772
20;26501;26500;58-316;1458;1119;1107;408;699
21;26501;26500;58-316;1730;1283;1267;439;828
22;26501;26500;58-316;1219;921;914;317;597
23;26501;26500;58-316;1154;865;860;268;592
24;26501;26500;58-302;833;421;418;178;240
25;26501;26500;58-302;1734;1006;999;440;559
26;26501;26500;58-302;1248;806;803;255;548
27;26501;26500;58-302;1759;1048;1036;404;632
28;26501;26500;58-301;1323;803;796;288;508
29;26501;26500;58-301;1254;785;780;322;458
30;26501;26500;58-301;1215;680;677;284;393
31;26501;26500;58-301;978;636;632;262;370
32;26501;26500;58-301;1149;585;583;257;326
33;26501;26500;58-308;1023;707;701;254;447
34;26501;26500;58-308;965;609;596;264;332
35;26501;26500;58-303;1331;711;698;319;379
36;26501;26500;58-303;344;207;206;94;112
37;26501;26500;58-303;1586;946;938;463;475
38;26501;26500;58-300;730;446;441;200;241
39;26501;26500;58-303;747;422;418;179;239
40;26501;26500;58-303;1402;941;931;349;582
41;26501;26500;58-300;1398;935;929;347;582
42;26501;26500;58-300;1353;770;764;349;415
43;26501;26500;58-300;1465;808;800;326;474
44;26501;26500;58-300;748;489;489;190;299
45;26501;26500;58-300;854;507;501;213;288
46;26501;26500;58-300;915;550;545;250;295
47;26501;26500;58-305;969;523;520;260;260
48;26501;26500;58-305;1009;559;555;256;299
49;26501;26500;58-305;1440;938;927;342;585
50;26501;26500;58-304;1247;802;796;307;489
51;26501;26500;58-304;1171;666;657;248;409
52;26501;26500;58-304;1189;718;709;262;447
53;26501;26500;58-304;971;674;666;220;446
54;26501;26500;58-304;1423;975;964;353;611
55;26501;26500;58-304;1154;680;672;277;395
56;26501;26500;58-304;739;457;452;199;253
57;26501;26500;58-304;1453;835;826;334;492
58;26501;26500;58-303;1330;834;827;350;477
59;26501;26500;58-301;49;27;27;13;14
60;26501;26500;58-300;168;78;77;39;38
61;26501;26500;58-309;305;111;110;46;64
62;26501;26500;58-308;35;20;20;9;11
63;26501;26500;58-304;28;27;27;13;14
64;26501;26500;58-305;31;15;13;7;6
1;40101;40100;87-700;1226;802;796;392;404
2;40101;40100;87-700;1180;785;775;450;325
3;40101;40100;87-700;1296;844;833;426;407
4;40101;40100;87-700;447;248;244;131;113
5;40101;40100;87-700;1238;837;823;352;471
6;40101;40100;87-700;914;643;638;252;386
7;40101;40100;87-700;1303;871;862;342;520
8;40101;40100;87-700;1175;795;789;296;493
9;40101;40100;87-700;146;84;83;39;44
10;40101;40100;87-700;274;138;137;73;64
1;40102;40100;87-720;1215;899;894;371;523
2;40102;40100;87-720;2040;1748;1739;746;993
3;40102;40100;87-720;1173;868;856;368;488
4;40102;40100;87-720;1268;898;891;426;465
5;40102;40100;87-720;1599;1341;1331;581;750
6;40102;40100;87-720;1079;829;819;347;472
7;40102;40100;87-720;2297;1797;1781;785;996
8;40102;40100;87-720;255;211;209;64;145
9;40102;40100;87-720;271;250;249;85;164
1;40103;40100;87-730;437;277;275;153;122
2;40103;40100;87-730;462;322;317;180;137
3;40103;40100;87-730;510;328;324;175;149
1;40104;40100;87-710;1365;818;802;546;256
2;40104;40100;87-700;835;562;556;223;333
3;40104;40100;87-700;493;338;337;182;155
4;40104;40100;87-700;550;357;351;242;109
5;40104;40100;87-700;431;266;264;182;82
6;40104;40100;87-700;1136;763;753;423;330
7;40104;40100;87-700;576;404;397;180;217
8;40104;40100;87-700;896;572;564;328;236
9;40104;40100;87-700;625;380;380;306;74
10;40104;40100;87-720;573;365;362;199;163
11;40104;40100;87-700;340;213;211;120;91
12;40104;40100;87-700;206;129;128;96;32
13;40104;40100;87-700;299;177;175;87;88
14;40104;40100;87-720;200;136;135;71;64
15;40104;40100;87-700;138;85;84;43;41
16;40104;40100;87-700;160;110;109;81;28
17;40104;40100;87-700;178;116;115;81;34
1;40105;40100;87-704;773;540;534;295;239
2;40105;40100;87-704;786;486;484;371;113
3;40105;40100;87-704;496;342;342;259;83
4;40105;40100;87-704;829;576;569;410;159
5;40105;40100;87-704;296;194;192;146;46
1;40106;40100;87-702;464;280;278;187;91
2;40106;40100;87-702;435;295;294;233;61
3;40106;40100;87-702;546;360;359;252;107
4;40106;40100;87-702;467;284;283;225;58
5;40106;40100;87-702;500;345;345;215;130
1;40107;40100;87-721;630;393;390;283;107
2;40107;40100;87-721;555;388;382;207;175
3;40107;40100;87-721;598;405;403;213;190
4;40107;40100;87-721;578;395;394;193;201
5;40107;40100;87-721;152;51;51;32;19
1;40108;40100;87-731;577;390;385;242;143
2;40108;40100;87-731;294;188;185;123;62
3;40108;40100;87-731;660;434;429;316;113
4;40108;40100;87-731;467;307;306;231;75
5;40108;40100;87-731;404;243;243;183;60
6;40108;40100;87-731;336;217;215;159;56
7;40108;40100;87-731;433;294;294;249;45
8;40108;40100;87-731;220;153;153;84;69
1;40109;40100;87-707;605;393;388;212;176
2;40109;40100;87-707;439;251;251;157;94
3;40109;40100;87-706;852;544;542;395;147
4;40109;40100;87-705;508;319;313;198;115
5;40109;40100;87-705;180;117;117;92;25
6;40109;40100;87-707;64;36;34;20;14
1;40201;40200;87-300;1325;957;945;423;522
2;40201;40200;87-300;943;643;640;304;336
3;40201;40200;87-300;1911;1304;1295;554;741
4;40201;40200;87-300;1910;1364;1349;581;768
5;40201;40200;87-300;1671;1135;1129;527;602
6;40201;40200;87-300;744;419;418;199;219
7;40201;40200;87-300;934;632;630;271;359
8;40201;40200;87-300;1489;952;946;428;518
9;40201;40200;87-300;1705;1202;1191;491;700
10;40201;40200;87-300;833;588;581;252;329
11;40201;40200;87-300;983;667;662;320;342
12;40201;40200;87-300;1730;1251;1245;599;646
13;40201;40200;87-300;931;655;648;308;340
14;40201;40200;87-300;1478;1073;1064;513;551
15;40201;40200;87-300;1122;719;709;360;349
16;40201;40200;87-300;136;56;56;23;33
1;40202;40200;87-327;646;427;424;243;181
2;40202;40200;87-327;432;288;287;165;122
3;40202;40200;87-326;958;614;609;410;199
4;40202;40200;87-326;390;204;202;158;44
5;40202;40200;87-325;929;571;570;377;193
6;40202;40200;87-327;311;197;195;151;44
7;40202;40200;87-327;515;340;337;218;119
8;40202;40200;87-326;270;169;169;113;56
9;40202;40200;87-326;206;133;133;92;41
10;40202;40200;87-327;74;22;22;9;13
1;40203;40200;87-300;1701;1205;1191;534;657
2;40203;40200;87-300;1004;701;695;379;316
3;40203;40200;87-300;1058;700;696;442;254
4;40203;40200;87-300;381;217;212;145;67
5;40203;40200;87-300;1196;717;712;383;329
6;40203;40200;87-300;1388;914;909;504;405
1;40204;40200;87-313;853;616;613;428;185
2;40204;40200;87-313;548;361;360;275;85
3;40204;40200;87-313;617;358;356;199;157
4;40204;40200;87-313;426;283;280;220;60
5;40204;40200;87-313;405;300;297;203;94
1;40205;40200;87-320;1039;680;673;405;268
2;40205;40200;87-320;382;250;246;163;83
3;40205;40200;87-320;429;274;272;207;65
4;40205;40200;87-320;391;240;238;167;71
5;40205;40200;87-320;292;201;199;153;46
6;40205;40200;87-320;341;214;212;157;55
1;40206;40200;87-321;838;515;504;372;132
2;40206;40200;87-321;588;391;390;262;128
3;40206;40200;87-321;594;403;403;295;108
4;40206;40200;87-322;477;295;290;225;65
5;40206;40200;87-321;373;266;264;189;75
6;40206;40200;87-322;304;164;163;101;62
7;40206;40200;87-322;271;162;162;117;45
1;40207;40200;87-330;1263;796;791;456;335
2;40207;40200;87-330;1402;865;856;466;390
3;40207;40200;87-330;932;528;524;355;169
4;40207;40200;87-330;543;291;288;195;93
5;40207;40200;87-330;290;155;155;66;89
6;40207;40200;87-330;368;211;208;142;66
7;40207;40200;87-330;365;218;216;173;43
8;40207;40200;87-330;486;270;265;210;55
9;40207;40200;87-330;435;275;274;179;95
10;40207;40200;87-330;363;180;179;143;36
1;40208;40200;87-340;896;517;511;357;154
2;40208;40200;87-340;1135;694;690;474;216
3;40208;40200;87-340;906;525;522;367;155
1;40209;40200;87-335;988;661;659;415;244
2;40209;40200;87-335;994;561;559;389;170
3;40209;40200;87-335;328;170;168;113;55
4;40209;40200;87-335;602;363;357;279;78
5;40209;40200;87-335;447;262;258;176;82
6;40209;40200;87-335;192;97;97;74;23
7;40209;40200;87-335;247;144;143;105;38
1;40210;40200;87-305;1048;728;720;396;324
2;40210;40200;87-305;1379;905;901;460;441
3;40210;40200;87-305;436;282;276;175;101
4;40210;40200;87-305;479;335;332;178;154
5;40210;40200;87-305;251;133;132;79;53
6;40210;40200;87-305;290;179;175;89;86
1;40301;40300;86-005;743;549;543;210;333
2;40301;40300;86-005;940;726;721;271;450
3;40301;40300;86-005;803;613;608;208;400
4;40301;40300;86-005;711;562;560;201;359
5;40301;40300;86-005;1077;809;801;349;452
6;40301;40300;86-005;459;354;349;141;208
7;40301;40300;86-005;1361;1059;1056;340;716
8;40301;40300;86-005;1119;875;865;283;582
9;40301;40300;86-065;687;498;495;168;327
10;40301;40300;86-065;750;602;596;168;428
11;40301;40300;86-065;1896;1481;1461;551;910
12;40301;40300;86-065;1918;1539;1525;498;1027
13;40301;40300;86-005;2134;1713;1704;589;1115
14;40301;40300;86-005;2127;1734;1725;484;1241
15;40301;40300;86-005;1197;948;939;308;631
16;40301;40300;86-005;335;277;274;74;200
1;40302;40300;86-070;343;239;239;154;85
2;40302;40300;86-070;525;332;327;184;143
3;40302;40300;86-070;468;315;313;126;187
4;40302;40300;86-070;520;378;377;150;227
5;40302;40300;86-070;544;325;325;133;192
6;40302;40300;86-070;769;524;518;216;302
7;40302;40300;86-070;693;439;436;242;194
8;40302;40300;86-070;531;337;336;171;165
9;40302;40300;86-070;935;602;596;312;284
10;40302;40300;86-070;1000;685;671;303;368
11;40302;40300;86-070;233;138;136;72;64
1;40303;40300;86-022;885;669;661;222;439
2;40303;40300;86-022;1271;837;829;461;368
3;40303;40300;86-022;793;554;551;308;243
4;40303;40300;86-022;667;469;460;205;255
5;40303;40300;86-022;824;657;650;219;431
6;40303;40300;86-022;933;711;696;267;429
7;40303;40300;86-022;532;341;338;148;190
8;40303;40300;86-022;498;318;314;171;143
9;40303;40300;86-022;331;228;228;144;84
10;40303;40300;86-022;749;516;509;223;286
11;40303;40300;86-022;629;478;477;249;228
12;40303;40300;86-022;461;287;280;162;118
13;40303;40300;86-022;195;125;124;82;42
14;40303;40300;86-022;804;563;559;208;351
1;40304;40300;86-010;872;469;467;258;209
2;40304;40300;86-010;1000;572;569;257;312
3;40304;40300;86-010;814;496;493;218;275
4;40304;40300;86-010;862;641;637;243;394
5;40304;40300;86-010;812;542;537;220;317
6;40304;40300;86-010;1156;803;800;333;467
7;40304;40300;86-010;1174;902;896;291;605
8;40304;40300;86-010;1169;798;791;307;484
9;40304;40300;86-013;1069;599;593;312;281
10;40304;40300;86-010;624;371;370;187;183
11;40304;40300;86-011;855;586;571;260;311
12;40304;40300;86-010;306;210;210;118;92
13;40304;40300;86-011;540;327;325;195;130
14;40304;40300;86-017;664;434;431;303;128
15;40304;40300;86-010;881;521;518;259;259
16;40304;40300;86-010;584;385;385;245;140
17;40304;40300;86-013;388;205;204;115;89
18;40304;40300;86-017;431;244;240;160;80
19;40304;40300;86-011;1074;847;832;362;470
20;40304;40300;86-010;275;161;160;103;57
21;40304;40300;86-010;475;367;361;168;193
22;40304;40300;86-011;347;260;259;120;139
23;40304;40300;86-010;531;323;322;178;144
24;40304;40300;86-010;425;234;231;164;67
25;40304;40300;86-010;158;116;114;80;34
26;40304;40300;86-010;33;18;16;12;4
27;40304;40300;86-010;552;408;405;44;361
1;40305;40300;86-060;1436;975;971;454;517
2;40305;40300;86-061;1523;1025;1016;383;633
3;40305;40300;86-060;1273;910;897;374;523
4;40305;40300;86-061;1452;1073;1059;346;713
5;40305;40300;86-061;170;109;105;47;58
6;40305;40300;86-060;926;721;713;264;449
7;40305;40300;86-060;174;110;109;86;23
8;40305;40300;86-060;382;245;245;131;114
9;40305;40300;86-060;162;96;96;48;48
10;40305;40300;86-061;432;328;322;99;223
1;40306;40300;86-031;666;566;563;160;403
2;40306;40300;86-021;745;581;579;234;345
3;40306;40300;86-021;928;711;705;235;470
4;40306;40300;86-031;579;457;452;178;274
5;40306;40300;86-032;1003;868;861;260;601
6;40306;40300;86-021;360;244;239;80;159
7;40306;40300;86-031;283;233;232;68;164
8;40306;40300;86-031;1001;830;822;233;589
9;40306;40300;86-031;1303;1070;1058;284;774
10;40306;40300;86-032;1011;889;881;237;644
11;40306;40300;86-032;696;609;603;128;475
12;40306;40300;86-031;928;793;781;183;598
13;40306;40300;86-031;901;752;745;257;488
14;40306;40300;86-031;797;695;688;187;501
15;40306;40300;86-021;808;649;644;202;442
16;40306;40300;86-021;636;485;484;181;303
17;40306;40300;86-032;613;546;545;116;429
18;40306;40300;86-031;28;10;9;7;2
1;40307;40300;86-017;402;267;267;171;96
2;40307;40300;86-014;774;526;520;244;276
3;40307;40300;86-014;541;343;340;174;166
4;40307;40300;86-014;622;431;427;165;262
5;40307;40300;86-014;1282;987;979;388;591
6;40307;40300;86-014;160;110;108;79;29
7;40307;40300;86-014;967;700;693;281;412
8;40307;40300;86-014;416;257;256;124;132
9;40307;40300;86-014;815;627;621;263;358
10;40307;40300;86-014;486;378;377;188;189
11;40307;40300;86-014;266;184;182;119;63
12;40307;40300;86-014;450;335;331;148;183
13;40307;40300;86-014;473;338;335;136;199
14;40307;40300;86-014;285;178;177;112;65
1;40308;40300;86-050;1642;1170;1158;488;670
2;40308;40300;86-050;1771;1309;1300;466;834
3;40308;40300;86-050;847;618;609;226;383
4;40308;40300;86-050;890;615;605;231;374
5;40308;40300;86-050;925;663;654;276;378
6;40308;40300;86-050;1340;884;873;325;548
7;40308;40300;86-050;1554;1049;1042;378;664
8;40308;40300;86-050;975;665;660;259;401
9;40308;40300;86-050;934;647;645;282;363
10;40308;40300;86-050;149;101;100;31;69
11;40308;40300;86-050;157;86;84;44;40
12;40308;40300;86-050;510;331;327;180;147
1;40401;40400;86-200;827;454;452;176;276
2;40401;40400;86-200;728;383;377;181;196
3;40401;40400;86-200;790;400;397;195;202
4;40401;40400;86-200;817;421;417;194;223
5;40401;40400;86-200;940;652;645;225;420
6;40401;40400;86-200;922;678;675;243;432
7;40401;40400;86-200;899;533;529;226;303
8;40401;40400;86-200;723;489;479;163;316
9;40401;40400;86-200;707;461;459;183;276
10;40401;40400;86-200;1020;737;734;230;504
11;40401;40400;86-200;860;600;597;213;384
12;40401;40400;86-200;741;505;502;179;323
13;40401;40400;86-200;858;589;586;239;347
14;40401;40400;86-200;957;628;624;274;350
15;40401;40400;86-200;871;536;531;205;326
16;40401;40400;86-200;105;48;48;25;23
17;40401;40400;86-200;34;24;21;17;4
1;40402;40400;86-200;1170;718;717;399;318
2;40402;40400;86-200;1259;719;716;353;363
3;40402;40400;86-200;925;540;536;326;210
4;40402;40400;86-200;523;340;335;193;142
5;40402;40400;86-200;695;482;477;229;248
1;40403;40400;86-200;752;546;540;235;305
2;40403;40400;86-253;1069;730;723;386;337
3;40403;40400;86-253;573;363;360;247;113
4;40403;40400;86-253;472;290;287;203;84
5;40403;40400;86-253;480;313;310;195;115
1;40404;40400;86-230;783;531;526;386;140
2;40404;40400;86-230;1226;817;810;372;438
3;40404;40400;86-230;912;545;541;344;197
4;40404;40400;86-230;278;155;155;111;44
5;40404;40400;86-230;514;335;333;222;111
1;40405;40400;86-221;476;295;293;186;107
2;40405;40400;86-221;492;279;277;178;99
3;40405;40400;86-221;1119;681;674;413;261
4;40405;40400;86-221;489;270;268;154;114
5;40405;40400;86-221;516;299;296;183;113
1;40406;40400;86-212;373;195;195;122;73
2;40406;40400;86-212;406;250;246;144;102
3;40406;40400;86-212;521;368;362;156;206
4;40406;40400;86-212;711;451;448;256;192
5;40406;40400;86-212;536;353;351;196;155
6;40406;40400;86-212;783;512;508;364;144
7;40406;40400;86-212;295;170;170;104;66
8;40406;40400;86-212;268;177;176;94;82
1;40407;40400;86-260;1318;941;934;485;449
2;40407;40400;86-260;1030;591;583;325;258
3;40407;40400;86-260;577;358;353;211;142
4;40407;40400;86-260;338;179;179;111;68
5;40407;40400;86-260;715;518;512;204;308
6;40407;40400;86-260;226;150;149;108;41
7;40407;40400;86-260;345;210;210;152;58
8;40407;40400;86-260;462;291;288;180;108
1;40501;40500;87-400;1242;771;761;399;362
2;40501;40500;87-400;1601;901;892;555;337
3;40501;40500;87-400;1092;679;672;302;370
4;40501;40500;87-400;1813;1241;1232;586;646
5;40501;40500;87-400;1519;1045;1039;551;488
6;40501;40500;87-400;1184;772;766;359;407
7;40501;40500;87-400;113;27;27;13;14
1;40502;40500;87-408;641;440;438;280;158
2;40502;40500;87-408;586;427;422;256;166
3;40502;40500;87-408;384;245;243;175;68
4;40502;40500;87-408;825;532;527;364;163
5;40502;40500;87-408;347;240;236;192;44
6;40502;40500;87-408;317;240;240;147;93
1;40503;40500;87-400;1333;786;778;540;238
2;40503;40500;87-400;1376;842;835;563;272
3;40503;40500;87-400;1087;639;634;380;254
4;40503;40500;87-400;841;621;616;300;316
5;40503;40500;87-400;599;390;383;195;188
6;40503;40500;87-400;891;583;582;348;234
7;40503;40500;87-400;653;458;458;281;177
1;40504;40500;87-410;1707;1138;1127;564;563
2;40504;40500;87-410;1884;1211;1199;631;568
3;40504;40500;87-410;782;515;503;296;207
4;40504;40500;87-410;898;536;532;326;206
5;40504;40500;87-410;516;309;306;201;105
6;40504;40500;87-410;381;233;231;149;82
7;40504;40500;87-410;1118;745;737;476;261
8;40504;40500;87-410;261;160;159;88;71
9;40504;40500;87-410;352;215;212;129;83
10;40504;40500;87-410;414;259;258;158;100
11;40504;40500;87-410;208;118;116;82;34
1;40505;40500;87-404;747;491;485;341;144
2;40505;40500;87-404;569;345;343;243;100
3;40505;40500;87-404;673;421;420;335;85
4;40505;40500;87-404;385;251;248;196;52
5;40505;40500;87-404;173;115;115;71;44
6;40505;40500;87-404;191;124;124;100;24
7;40505;40500;87-404;229;161;160;126;34
1;40506;40500;87-645;1054;640;634;480;154
2;40506;40500;87-645;413;238;236;170;66
3;40506;40500;87-645;718;405;400;299;101
4;40506;40500;87-645;1064;639;636;384;252
1;40601;40600;86-302;250;156;156;97;59
2;40601;40600;86-302;956;635;631;273;358
3;40601;40600;86-302;1568;1084;1074;461;613
4;40601;40600;86-302;610;423;418;179;239
5;40601;40600;86-302;596;430;427;222;205
6;40601;40600;86-302;868;586;585;291;294
7;40601;40600;86-302;352;193;190;103;87
8;40601;40600;86-302;432;243;239;162;77
9;40601;40600;86-302;282;168;166;110;56
10;40601;40600;86-302;865;634;626;263;363
11;40601;40600;86-302;498;324;319;159;160
12;40601;40600;86-302;870;600;595;271;324
13;40601;40600;86-302;185;116;116;73;43
14;40601;40600;86-302;712;416;413;219;194
15;40601;40600;86-302;221;136;136;87;49
16;40601;40600;86-302;903;657;653;224;429
1;40602;40600;86-330;723;474;471;317;154
2;40602;40600;86-330;848;456;453;239;214
3;40602;40600;86-330;665;424;419;219;200
4;40602;40600;86-330;535;332;331;206;125
5;40602;40600;86-330;346;226;225;134;91
6;40602;40600;86-330;438;261;258;193;65
7;40602;40600;86-330;452;280;279;178;101
8;40602;40600;86-330;348;210;209;153;56
9;40602;40600;86-330;376;254;251;177;74
1;40603;40600;86-320;694;438;435;230;205
2;40603;40600;86-320;692;442;435;232;203
3;40603;40600;86-320;742;495;490;265;225
4;40603;40600;86-320;695;396;392;228;164
5;40603;40600;86-320;690;445;442;310;132
6;40603;40600;86-320;729;407;405;270;135
7;40603;40600;86-320;726;377;376;291;85
8;40603;40600;86-320;443;253;253;205;48
9;40603;40600;86-320;39;14;12;8;4
1;40604;40600;87-220;749;494;487;271;216
2;40604;40600;87-220;582;337;334;209;125
3;40604;40600;87-220;394;228;227;160;67
4;40604;40600;87-220;239;146;146;97;49
5;40604;40600;87-220;213;128;127;87;40
6;40604;40600;87-220;458;255;250;172;78
7;40604;40600;87-220;230;90;89;64;25
8;40604;40600;87-220;268;158;157;117;40
9;40604;40600;87-220;221;115;114;85;29
1;40605;40600;86-318;585;343;340;209;131
2;40605;40600;86-318;1193;742;739;451;288
3;40605;40600;86-318;331;194;194;127;67
4;40605;40600;86-318;352;223;223;161;62
5;40605;40600;86-318;164;94;93;63;30
6;40605;40600;86-318;172;116;115;79;36
7;40605;40600;86-318;240;142;140;95;45
1;40606;40600;86-341;536;256;254;191;63
2;40606;40600;86-342;480;253;252;181;71
3;40606;40600;86-341;613;399;397;271;126
4;40606;40600;86-341;569;335;333;246;87
5;40606;40600;86-320;204;119;119;69;50
6;40606;40600;86-342;210;125;125;104;21
7;40606;40600;86-342;149;75;75;49;26
8;40606;40600;86-342;189;102;102;74;28
1;40701;40700;88-100;1192;817;809;300;509
2;40701;40700;88-100;1113;822;812;302;510
3;40701;40700;88-100;890;514;510;219;291
4;40701;40700;88-100;1248;825;818;380;438
5;40701;40700;88-100;920;621;619;225;394
6;40701;40700;88-100;1238;749;740;248;492
7;40701;40700;88-100;1004;511;505;246;259
8;40701;40700;88-100;1122;651;645;267;378
9;40701;40700;88-100;1096;606;602;300;302
10;40701;40700;88-100;1031;669;661;264;397
11;40701;40700;88-100;921;469;462;234;228
12;40701;40700;88-100;1098;715;710;267;443
13;40701;40700;88-100;1261;852;844;292;552
14;40701;40700;88-100;1449;987;980;362;618
15;40701;40700;88-100;890;606;598;217;381
16;40701;40700;88-100;1018;671;663;278;385
17;40701;40700;88-100;964;623;623;243;380
18;40701;40700;88-100;907;579;572;241;331
19;40701;40700;88-100;1708;1337;1324;427;897
20;40701;40700;88-100;1775;1335;1327;438;889
21;40701;40700;88-100;801;587;581;234;347
22;40701;40700;88-100;1279;722;715;335;380
23;40701;40700;88-100;963;631;626;308;318
24;40701;40700;88-100;1014;667;661;225;436
25;40701;40700;88-100;1104;772;766;249;517
26;40701;40700;88-100;1460;928;917;355;562
27;40701;40700;88-100;858;661;657;240;417
28;40701;40700;88-100;1150;903;896;351;545
29;40701;40700;88-100;1052;759;750;199;551
30;40701;40700;88-100;1024;716;712;267;445
31;40701;40700;88-100;568;399;394;133;261
32;40701;40700;88-100;989;700;698;249;449
33;40701;40700;88-100;1637;1171;1163;442;721
34;40701;40700;88-100;672;484;480;156;324
35;40701;40700;88-100;818;642;640;258;382
36;40701;40700;88-100;913;682;680;224;456
37;40701;40700;88-100;1074;773;768;267;501
38;40701;40700;88-100;961;688;678;265;413
39;40701;40700;88-100;987;725;724;263;461
40;40701;40700;88-100;1117;794;788;268;520
41;40701;40700;88-100;894;639;633;255;378
42;40701;40700;88-100;1056;810;802;292;510
43;40701;40700;88-100;1622;1167;1163;429;734
44;40701;40700;88-100;1183;857;849;333;516
45;40701;40700;88-100;1473;1078;1071;403;668
46;40701;40700;88-100;79;43;42;24;18
47;40701;40700;88-100;184;53;53;27;26
48;40701;40700;88-100;326;207;206;11;195
49;40701;40700;88-100;648;554;552;216;336
50;40701;40700;88-100;510;463;458;193;265
1;40702;40700;88-133;827;468;461;287;174
2;40702;40700;88-133;851;487;481;303;178
3;40702;40700;88-133;515;313;313;205;108
4;40702;40700;88-133;190;117;114;71;43
5;40702;40700;88-133;164;104;104;69;35
6;40702;40700;88-110;675;399;398;226;172
7;40702;40700;88-133;237;146;144;84;60
8;40702;40700;88-133;329;184;183;100;83
1;40703;40700;88-140;797;534;525;240;285
2;40703;40700;88-140;803;566;562;250;312
3;40703;40700;88-140;520;295;291;151;140
4;40703;40700;88-140;871;612;606;325;281
5;40703;40700;88-140;1026;614;611;354;257
6;40703;40700;88-140;925;627;619;317;302
7;40703;40700;88-140;613;315;311;187;124
8;40703;40700;88-140;797;520;512;294;218
9;40703;40700;88-140;407;234;233;140;93
10;40703;40700;88-140;392;273;271;198;73
11;40703;40700;88-140;311;202;201;128;73
12;40703;40700;88-140;453;310;307;169;138
13;40703;40700;88-140;225;146;144;81;63
14;40703;40700;88-140;397;252;251;152;99
15;40703;40700;88-140;184;109;109;59;50
16;40703;40700;88-140;226;135;131;80;51
17;40703;40700;88-140;218;133;133;83;50
18;40703;40700;88-140;242;168;168;139;29
19;40703;40700;88-140;175;84;84;61;23
20;40703;40700;88-140;330;199;197;139;58
21;40703;40700;88-140;324;223;222;105;117
22;40703;40700;88-140;51;27;24;15;9
1;40704;40700;88-101;554;357;354;185;169
2;40704;40700;88-110;665;444;441;238;203
3;40704;40700;88-110;369;225;223;125;98
4;40704;40700;88-101;635;407;402;243;159
5;40704;40700;88-110;525;428;426;152;274
6;40704;40700;88-181;1435;849;839;460;379
7;40704;40700;88-110;696;456;452;240;212
8;40704;40700;88-101;585;390;385;225;160
9;40704;40700;88-101;342;211;211;109;102
10;40704;40700;88-110;663;486;480;238;242
11;40704;40700;88-101;283;197;195;71;124
12;40704;40700;88-110;609;393;389;216;173
13;40704;40700;88-110;422;273;271;185;86
14;40704;40700;88-110;440;289;283;145;138
15;40704;40700;88-110;563;377;370;178;192
16;40704;40700;88-101;330;212;212;106;106
1;40705;40700;88-160;776;494;486;252;234
2;40705;40700;88-160;1099;738;730;386;344
3;40705;40700;88-160;1181;697;690;396;294
4;40705;40700;88-160;562;354;346;149;197
5;40705;40700;88-160;1203;814;807;419;388
6;40705;40700;88-160;1472;999;992;462;530
7;40705;40700;88-160;636;407;404;229;175
8;40705;40700;88-160;892;584;577;372;205
9;40705;40700;88-160;721;389;385;241;144
10;40705;40700;88-160;422;255;254;166;88
11;40705;40700;88-160;594;366;359;217;142
1;40706;40700;88-150;663;425;421;223;198
2;40706;40700;88-150;933;596;594;313;281
3;40706;40700;88-153;1071;713;707;329;378
4;40706;40700;88-153;1207;860;852;412;440
5;40706;40700;88-150;1368;963;952;436;516
6;40706;40700;88-150;382;230;226;158;68
7;40706;40700;88-121;511;326;323;150;173
8;40706;40700;88-121;336;228;227;135;92
9;40706;40700;88-121;471;266;260;167;93
10;40706;40700;88-150;564;314;313;182;131
11;40706;40700;88-153;489;272;270;183;87
12;40706;40700;88-150;544;311;306;223;83
13;40706;40700;88-150;362;184;183;119;64
14;40706;40700;88-121;377;216;214;125;89
15;40706;40700;88-153;642;366;364;211;153
16;40706;40700;88-150;649;423;420;306;114
17;40706;40700;88-150;496;302;299;188;111
18;40706;40700;88-150;243;147;146;101;45
19;40706;40700;88-153;192;129;129;76;53
20;40706;40700;88-150;660;406;404;184;220
21;40706;40700;88-153;910;607;606;240;366
22;40706;40700;88-153;405;227;225;154;71
23;40706;40700;88-121;177;93;92;66;26
1;40707;40700;88-170;1011;689;678;326;352
2;40707;40700;88-170;851;579;576;295;281
3;40707;40700;88-170;1010;582;576;313;263
4;40707;40700;88-170;688;391;389;225;164
5;40707;40700;88-170;241;133;132;62;70
6;40707;40700;88-170;349;216;211;120;91
7;40707;40700;88-170;971;651;645;330;315
8;40707;40700;88-170;1027;641;634;392;242
9;40707;40700;88-170;191;119;119;78;41
10;40707;40700;88-170;307;212;212;122;90
11;40707;40700;88-170;387;255;252;153;99
1;40708;40700;88-111;434;307;302;193;109
2;40708;40700;88-111;583;324;318;172;146
3;40708;40700;88-180;441;280;277;200;77
4;40708;40700;88-111;646;392;389;255;134
5;40708;40700;88-111;391;236;231;158;73
6;40708;40700;88-111;578;342;338;220;118
7;40708;40700;88-181;224;139;139;99;40
8;40708;40700;88-111;187;122;122;80;42
1;40709;40700;88-180;1338;922;914;446;468
2;40709;40700;88-180;1223;736;727;431;296
3;40709;40700;88-180;518;330;330;207;123
4;40709;40700;88-180;263;174;172;107;65
5;40709;40700;88-180;451;257;253;161;92
6;40709;40700;88-180;432;301;301;153;148
7;40709;40700;88-180;508;275;273;178;95
8;40709;40700;86-060;372;214;211;131;80
9;40709;40700;88-180;270;164;161;90;71
10;40709;40700;88-180;905;642;640;318;322
11;40709;40700;86-060;167;128;128;66;62
12;40709;40700;86-060;311;209;206;113;93
1;40801;40800;87-600;1713;1117;1100;550;550
2;40801;40800;87-600;1299;743;734;339;395
3;40801;40800;87-600;1126;637;631;289;342
4;40801;40800;87-600;1280;773;767;395;372
5;40801;40800;87-600;672;455;453;249;204
6;40801;40800;87-600;1062;668;663;283;380
7;40801;40800;87-600;1294;800;792;371;421
8;40801;40800;87-600;750;509;501;226;275
9;40801;40800;87-600;665;465;461;172;289
10;40801;40800;87-600;251;73;73;51;22
1;40802;40800;87-617;654;481;476;241;235
2;40802;40800;87-617;461;280;276;169;107
3;40802;40800;87-617;626;337;333;229;104
4;40802;40800;87-617;274;143;141;93;48
5;40802;40800;87-617;303;177;175;107;68
1;40803;40800;87-602;546;341;339;235;104
2;40803;40800;87-602;696;412;411;303;108
3;40803;40800;87-602;464;269;269;208;61
4;40803;40800;87-602;463;265;264;188;76
1;40804;40800;87-610;755;454;452;274;178
2;40804;40800;87-610;797;567;563;339;224
3;40804;40800;87-610;689;411;408;282;126
4;40804;40800;87-610;412;248;248;166;82
5;40804;40800;87-610;704;410;405;296;109
6;40804;40800;87-610;691;432;427;279;148
7;40804;40800;87-610;364;226;224;175;49
8;40804;40800;87-610;350;245;239;169;70
9;40804;40800;87-610;383;235;231;164;67
10;40804;40800;87-610;413;218;217;147;70
1;40805;40800;87-620;670;445;438;237;201
2;40805;40800;87-620;875;589;584;314;270
3;40805;40800;87-620;292;172;170;137;33
4;40805;40800;87-620;171;103;102;69;33
5;40805;40800;87-620;852;476;469;303;166
6;40805;40800;87-620;514;316;311;177;134
7;40805;40800;87-620;263;128;128;106;22
8;40805;40800;87-620;173;121;120;79;41
9;40805;40800;87-620;181;108;107;86;21
10;40805;40800;87-620;374;215;213;152;61
11;40805;40800;87-620;304;174;170;101;69
12;40805;40800;87-620;187;97;97;68;29
13;40805;40800;87-620;341;181;179;134;45
1;40806;40800;87-600;1238;797;791;427;364
2;40806;40800;87-600;447;288;288;191;97
3;40806;40800;87-600;957;603;600;422;178
4;40806;40800;87-600;504;305;302;202;100
5;40806;40800;87-600;1274;748;740;460;280
6;40806;40800;87-600;558;324;323;186;137
7;40806;40800;87-600;613;352;348;253;95
8;40806;40800;87-600;721;455;451;306;145
9;40806;40800;87-600;1085;689;688;447;241
10;40806;40800;87-600;147;88;87;68;19
11;40806;40800;87-600;525;304;302;148;154
12;40806;40800;87-600;277;164;163;123;40
13;40806;40800;87-600;297;172;167;108;59
1;40807;40800;87-630;1187;796;790;399;391
2;40807;40800;87-630;790;564;561;297;264
3;40807;40800;87-630;800;441;437;310;127
4;40807;40800;87-630;682;456;453;310;143
5;40807;40800;87-630;369;202;200;139;61
6;40807;40800;87-630;315;181;178;142;36
7;40807;40800;87-630;251;154;150;104;46
8;40807;40800;87-630;739;521;516;273;243
9;40807;40800;87-630;171;93;91;64;27
10;40807;40800;87-630;339;233;231;144;87
1;40808;40800;87-605;966;642;637;398;239
2;40808;40800;87-605;557;345;339;265;74
3;40808;40800;87-605;540;310;309;233;76
4;40808;40800;87-605;704;415;414;325;89
5;40808;40800;87-605;503;344;339;277;62
6;40808;40800;87-605;187;138;135;79;56
1;40809;40800;87-603;636;385;382;267;115
2;40809;40800;87-603;236;140;139;91;48
3;40809;40800;87-603;980;641;637;356;281
4;40809;40800;87-603;613;370;366;244;122
5;40809;40800;87-603;327;179;176;120;56
6;40809;40800;87-603;343;222;217;142;75
7;40809;40800;87-603;296;182;179;114;65
8;40809;40800;87-603;313;191;190;138;52
9;40809;40800;87-603;267;167;163;104;59
10;40809;40800;87-600;287;171;170;117;53
11;40809;40800;87-603;320;188;187;126;61
12;40809;40800;87-603;243;135;134;96;38
13;40809;40800;87-603;66;47;45;11;34
1;40901;40900;88-306;599;393;388;162;226
2;40901;40900;88-306;467;259;255;150;105
3;40901;40900;88-306;593;307;305;181;124
4;40901;40900;88-306;451;259;256;157;99
5;40901;40900;88-306;609;338;335;218;117
6;40901;40900;88-306;650;424;421;264;157
1;40902;40900;88-324;606;384;378;212;166
2;40902;40900;88-324;523;310;310;221;89
3;40902;40900;88-324;829;559;549;327;222
4;40902;40900;88-324;481;264;261;178;83
5;40902;40900;88-324;413;273;268;182;86
6;40902;40900;88-324;404;245;245;175;70
7;40902;40900;88-324;259;179;178;142;36
8;40902;40900;88-324;19;15;14;8;6
1;40903;40900;88-300;1280;901;897;338;559
2;40903;40900;88-300;1249;794;788;374;414
3;40903;40900;88-300;1171;798;790;358;432
4;40903;40900;88-300;1136;783;773;322;451
5;40903;40900;88-300;1348;892;888;387;501
6;40903;40900;88-300;1410;933;921;415;506
7;40903;40900;88-300;1600;1123;1107;533;574
8;40903;40900;88-342;1032;685;673;405;268
9;40903;40900;88-300;957;616;612;325;287
10;40903;40900;88-300;479;284;280;154;126
11;40903;40900;88-300;848;540;534;263;271
12;40903;40900;88-300;925;554;551;325;226
13;40903;40900;88-300;688;363;356;246;110
14;40903;40900;88-330;764;463;458;241;217
15;40903;40900;88-330;1079;680;675;389;286
16;40903;40900;88-321;909;557;549;341;208
17;40903;40900;88-300;670;437;427;193;234
18;40903;40900;88-300;297;196;195;118;77
19;40903;40900;88-330;271;184;183;136;47
20;40903;40900;88-330;274;155;152;84;68
21;40903;40900;88-300;23;17;17;6;11
1;40904;40900;88-320;1223;796;789;357;432
2;40904;40900;88-320;1006;695;684;314;370
3;40904;40900;88-320;1175;728;721;347;374
4;40904;40900;88-320;290;178;176;105;71
5;40904;40900;88-320;504;303;298;169;129
6;40904;40900;88-320;518;352;346;234;112
7;40904;40900;88-320;507;295;291;171;120
8;40904;40900;88-320;757;453;448;291;157
9;40904;40900;88-320;613;373;366;252;114
10;40904;40900;88-320;595;316;314;165;149
11;40904;40900;88-320;260;151;148;104;44
12;40904;40900;88-320;536;340;337;192;145
13;40904;40900;88-320;458;274;273;200;73
14;40904;40900;88-320;46;9;8;6;2
1;41001;41000;89-240;1291;829;822;375;447
2;41001;41000;89-240;1248;794;783;372;411
3;41001;41000;89-240;977;648;640;333;307
4;41001;41000;89-240;435;262;259;175;84
5;41001;41000;89-240;512;356;355;237;118
6;41001;41000;89-240;658;416;414;260;154
7;41001;41000;89-240;868;572;569;335;234
8;41001;41000;89-240;310;167;167;124;43
9;41001;41000;89-240;616;357;351;227;124
10;41001;41000;89-240;308;174;173;124;49
11;41001;41000;89-240;546;301;299;218;81
12;41001;41000;89-240;472;291;290;209;81
13;41001;41000;89-240;299;159;154;91;63
14;41001;41000;89-240;248;154;154;89;65
15;41001;41000;89-240;230;148;147;82;65
16;41001;41000;89-240;274;159;159;99;60
1;41002;41000;89-115;798;480;479;262;217
2;41002;41000;89-115;349;189;189;76;113
3;41002;41000;89-115;990;571;564;289;275
4;41002;41000;89-115;929;558;555;206;349
5;41002;41000;89-115;550;307;301;189;112
6;41002;41000;89-115;268;161;157;69;88
7;41002;41000;89-115;506;304;303;196;107
8;41002;41000;89-115;326;182;177;106;71
9;41002;41000;89-115;189;113;113;63;50
10;41002;41000;89-114;535;309;305;182;123
11;41002;41000;89-114;370;230;228;181;47
12;41002;41000;89-115;166;113;110;57;53
13;41002;41000;89-115;177;123;121;82;39
14;41002;41000;89-115;268;144;144;81;63
15;41002;41000;89-115;171;88;88;61;27
1;41003;41000;89-100;959;688;685;319;366
2;41003;41000;89-100;1306;939;931;364;567
3;41003;41000;89-100;1493;926;917;442;475
4;41003;41000;89-100;1031;652;645;326;319
5;41003;41000;89-100;632;365;360;168;192
6;41003;41000;89-100;1057;688;685;283;402
7;41003;41000;89-100;633;400;394;196;198
8;41003;41000;89-100;1131;721;716;368;348
9;41003;41000;89-100;1230;842;834;343;491
10;41003;41000;89-100;1121;851;845;337;508
11;41003;41000;89-100;852;594;592;207;385
12;41003;41000;89-100;431;285;282;128;154
13;41003;41000;89-100;193;101;98;57;41
14;41003;41000;89-100;977;641;639;296;343
15;41003;41000;89-100;1389;979;968;413;555
16;41003;41000;89-120;1359;906;904;390;514
17;41003;41000;89-121;1146;791;781;369;412
18;41003;41000;89-121;280;171;170;102;68
19;41003;41000;89-100;559;384;383;196;187
20;41003;41000;89-100;268;166;161;65;96
21;41003;41000;89-100;188;134;134;56;78
22;41003;41000;89-100;214;135;135;67;68
23;41003;41000;89-100;302;210;206;98;108
24;41003;41000;89-100;177;114;112;64;48
25;41003;41000;89-122;286;180;177;72;105
26;41003;41000;89-100;241;177;176;75;101
27;41003;41000;89-100;539;390;383;196;187
28;41003;41000;89-100;182;143;143;88;55
29;41003;41000;89-100;940;696;686;300;386
30;41003;41000;89-100;993;688;684;322;362
31;41003;41000;89-120;915;722;716;99;617
32;41003;41000;89-100;46;11;11;5;6
33;41003;41000;89-100;59;41;38;15;23
34;41003;41000;89-120;138;130;128;19;109
1;41004;41000;89-110;753;513;509;256;253
2;41004;41000;89-110;783;531;527;264;263
3;41004;41000;89-110;408;241;237;115;122
4;41004;41000;89-110;325;236;236;187;49
5;41004;41000;89-110;417;222;222;147;75
6;41004;41000;89-110;445;252;250;142;108
7;41004;41000;89-110;439;242;241;167;74
8;41004;41000;89-110;493;322;317;201;116
9;41004;41000;89-110;502;312;307;154;153
10;41004;41000;89-110;328;206;206;137;69
11;41004;41000;89-110;174;119;118;66;52
12;41004;41000;89-110;223;150;147;76;71
1;41005;41000;89-200;885;633;628;307;321
2;41005;41000;89-200;1028;684;679;296;383
3;41005;41000;89-200;672;496;493;190;303
4;41005;41000;89-200;857;614;608;219;389
5;41005;41000;89-200;780;507;504;181;323
6;41005;41000;89-200;675;413;409;186;223
7;41005;41000;89-200;752;473;463;222;241
8;41005;41000;89-200;1131;849;843;284;559
9;41005;41000;89-200;1290;881;875;414;461
10;41005;41000;89-200;2149;1536;1524;632;892
11;41005;41000;89-200;1607;1178;1174;507;667
12;41005;41000;89-200;819;559;553;253;300
13;41005;41000;89-200;684;412;405;243;162
14;41005;41000;89-200;353;252;250;105;145
15;41005;41000;89-200;822;460;456;260;196
16;41005;41000;89-200;520;322;320;222;98
17;41005;41000;89-200;423;233;231;142;89
18;41005;41000;89-200;640;431;427;252;175
19;41005;41000;89-200;897;600;592;292;300
20;41005;41000;89-200;305;182;180;98;82
21;41005;41000;89-200;167;107;106;75;31
22;41005;41000;89-200;249;148;145;90;55
23;41005;41000;89-200;229;172;169;107;62
24;41005;41000;89-200;544;345;340;183;157
25;41005;41000;89-200;25;21;21;11;10
1;41101;41100;88-200;798;540;538;286;252
2;41101;41100;88-200;804;544;543;306;237
3;41101;41100;88-200;772;489;485;274;211
4;41101;41100;88-200;817;559;554;286;268
5;41101;41100;88-200;750;518;510;240;270
6;41101;41100;88-200;190;83;83;46;37
1;41102;41100;88-231;674;436;434;305;129
2;41102;41100;88-231;398;255;252;191;61
3;41102;41100;88-231;593;390;383;279;104
4;41102;41100;88-231;561;354;351;258;93
5;41102;41100;88-231;381;241;240;192;48
1;41103;41100;88-210;1016;651;646;387;259
2;41103;41100;88-210;460;290;288;193;95
3;41103;41100;88-210;1082;641;636;484;152
4;41103;41100;88-210;434;281;279;191;88
5;41103;41100;88-210;167;102;102;83;19
6;41103;41100;88-210;762;429;423;287;136
1;41104;41100;88-220;1210;776;767;511;256
2;41104;41100;88-220;633;398;397;311;86
3;41104;41100;88-220;1235;829;825;426;399
4;41104;41100;88-220;646;420;413;282;131
5;41104;41100;88-220;672;419;418;342;76
6;41104;41100;88-220;396;237;234;169;65
7;41104;41100;88-220;401;231;229;157;72
8;41104;41100;88-220;310;183;183;153;30
9;41104;41100;88-220;153;120;120;92;28
1;41105;41100;88-230;1424;928;921;538;383
2;41105;41100;88-230;808;470;468;277;191
3;41105;41100;88-230;966;606;600;347;253
4;41105;41100;88-230;370;200;200;142;58
5;41105;41100;88-230;203;124;123;105;18
6;41105;41100;88-230;500;311;309;232;77
7;41105;41100;88-230;484;317;316;220;96
8;41105;41100;88-230;514;306;305;255;50
9;41105;41100;88-230;425;272;272;189;83
10;41105;41100;88-230;447;257;251;188;63
11;41105;41100;88-230;514;315;314;230;84
12;41105;41100;88-230;229;150;148;125;23
13;41105;41100;88-230;64;32;29;10;19
1;41106;41100;88-200;405;265;265;184;81
2;41106;41100;88-200;302;231;229;145;84
3;41106;41100;88-200;355;203;199;115;84
4;41106;41100;88-200;347;203;203;123;80
5;41106;41100;88-200;236;141;140;96;44
6;41106;41100;88-200;392;256;252;166;86
7;41106;41100;88-200;401;250;249;151;98
8;41106;41100;88-200;322;205;205;149;56
9;41106;41100;88-200;228;164;162;95;67
10;41106;41100;88-200;291;213;210;156;54
1;41107;41100;87-875;436;267;266;174;92
2;41107;41100;87-875;729;450;447;323;124
3;41107;41100;87-875;767;515;512;277;235
4;41107;41100;87-875;576;396;393;247;146
5;41107;41100;87-875;381;234;230;175;55
6;41107;41100;87-875;386;304;302;159;143
7;41107;41100;87-875;598;404;395;281;114
1;41201;41200;87-500;767;472;466;243;223
2;41201;41200;87-500;582;344;342;179;163
3;41201;41200;87-500;680;406;403;200;203
4;41201;41200;87-500;936;608;600;266;334
5;41201;41200;87-500;1005;665;655;296;359
6;41201;41200;87-500;850;632;626;272;354
7;41201;41200;87-500;630;455;451;229;222
8;41201;41200;87-500;769;540;534;224;310
9;41201;41200;87-500;753;467;465;210;255
10;41201;41200;87-500;672;495;490;189;301
11;41201;41200;87-500;864;559;554;307;247
12;41201;41200;87-500;669;450;450;191;259
13;41201;41200;87-500;777;584;579;238;341
14;41201;41200;87-500;770;361;357;206;151
15;41201;41200;87-500;714;492;492;220;272
16;41201;41200;87-500;127;56;55;27;28
1;41202;41200;87-522;1044;630;624;357;267
2;41202;41200;87-522;992;576;566;406;160
3;41202;41200;87-517;456;270;268;166;102
4;41202;41200;87-517;348;236;236;126;110
5;41202;41200;87-517;280;196;193;131;62
6;41202;41200;87-517;215;146;146;116;30
7;41202;41200;87-517;295;164;163;111;52
8;41202;41200;87-517;312;199;197;116;81
9;41202;41200;87-517;44;17;17;13;4
1;41203;41200;87-515;894;583;581;412;169
2;41203;41200;87-515;266;152;152;131;21
3;41203;41200;87-515;558;318;317;211;106
4;41203;41200;87-515;197;103;100;67;33
5;41203;41200;87-515;850;525;522;412;110
6;41203;41200;87-515;467;296;296;173;123
7;41203;41200;87-515;235;166;165;118;47
8;41203;41200;87-515;191;108;108;79;29
1;41204;41200;87-500;698;425;424;269;155
2;41204;41200;87-500;536;337;335;179;156
3;41204;41200;87-500;532;320;318;204;114
4;41204;41200;87-500;818;486;480;346;134
5;41204;41200;87-500;464;255;252;168;84
6;41204;41200;87-500;607;363;358;229;129
7;41204;41200;87-500;202;116;116;92;24
8;41204;41200;87-500;483;308;306;180;126
9;41204;41200;87-500;489;310;306;145;161
10;41204;41200;87-500;214;134;134;82;52
11;41204;41200;87-500;325;201;200;130;70
12;41204;41200;87-500;296;182;180;114;66
1;41205;41200;87-510;905;535;532;387;145
2;41205;41200;87-510;826;564;561;345;216
3;41205;41200;87-510;359;192;192;143;49
4;41205;41200;87-510;689;444;441;339;102
5;41205;41200;87-510;297;179;179;153;26
6;41205;41200;87-510;859;551;547;425;122
7;41205;41200;87-510;171;126;126;78;48
8;41205;41200;87-510;243;124;124;90;34
1;41206;41200;87-337;613;372;371;235;136
2;41206;41200;87-337;336;170;170;119;51
3;41206;41200;87-337;602;373;371;244;127
4;41206;41200;87-337;550;306;304;226;78
5;41206;41200;87-337;378;227;226;159;67
6;41206;41200;87-337;559;325;319;193;126
1;41301;41300;89-430;932;560;552;251;301
2;41301;41300;89-430;657;451;447;222;225
3;41301;41300;89-430;348;196;193;127;66
4;41301;41300;89-430;420;235;235;152;83
5;41301;41300;89-430;776;510;506;312;194
6;41301;41300;89-430;532;335;331;231;100
7;41301;41300;89-430;465;291;290;158;132
8;41301;41300;89-430;410;266;260;139;121
9;41301;41300;89-430;307;210;205;118;87
10;41301;41300;89-430;57;26;25;11;14
1;41302;41300;89-400;666;413;410;214;196
2;41302;41300;89-400;817;512;509;242;267
3;41302;41300;89-400;741;514;511;237;274
4;41302;41300;89-400;1130;807;797;348;449
5;41302;41300;89-400;825;591;588;239;349
6;41302;41300;89-400;744;498;497;174;323
7;41302;41300;89-400;509;342;337;118;219
8;41302;41300;89-400;530;385;383;114;269
9;41302;41300;89-400;564;399;399;156;243
10;41302;41300;89-400;572;314;311;186;125
11;41302;41300;89-400;722;414;413;217;196
12;41302;41300;89-400;687;464;461;272;189
13;41302;41300;89-400;836;536;533;249;284
14;41302;41300;89-400;513;296;295;170;125
15;41302;41300;89-405;691;412;412;259;153
16;41302;41300;89-400;385;215;215;133;82
17;41302;41300;89-400;358;211;210;136;74
18;41302;41300;89-400;199;106;106;53;53
1;41303;41300;89-412;415;254;254;168;86
2;41303;41300;89-412;438;273;270;162;108
3;41303;41300;89-412;628;434;431;236;195
4;41303;41300;89-413;760;431;428;282;146
5;41303;41300;89-413;427;221;217;140;77
6;41303;41300;89-412;207;114;113;74;39
7;41303;41300;89-412;313;177;177;123;54
8;41303;41300;89-413;241;161;160;118;42
1;41304;41300;89-410;1148;809;803;322;481
2;41304;41300;89-410;1012;608;604;283;321
3;41304;41300;89-410;622;410;410;205;205
4;41304;41300;89-410;642;387;382;194;188
5;41304;41300;89-410;617;374;366;187;179
6;41304;41300;89-410;673;365;362;247;115
7;41304;41300;89-410;340;211;209;124;85
8;41304;41300;89-421;1100;638;633;380;253
9;41304;41300;89-410;812;524;522;274;248
10;41304;41300;89-410;350;194;193;131;62
11;41304;41300;89-422;513;297;292;192;100
12;41304;41300;89-422;829;535;526;220;306
13;41304;41300;89-410;210;128;127;82;45
14;41304;41300;89-410;262;151;150;98;52
15;41304;41300;89-410;300;192;189;119;70
16;41304;41300;89-410;18;18;16;10;6
17;41304;41300;89-410;20;15;14;4;10
1;41401;41400;86-122;830;546;540;286;254
2;41401;41400;86-122;558;379;376;217;159
3;41401;41400;86-122;483;262;260;157;103
4;41401;41400;86-122;582;337;335;243;92
5;41401;41400;86-122;690;398;396;292;104
6;41401;41400;86-122;562;360;355;274;81
1;41402;41400;86-134;413;217;212;119;93
2;41402;41400;86-134;500;326;325;162;163
3;41402;41400;86-134;332;189;187;106;81
4;41402;41400;86-134;669;415;411;249;162
5;41402;41400;86-134;708;391;388;190;198
6;41402;41400;86-134;582;375;372;143;229
7;41402;41400;86-134;397;244;242;115;127
8;41402;41400;86-134;471;345;339;106;233
9;41402;41400;86-134;206;114;114;64;50
10;41402;41400;86-134;431;263;261;136;125
11;41402;41400;86-170;194;100;100;65;35
12;41402;41400;86-134;263;160;159;94;65
1;41403;41400;86-140;913;643;634;339;295
2;41403;41400;86-140;488;299;298;212;86
3;41403;41400;86-140;609;337;334;241;93
4;41403;41400;86-140;938;606;605;400;205
5;41403;41400;86-140;413;266;265;198;67
6;41403;41400;86-140;263;173;173;96;77
1;41404;41400;86-131;822;490;482;322;160
2;41404;41400;86-131;1081;720;717;370;347
3;41404;41400;86-131;900;548;539;313;226
4;41404;41400;86-131;1197;765;758;419;339
5;41404;41400;86-131;434;258;257;145;112
6;41404;41400;86-131;824;495;489;354;135
7;41404;41400;86-131;374;225;222;155;67
8;41404;41400;86-131;191;119;117;74;43
1;41405;41400;86-141;598;414;409;274;135
2;41405;41400;86-141;678;459;453;329;124
3;41405;41400;86-141;737;494;488;300;188
4;41405;41400;86-141;456;273;273;177;96
5;41405;41400;86-141;678;458;453;240;213
1;41406;41400;86-170;913;599;597;267;330
2;41406;41400;86-170;1079;604;599;294;305
3;41406;41400;86-170;1152;685;682;339;343
4;41406;41400;86-170;811;561;556;221;335
5;41406;41400;86-170;604;339;336;215;121
6;41406;41400;86-170;641;344;342;221;121
7;41406;41400;86-170;285;147;146;75;71
8;41406;41400;86-170;300;172;172;103;69
9;41406;41400;86-170;580;325;321;165;156
10;41406;41400;86-170;511;252;250;139;111
11;41406;41400;86-170;250;110;110;76;34
1;41407;41400;86-150;961;604;600;336;264
2;41407;41400;86-150;741;408;403;210;193
3;41407;41400;86-150;318;197;195;96;99
4;41407;41400;86-150;837;563;556;267;289
5;41407;41400;86-150;785;483;481;257;224
6;41407;41400;86-150;617;422;416;197;219
1;41408;41400;86-120;777;539;536;253;283
2;41408;41400;86-120;1045;763;757;362;395
3;41408;41400;86-120;434;296;290;217;73
4;41408;41400;86-120;564;410;405;194;211
5;41408;41400;86-120;405;277;276;187;89
6;41408;41400;86-120;500;343;341;223;118
7;41408;41400;86-120;453;320;317;182;135
8;41408;41400;86-120;187;112;112;91;21
9;41408;41400;86-120;180;108;106;53;53
10;41408;41400;86-120;156;104;104;66;38
11;41408;41400;86-120;283;171;171;76;95
12;41408;41400;86-120;241;144;144;88;56
13;41408;41400;86-120;263;167;165;86;79
14;41408;41400;86-120;482;345;340;137;203
15;41408;41400;86-120;422;285;282;161;121
16;41408;41400;86-120;422;224;224;142;82
17;41408;41400;86-120;86;38;36;19;17
18;41408;41400;86-120;39;30;28;15;13
1;41409;41400;86-100;1358;1054;1040;334;706
2;41409;41400;86-100;1447;1007;998;336;662
3;41409;41400;86-100;838;403;399;189;210
4;41409;41400;86-100;1056;630;627;292;335
5;41409;41400;86-100;1200;690;683;294;389
6;41409;41400;86-100;1023;763;760;315;445
7;41409;41400;86-105;1372;952;944;339;605
8;41409;41400;86-105;922;597;592;217;375
9;41409;41400;86-105;1401;952;944;332;612
10;41409;41400;86-105;1468;1033;1025;379;646
11;41409;41400;86-105;1022;717;712;274;438
12;41409;41400;86-105;819;662;654;228;426
13;41409;41400;86-105;1884;1433;1413;492;921
14;41409;41400;86-105;968;671;664;309;355
15;41409;41400;86-105;928;479;476;270;206
16;41409;41400;86-105;1093;708;700;370;330
17;41409;41400;86-105;356;217;216;122;94
18;41409;41400;86-105;1206;727;717;382;335
19;41409;41400;86-100;797;424;422;234;188
20;41409;41400;86-100;924;636;633;221;412
21;41409;41400;86-100;529;288;286;172;114
22;41409;41400;86-100;426;288;287;186;101
23;41409;41400;86-100;340;241;239;124;115
24;41409;41400;86-100;64;43;42;17;25
25;41409;41400;86-100;377;185;181;94;87
26;41409;41400;86-100;37;24;23;20;3
1;41410;41400;86-182;588;437;433;237;196
2;41410;41400;86-182;563;388;386;199;187
3;41410;41400;86-182;503;308;301;144;157
4;41410;41400;86-182;198;133;131;95;36
5;41410;41400;86-182;198;141;140;109;31
6;41410;41400;86-182;382;263;260;175;85
7;41410;41400;86-182;237;137;134;90;44
8;41410;41400;86-182;147;74;73;49;24
1;41411;41400;86-160;826;524;520;326;194
2;41411;41400;86-160;572;304;302;194;108
3;41411;41400;86-160;179;87;87;67;20
4;41411;41400;86-160;346;194;191;97;94
5;41411;41400;86-160;961;491;487;316;171
6;41411;41400;86-160;579;384;382;244;138
7;41411;41400;86-160;272;153;152;94;58
8;41411;41400;86-160;219;139;136;73;63
9;41411;41400;86-160;773;475;471;251;220
1;41501;41500;87-140;1799;985;978;492;486
2;41501;41500;87-140;1274;712;704;338;366
3;41501;41500;87-140;1289;820;818;384;434
4;41501;41500;87-140;1976;1245;1237;559;678
5;41501;41500;87-140;734;486;482;200;282
6;41501;41500;87-140;1266;844;843;407;436
7;41501;41500;87-140;1515;1014;1010;442;568
8;41501;41500;87-140;49;21;21;9;12
1;41502;41500;87-140;445;251;251;143;108
2;41502;41500;87-140;589;391;388;218;170
3;41502;41500;87-140;995;659;652;345;307
4;41502;41500;87-140;669;412;406;289;117
5;41502;41500;87-140;487;288;284;157;127
6;41502;41500;87-140;1168;734;728;476;252
7;41502;41500;87-140;591;399;394;222;172
8;41502;41500;87-140;456;275;272;142;130
9;41502;41500;87-140;335;220;218;137;81
10;41502;41500;87-140;409;258;256;165;91
11;41502;41500;87-140;624;407;401;240;161
12;41502;41500;87-140;359;233;226;135;91
13;41502;41500;87-140;109;70;69;49;20
14;41502;41500;87-140;85;18;13;5;8
1;41503;41500;87-640;1483;943;931;513;418
2;41503;41500;87-632;577;336;331;226;105
3;41503;41500;87-640;878;505;503;327;176
4;41503;41500;87-640;1393;833;829;530;299
5;41503;41500;87-640;1135;769;758;361;397
6;41503;41500;87-632;346;206;203;145;58
7;41503;41500;87-640;472;279;278;196;82
8;41503;41500;87-640;398;225;223;155;68
1;41504;41500;87-122;1061;818;813;457;356
2;41504;41500;87-162;660;450;446;258;188
3;41504;41500;87-162;1283;894;881;426;455
4;41504;41500;87-162;1103;735;726;308;418
5;41504;41500;87-122;809;558;553;337;216
6;41504;41500;87-162;744;536;533;296;237
7;41504;41500;87-162;483;338;335;186;149
8;41504;41500;87-162;748;574;571;222;349
9;41504;41500;87-124;1382;1006;1002;385;617
10;41504;41500;87-162;1113;820;812;356;456
11;41504;41500;87-124;817;633;630;241;389
12;41504;41500;87-122;1128;875;865;418;447
13;41504;41500;87-162;1240;865;858;434;424
14;41504;41500;87-162;786;617;604;218;386
15;41504;41500;87-124;993;777;766;242;524
16;41504;41500;87-162;582;399;394;187;207
17;41504;41500;87-162;375;276;275;134;141
1;41505;41500;87-152;416;292;289;153;136
2;41505;41500;87-152;1257;868;862;383;479
3;41505;41500;87-152;1562;1248;1237;509;728
4;41505;41500;87-152;342;231;229;143;86
5;41505;41500;87-152;765;473;470;269;201
6;41505;41500;87-152;529;388;385;246;139
7;41505;41500;87-152;580;360;354;233;121
8;41505;41500;87-152;562;395;395;175;220
1;41506;41500;87-148;841;598;596;284;312
2;41506;41500;87-148;1546;958;953;516;437
3;41506;41500;87-148;1855;1464;1450;501;949
4;41506;41500;87-148;1188;859;856;353;503
5;41506;41500;87-148;1253;965;952;375;577
6;41506;41500;87-148;605;383;382;231;151
7;41506;41500;87-148;668;429;424;246;178
1;41507;41500;87-123;1831;1386;1378;568;810
2;41507;41500;87-123;2417;1867;1848;868;980
3;41507;41500;87-123;1246;897;891;542;349
4;41507;41500;87-123;535;363;360;231;129
5;41507;41500;87-126;1774;1261;1249;687;562
6;41507;41500;87-125;1617;1198;1187;485;702
7;41507;41500;87-125;1431;1043;1031;383;648
8;41507;41500;87-123;965;751;746;380;366
9;41507;41500;87-126;734;482;478;342;136
10;41507;41500;87-123;675;473;469;256;213
11;41507;41500;87-125;1270;991;981;333;648
1;41508;41500;87-103;999;802;797;314;483
2;41508;41500;87-103;862;605;601;194;407
3;41508;41500;87-165;952;704;696;268;428
4;41508;41500;87-165;846;637;631;251;380
5;41508;41500;87-103;155;89;88;33;55
6;41508;41500;87-165;79;36;34;27;7
1;41509;41500;87-134;1564;1058;1049;485;564
2;41509;41500;87-134;787;528;522;291;231
3;41509;41500;87-134;946;577;572;344;228
4;41509;41500;87-134;764;512;504;242;262
5;41509;41500;87-134;666;510;508;200;308
6;41509;41500;87-134;1550;1149;1139;480;659
7;41509;41500;87-134;1095;828;820;297;523
8;41509;41500;87-134;970;667;658;300;358
9;41509;41500;87-134;542;330;326;193;133
10;41509;41500;87-134;749;460;451;256;195
11;41509;41500;87-134;1192;1014;1007;276;731
12;41509;41500;87-134;802;660;657;202;455
1;41601;41600;89-505;470;317;315;206;109
2;41601;41600;89-512;431;268;265;174;91
3;41601;41600;89-511;328;201;199;131;68
4;41601;41600;89-511;340;227;224;154;70
5;41601;41600;89-511;1085;765;762;415;347
6;41601;41600;89-511;1209;807;798;420;378
7;41601;41600;89-505;251;143;141;102;39
8;41601;41600;89-512;419;273;271;180;91
9;41601;41600;89-505;246;177;175;129;46
10;41601;41600;89-511;308;217;211;125;86
11;41601;41600;89-511;310;208;206;109;97
1;41602;41600;89-520;522;310;305;179;126
2;41602;41600;89-520;416;216;215;121;94
3;41602;41600;89-520;584;365;361;178;183
4;41602;41600;89-520;860;538;530;313;217
5;41602;41600;89-520;794;521;514;350;164
6;41602;41600;89-520;644;320;317;230;87
1;41603;41600;89-506;685;463;456;283;173
2;41603;41600;89-506;397;270;268;192;76
3;41603;41600;89-506;498;286;279;188;91
4;41603;41600;89-506;339;197;194;135;59
5;41603;41600;89-506;778;528;520;359;161
6;41603;41600;89-506;427;259;256;187;69
7;41603;41600;89-506;172;112;109;82;27
1;41604;41600;89-526;647;417;414;317;97
2;41604;41600;89-510;639;443;438;277;161
3;41604;41600;89-510;540;385;381;232;149
4;41604;41600;89-525;558;385;382;250;132
5;41604;41600;89-526;440;272;267;188;79
6;41604;41600;89-526;555;367;362;248;114
7;41604;41600;89-510;864;522;519;310;209
8;41604;41600;89-510;298;216;215;139;76
1;41605;41600;89-530;293;186;185;141;44
2;41605;41600;89-530;975;669;662;481;181
3;41605;41600;89-530;571;386;385;269;116
4;41605;41600;89-530;831;557;551;312;239
5;41605;41600;89-530;808;581;580;335;245
6;41605;41600;89-530;566;410;408;237;171
7;41605;41600;89-530;369;273;273;184;89
1;41606;41600;89-500;1076;706;698;349;349
2;41606;41600;89-500;1188;862;853;395;458
3;41606;41600;89-500;779;511;499;245;254
4;41606;41600;89-500;825;537;535;269;266
5;41606;41600;89-500;820;575;569;267;302
6;41606;41600;89-500;985;667;662;327;335
7;41606;41600;89-500;932;586;582;268;314
8;41606;41600;89-500;901;581;579;265;314
9;41606;41600;89-500;1139;805;797;372;425
10;41606;41600;89-500;475;318;316;177;139
11;41606;41600;89-500;481;327;326;213;113
12;41606;41600;89-502;459;257;255;169;86
13;41606;41600;89-500;685;443;439;289;150
14;41606;41600;89-500;253;139;136;96;40
15;41606;41600;89-504;1004;739;733;526;207
16;41606;41600;89-500;833;554;551;259;292
17;41606;41600;89-502;948;619;615;354;261
18;41606;41600;89-500;328;235;230;132;98
19;41606;41600;89-500;239;137;137;72;65
20;41606;41600;89-500;101;26;25;8;17
21;41606;41600;89-502;39;25;24;15;9
1;41701;41700;87-200;601;365;363;164;199
2;41701;41700;87-200;1258;799;796;304;492
3;41701;41700;87-200;644;494;488;137;351
4;41701;41700;87-200;1423;924;920;378;542
5;41701;41700;87-200;510;265;264;125;139
6;41701;41700;87-200;1139;781;775;276;499
7;41701;41700;87-200;558;328;326;111;215
8;41701;41700;87-200;1215;715;713;284;429
9;41701;41700;87-200;1236;737;733;323;410
10;41701;41700;87-200;589;406;399;169;230
11;41701;41700;87-200;61;13;13;2;11
1;41702;41700;87-207;834;492;491;311;180
2;41702;41700;87-207;660;373;372;266;106
3;41702;41700;87-207;848;511;506;320;186
1;41703;41700;87-222;893;531;525;303;222
2;41703;41700;87-222;891;539;538;315;223
3;41703;41700;87-222;676;389;385;256;129
4;41703;41700;87-222;582;319;317;224;93
1;41704;41700;87-214;690;472;463;260;203
2;41704;41700;87-214;694;418;415;265;150
3;41704;41700;87-214;683;423;421;271;150
4;41704;41700;87-214;960;601;597;354;243
5;41704;41700;87-214;407;235;234;149;85
1;41705;41700;87-200;750;450;449;250;199
2;41705;41700;87-213;1186;728;718;449;269
3;41705;41700;87-200;525;319;317;185;132
4;41705;41700;87-200;752;474;467;245;222
5;41705;41700;87-200;757;405;402;258;144
6;41705;41700;87-200;461;263;260;132;128
7;41705;41700;87-200;522;302;297;172;125
8;41705;41700;87-213;412;268;263;172;91
9;41705;41700;87-200;389;237;236;108;128
10;41705;41700;87-200;356;219;219;140;79
11;41705;41700;87-200;237;143;143;106;37
1;41801;41800;87-820;862;576;572;288;284
2;41801;41800;87-820;767;484;472;200;272
3;41801;41800;87-820;826;547;547;245;302
4;41801;41800;87-820;86;58;54;19;35
1;41802;41800;87-821;451;306;306;173;133
2;41802;41800;87-820;648;393;386;266;120
3;41802;41800;87-820;478;312;309;219;90
4;41802;41800;87-820;575;375;375;245;130
5;41802;41800;87-820;215;164;163;112;51
6;41802;41800;87-820;303;207;206;135;71
7;41802;41800;87-820;41;28;28;19;9
1;41803;41800;87-851;730;461;452;298;154
2;41803;41800;87-851;395;248;246;162;84
3;41803;41800;87-851;426;278;275;192;83
4;41803;41800;87-851;347;220;218;152;66
5;41803;41800;87-890;299;194;191;131;60
6;41803;41800;87-851;212;135;135;88;47
7;41803;41800;87-851;160;103;103;71;32
1;41804;41800;87-880;1079;722;712;303;409
2;41804;41800;87-880;1357;815;811;388;423
3;41804;41800;87-880;635;389;380;238;142
4;41804;41800;87-880;1200;804;797;466;331
5;41804;41800;87-880;671;389;383;267;116
6;41804;41800;87-880;572;310;307;193;114
7;41804;41800;87-880;663;394;389;232;157
8;41804;41800;87-880;472;298;293;165;128
9;41804;41800;87-880;998;597;587;272;315
10;41804;41800;87-880;303;205;204;139;65
11;41804;41800;87-880;237;170;170;73;97
12;41804;41800;87-800;1034;936;922;441;481
1;41805;41800;87-850;1431;860;854;486;368
2;41805;41800;87-850;818;485;482;325;157
3;41805;41800;87-850;741;441;440;257;183
4;41805;41800;87-850;1018;620;609;326;283
5;41805;41800;87-850;381;221;219;162;57
6;41805;41800;87-850;381;211;211;130;81
7;41805;41800;87-850;405;242;237;141;96
8;41805;41800;87-850;716;420;419;303;116
9;41805;41800;87-850;43;14;9;6;3
1;41806;41800;87-860;908;604;598;325;273
2;41806;41800;87-860;534;349;345;163;182
3;41806;41800;87-860;841;468;468;317;151
4;41806;41800;87-860;622;352;347;255;92
5;41806;41800;87-860;386;233;232;150;82
6;41806;41800;87-860;604;377;374;268;106
7;41806;41800;87-860;308;187;187;139;48
8;41806;41800;87-860;345;184;182;129;53
1;41807;41800;87-811;1182;827;817;282;535
2;41807;41800;87-811;1566;905;895;470;425
3;41807;41800;87-811;1297;853;841;466;375
4;41807;41800;87-811;1026;618;612;279;333
5;41807;41800;87-811;1489;987;978;414;564
6;41807;41800;87-811;440;270;267;162;105
7;41807;41800;87-811;693;559;555;209;346
1;41808;41800;87-865;1158;765;760;478;282
2;41808;41800;87-865;1306;851;847;626;221
3;41808;41800;87-865;699;432;432;327;105
4;41808;41800;87-865;1015;609;608;518;90
5;41808;41800;87-865;703;401;399;237;162
6;41808;41800;87-865;763;478;475;397;78
1;41809;41800;87-820;181;125;125;81;44
2;41809;41800;87-820;632;387;387;262;125
3;41809;41800;87-853;416;302;301;162;139
4;41809;41800;87-820;759;449;445;332;113
5;41809;41800;87-820;730;480;475;286;189
6;41809;41800;87-820;368;272;268;180;88
1;41810;41800;87-732;596;390;390;268;122
2;41810;41800;87-732;899;662;657;420;237
3;41810;41800;87-732;779;544;540;338;202
4;41810;41800;87-732;705;473;467;352;115
5;41810;41800;87-732;478;317;314;219;95
1;41811;41800;87-840;964;626;616;326;290
2;41811;41800;87-840;673;384;380;256;124
3;41811;41800;87-840;787;454;450;324;126
4;41811;41800;87-840;398;226;225;175;50
5;41811;41800;87-840;385;219;218;166;52
6;41811;41800;87-840;563;311;308;237;71
7;41811;41800;87-840;457;306;304;221;83
8;41811;41800;87-840;367;214;214;156;58
9;41811;41800;87-840;710;398;396;320;76
10;41811;41800;87-840;31;15;14;9;5
1;41812;41800;87-890;1314;871;860;441;419
2;41812;41800;87-890;1290;850;843;450;393
3;41812;41800;87-890;937;613;607;348;259
4;41812;41800;87-890;501;296;293;218;75
5;41812;41800;87-890;646;423;419;314;105
6;41812;41800;87-865;499;331;328;239;89
7;41812;41800;87-890;530;344;341;238;103
8;41812;41800;87-890;312;228;227;141;86
9;41812;41800;87-890;302;204;201;146;55
10;41812;41800;87-890;313;195;195;132;63
11;41812;41800;87-890;301;197;193;122;71
1;41813;41800;87-815;311;240;238;135;103
2;41813;41800;87-815;940;595;591;317;274
3;41813;41800;87-800;612;384;379;204;175
4;41813;41800;87-809;691;477;467;262;205
5;41813;41800;87-853;911;645;642;320;322
6;41813;41800;87-853;860;544;541;306;235
7;41813;41800;87-800;321;219;218;89;129
8;41813;41800;87-853;320;227;223;108;115
9;41813;41800;87-853;259;176;173;90;83
10;41813;41800;87-853;583;463;456;168;288
1;41901;41900;88-190;919;567;563;248;315
2;41901;41900;88-190;894;616;609;244;365
3;41901;41900;88-190;281;190;187;113;74
4;41901;41900;88-190;985;639;633;234;399
5;41901;41900;88-190;563;365;363;129;234
6;41901;41900;88-190;568;362;362;113;249
7;41901;41900;88-190;510;344;343;122;221
8;41901;41900;88-190;632;464;461;183;278
9;41901;41900;88-192;600;381;376;153;223
10;41901;41900;88-192;621;391;387;150;237
11;41901;41900;88-192;698;353;350;197;153
12;41901;41900;88-190;324;157;156;68;88
13;41901;41900;88-190;395;242;237;120;117
14;41901;41900;88-190;675;484;478;235;243
15;41901;41900;88-190;420;250;247;151;96
16;41901;41900;88-192;258;185;184;95;89
17;41901;41900;88-190;193;138;138;81;57
18;41901;41900;88-190;561;415;411;169;242
19;41901;41900;88-190;415;239;238;142;96
1;41902;41900;88-410;822;551;540;286;254
2;41902;41900;88-410;470;340;337;181;156
3;41902;41900;88-410;279;200;198;116;82
4;41902;41900;88-410;311;202;201;90;111
5;41902;41900;88-410;623;456;451;246;205
6;41902;41900;88-410;551;366;365;257;108
7;41902;41900;88-410;284;174;174;91;83
8;41902;41900;88-410;284;192;188;97;91
9;41902;41900;88-410;201;147;147;121;26
10;41902;41900;88-410;229;126;125;82;43
1;41903;41900;88-430;819;569;566;256;310
2;41903;41900;88-430;766;504;501;254;247
3;41903;41900;88-430;389;263;262;120;142
4;41903;41900;88-430;863;573;563;296;267
5;41903;41900;88-430;442;277;271;168;103
6;41903;41900;88-430;416;259;259;177;82
7;41903;41900;88-430;212;133;131;76;55
8;41903;41900;88-430;221;127;124;97;27
9;41903;41900;88-430;230;135;134;67;67
10;41903;41900;88-430;243;168;167;98;69
11;41903;41900;88-430;465;310;308;145;163
12;41903;41900;88-430;463;286;285;174;111
13;41903;41900;88-430;497;307;304;153;151
14;41903;41900;88-430;212;127;126;92;34
15;41903;41900;88-430;265;147;146;107;39
16;41903;41900;88-430;51;21;21;9;12
1;41904;41900;89-210;870;551;547;259;288
2;41904;41900;89-210;931;565;563;270;293
3;41904;41900;89-210;990;677;668;336;332
4;41904;41900;89-210;474;313;308;158;150
5;41904;41900;89-210;644;405;402;219;183
6;41904;41900;89-210;446;286;286;202;84
7;41904;41900;89-210;710;480;477;269;208
8;41904;41900;89-210;826;540;533;260;273
9;41904;41900;89-210;264;175;173;90;83
10;41904;41900;89-210;572;335;333;191;142
11;41904;41900;89-210;555;327;321;182;139
12;41904;41900;89-210;462;296;292;159;133
13;41904;41900;89-210;211;142;140;72;68
1;41905;41900;88-420;967;678;671;324;347
2;41905;41900;88-420;728;523;517;232;285
3;41905;41900;88-420;593;402;397;238;159
4;41905;41900;88-420;338;241;241;137;104
5;41905;41900;88-420;352;227;226;183;43
6;41905;41900;88-420;350;237;234;122;112
7;41905;41900;88-420;263;175;175;113;62
8;41905;41900;88-420;396;262;258;157;101
9;41905;41900;88-420;381;254;251;176;75
10;41905;41900;88-420;354;220;213;156;57
11;41905;41900;88-420;291;185;184;124;60
1;41906;41900;88-400;788;546;533;216;317
2;41906;41900;88-400;896;624;620;298;322
3;41906;41900;88-400;799;552;547;248;299
4;41906;41900;88-400;614;442;437;175;262
5;41906;41900;88-400;621;436;431;204;227
6;41906;41900;88-400;900;636;632;274;358
7;41906;41900;88-400;930;662;658;294;364
8;41906;41900;88-400;777;466;461;214;247
9;41906;41900;88-400;737;482;480;230;250
10;41906;41900;88-400;1228;845;835;347;488
11;41906;41900;88-400;822;572;567;245;322
12;41906;41900;88-400;1044;720;706;339;367
13;41906;41900;88-400;685;443;437;310;127
14;41906;41900;88-400;591;351;347;229;118
15;41906;41900;88-400;716;492;484;327;157
16;41906;41900;88-400;705;461;454;289;165
17;41906;41900;88-400;495;302;293;185;108
18;41906;41900;88-400;467;332;331;187;144
19;41906;41900;88-400;184;127;127;87;40
20;41906;41900;88-400;867;510;506;321;185
21;41906;41900;88-400;813;517;510;357;153
22;41906;41900;88-400;258;157;154;96;58
23;41906;41900;88-400;358;257;255;182;73
24;41906;41900;88-400;578;364;355;209;146
25;41906;41900;88-400;315;248;246;125;121
26;41906;41900;88-400;317;195;188;137;51
27;41906;41900;88-400;168;109;109;67;42
28;41906;41900;88-400;67;22;22;11;11
29;41906;41900;88-400;63;33;32;18;14
1;46101;46100;85-555;1866;1448;1439;565;874
2;46101;46100;85-529;878;648;645;260;385
3;46101;46100;85-554;1765;1281;1270;503;767
4;46101;46100;85-201;870;589;585;213;372
5;46101;46100;85-235;849;565;561;195;366
6;46101;46100;85-235;1335;947;940;365;575
7;46101;46100;85-209;1398;855;847;331;516
8;46101;46100;85-209;1643;1137;1132;393;739
9;46101;46100;85-208;768;475;472;180;292
10;46101;46100;85-405;2261;1726;1709;573;1136
11;46101;46100;85-350;856;614;609;235;374
12;46101;46100;85-405;1647;1216;1198;504;694
13;46101;46100;85-405;2376;1904;1883;628;1255
14;46101;46100;85-469;1539;1198;1183;478;705
15;46101;46100;85-446;2043;1560;1553;582;971
16;46101;46100;85-435;1714;1407;1390;447;943
17;46101;46100;85-446;1555;1165;1156;516;640
18;46101;46100;85-435;1586;1288;1277;456;821
19;46101;46100;85-435;1183;882;876;322;554
20;46101;46100;85-435;1403;1053;1040;428;612
21;46101;46100;85-641;666;532;523;158;365
22;46101;46100;85-643;1534;1198;1194;316;878
23;46101;46100;85-643;1117;824;820;281;539
24;46101;46100;85-641;1501;1083;1072;338;734
25;46101;46100;85-602;844;605;600;199;401
26;46101;46100;85-602;1285;1027;1017;303;714
27;46101;46100;85-601;732;544;541;193;348
28;46101;46100;85-643;2834;2292;2276;634;1642
29;46101;46100;85-092;1221;901;889;293;596
30;46101;46100;85-095;1134;933;925;241;684
31;46101;46100;85-671;917;684;680;250;430
32;46101;46100;85-717;855;649;639;196;443
33;46101;46100;85-650;796;610;606;174;432
34;46101;46100;85-650;1609;1221;1205;399;806
35;46101;46100;85-095;1060;765;756;289;467
36;46101;46100;85-028;1456;1147;1141;379;762
37;46101;46100;85-090;1194;929;923;280;643
38;46101;46100;85-028;1140;831;826;315;511
39;46101;46100;85-731;838;682;681;248;433
40;46101;46100;85-731;1371;1119;1108;349;759
41;46101;46100;85-703;1525;1243;1230;429;801
42;46101;46100;85-707;945;685;679;208;471
43;46101;46100;85-707;1112;861;856;270;586
44;46101;46100;85-707;1225;940;935;289;646
45;46101;46100;85-707;1675;1240;1229;417;812
46;46101;46100;85-717;1249;897;888;334;554
47;46101;46100;85-717;1158;873;864;301;563
48;46101;46100;85-717;1214;929;922;352;570
49;46101;46100;85-738;658;452;446;188;258
50;46101;46100;85-775;893;551;547;264;283
51;46101;46100;85-776;1000;656;650;280;370
52;46101;46100;85-796;866;658;649;203;446
53;46101;46100;85-796;1199;938;935;315;620
54;46101;46100;85-796;850;658;650;189;461
55;46101;46100;85-796;822;632;627;226;401
56;46101;46100;85-796;1157;880;869;298;571
57;46101;46100;85-796;570;436;433;148;285
58;46101;46100;85-796;936;732;725;239;486
59;46101;46100;85-796;2247;1818;1806;550;1256
60;46101;46100;85-796;1320;1013;1001;333;668
61;46101;46100;85-796;2382;1806;1798;617;1181
62;46101;46100;85-796;1095;797;794;298;496
63;46101;46100;85-792;989;751;749;278;471
64;46101;46100;85-792;1164;921;916;350;566
65;46101;46100;85-792;1202;911;907;316;591
66;46101;46100;85-796;827;621;613;198;415
67;46101;46100;85-791;1380;1021;1014;392;622
68;46101;46100;85-791;1145;842;832;316;516
69;46101;46100;85-791;1173;880;875;319;556
70;46101;46100;85-791;716;508;503;185;318
71;46101;46100;85-790;1465;1045;1034;433;601
72;46101;46100;85-790;1654;1255;1247;440;807
73;46101;46100;85-790;767;565;563;244;319
74;46101;46100;85-790;1390;1050;1042;395;647
75;46101;46100;85-790;1725;1318;1299;430;869
76;46101;46100;85-790;952;686;679;244;435
77;46101;46100;85-791;782;588;583;251;332
78;46101;46100;85-790;864;625;623;219;404
79;46101;46100;85-790;774;589;585;166;419
80;46101;46100;85-790;1117;842;839;316;523
81;46101;46100;85-790;1721;1339;1326;405;921
82;46101;46100;85-790;1757;1322;1312;529;783
83;46101;46100;85-790;790;585;581;223;358
84;46101;46100;85-790;1080;793;786;312;474
85;46101;46100;85-790;1543;1103;1094;400;694
86;46101;46100;85-790;2596;2078;2064;701;1363
87;46101;46100;85-790;1489;1034;1019;430;589
88;46101;46100;85-790;1926;1335;1326;473;853
89;46101;46100;85-790;1589;1129;1123;410;713
90;46101;46100;85-790;268;168;166;98;68
91;46101;46100;85-320;1325;1014;1005;328;677
92;46101;46100;85-323;949;673;669;251;418
93;46101;46100;85-323;648;458;457;174;283
94;46101;46100;85-320;875;653;649;197;452
95;46101;46100;85-323;1248;814;811;318;493
96;46101;46100;85-323;1429;1043;1035;390;645
97;46101;46100;85-323;1384;951;946;360;586
98;46101;46100;85-323;1098;780;776;278;498
99;46101;46100;85-320;1343;939;931;329;602
100;46101;46100;85-219;1163;701;690;298;392
101;46101;46100;85-219;952;623;616;257;359
102;46101;46100;85-348;983;730;727;286;441
103;46101;46100;85-348;1762;1274;1262;462;800
104;46101;46100;85-348;1014;695;688;286;402
105;46101;46100;85-350;1628;1234;1223;450;773
106;46101;46100;85-360;1542;1140;1128;419;709
107;46101;46100;85-360;1587;1242;1237;542;695
108;46101;46100;85-391;2081;1597;1585;650;935
109;46101;46100;85-391;2256;1743;1728;589;1139
110;46101;46100;85-122;1061;697;684;263;421
111;46101;46100;85-122;762;581;572;176;396
112;46101;46100;85-122;732;561;558;173;385
113;46101;46100;85-120;1280;925;915;356;559
114;46101;46100;85-158;1442;983;976;376;600
115;46101;46100;85-137;1776;1285;1276;442;834
116;46101;46100;85-134;1679;1191;1182;432;750
117;46101;46100;85-134;1740;1355;1339;415;924
118;46101;46100;85-149;1414;1097;1089;344;745
119;46101;46100;85-149;1166;821;814;316;498
120;46101;46100;85-134;678;533;531;172;359
121;46101;46100;85-134;1280;981;978;343;635
122;46101;46100;85-137;1832;1396;1381;472;909
123;46101;46100;85-138;1025;780;773;311;462
124;46101;46100;85-138;1077;828;821;257;564
125;46101;46100;85-138;790;561;551;225;326
126;46101;46100;85-138;1437;1103;1092;378;714
127;46101;46100;85-304;1009;800;797;221;576
128;46101;46100;85-304;2332;1822;1800;578;1222
129;46101;46100;85-308;1110;908;900;281;619
130;46101;46100;85-308;1689;1392;1382;443;939
131;46101;46100;85-164;583;431;429;123;306
132;46101;46100;85-164;1606;1239;1228;411;817
133;46101;46100;85-164;1543;1165;1151;413;738
134;46101;46100;85-164;1316;1019;1003;351;652
135;46101;46100;85-164;1376;1020;1014;352;662
136;46101;46100;85-164;1666;1282;1272;413;859
137;46101;46100;85-023;1013;616;616;218;398
138;46101;46100;85-858;1774;1372;1361;493;868
139;46101;46100;85-868;1378;1030;1018;381;637
140;46101;46100;85-870;1665;1269;1261;353;908
141;46101;46100;85-870;1135;851;845;316;529
142;46101;46100;85-866;1242;883;877;311;566
143;46101;46100;85-866;1137;840;834;293;541
144;46101;46100;85-866;1290;938;926;331;595
145;46101;46100;85-858;1110;828;823;283;540
146;46101;46100;85-858;1557;1143;1134;370;764
147;46101;46100;85-858;1513;1161;1156;366;790
148;46101;46100;85-863;1553;1176;1165;375;790
149;46101;46100;85-863;1407;1020;1013;351;662
150;46101;46100;85-863;1495;1088;1073;363;710
151;46101;46100;85-861;1483;1092;1082;380;702
152;46101;46100;85-861;1671;1367;1359;408;951
153;46101;46100;85-061;1324;1030;1017;333;684
154;46101;46100;85-805;1100;704;693;300;393
155;46101;46100;85-805;1268;794;787;296;491
156;46101;46100;85-805;1142;748;742;340;402
157;46101;46100;85-805;1300;903;893;319;574
158;46101;46100;85-805;1499;1126;1111;417;694
159;46101;46100;85-829;1357;1017;1007;332;675
160;46101;46100;85-829;1562;1176;1166;449;717
161;46101;46100;85-861;977;605;603;249;354
162;46101;46100;85-844;2050;1563;1543;594;949
163;46101;46100;85-829;1193;860;855;340;515
164;46101;46100;85-829;967;705;697;223;474
165;46101;46100;85-827;1187;817;814;280;534
166;46101;46100;85-827;1017;723;715;265;450
167;46101;46100;85-833;806;445;441;239;202
168;46101;46100;85-873;1185;643;640;327;313
169;46101;46100;85-844;680;436;432;200;232
170;46101;46100;85-039;1352;807;804;309;495
171;46101;46100;85-057;1265;771;763;310;453
172;46101;46100;85-060;969;589;584;206;378
173;46101;46100;85-039;984;574;569;211;358
174;46101;46100;85-039;957;551;549;199;350
175;46101;46100;85-071;728;433;428;170;258
176;46101;46100;85-005;996;619;615;189;426
177;46101;46100;85-071;961;633;632;235;397
178;46101;46100;85-010;844;506;503;207;296
179;46101;46100;85-010;908;578;568;200;368
180;46101;46100;85-054;1102;675;669;265;404
181;46101;46100;85-006;459;294;290;106;184
182;46101;46100;85-014;1160;918;912;274;638
183;46101;46100;85-021;1374;1034;1028;307;721
184;46101;46100;85-014;1048;706;701;258;443
185;46101;46100;85-004;937;664;651;230;421
186;46101;46100;85-097;991;727;721;237;484
187;46101;46100;85-033;445;292;290;119;171
188;46101;46100;85-222;1213;797;789;307;482
189;46101;46100;85-102;793;493;492;199;293
190;46101;46100;85-863;107;58;56;28;28
191;46101;46100;85-402;55;40;37;11;26
192;46101;46100;85-826;183;90;89;32;57
193;46101;46100;85-094;629;242;238;95;143
194;46101;46100;85-796;353;178;176;69;107
195;46101;46100;85-168;341;165;165;62;103
196;46101;46100;85-326;173;57;57;19;38
197;46101;46100;85-472;94;64;64;20;44
198;46101;46100;85-030;97;49;49;24;25
199;46101;46100;85-681;474;195;194;87;107
200;46101;46100;85-015;123;48;47;10;37
201;46101;46100;85-485;33;19;14;4;10
202;46101;46100;85-676;28;24;24;13;11
203;46101;46100;85-131;276;225;222;23;199
204;46101;46100;85-790;458;374;371;46;325
205;46101;46100;85-831;61;59;58;14;44
206;46101;46100;85-796;29;2;2;2;0
207;46101;46100;85-825;78;26;26;8;18
208;46101;46100;85-796;81;76;73;32;41
1;46201;46200;86-300;1466;1004;998;341;657
2;46201;46200;86-300;2254;1617;1605;677;928
3;46201;46200;86-300;1729;1103;1095;445;650
4;46201;46200;86-300;710;389;384;184;200
5;46201;46200;86-300;819;509;509;208;301
6;46201;46200;86-300;1426;974;965;422;543
7;46201;46200;86-300;824;550;547;221;326
8;46201;46200;86-300;1173;777;773;300;473
9;46201;46200;86-300;1145;696;692;296;396
10;46201;46200;86-300;1539;856;850;409;441
11;46201;46200;86-300;976;544;539;255;284
12;46201;46200;86-300;443;259;257;112;145
13;46201;46200;86-300;571;347;345;148;197
14;46201;46200;86-300;1846;1272;1261;521;740
15;46201;46200;86-300;959;710;706;293;413
16;46201;46200;86-300;634;427;427;173;254
17;46201;46200;86-300;1598;1046;1039;411;628
18;46201;46200;86-300;1273;808;797;329;468
19;46201;46200;86-300;949;498;491;222;269
20;46201;46200;86-300;793;423;420;169;251
21;46201;46200;86-300;532;300;295;131;164
22;46201;46200;86-300;504;258;256;124;132
23;46201;46200;86-300;738;378;375;190;185
24;46201;46200;86-300;783;441;439;178;261
25;46201;46200;86-300;1279;831;828;504;324
26;46201;46200;86-300;1203;741;736;321;415
27;46201;46200;86-300;1087;658;654;267;387
28;46201;46200;86-300;1181;826;819;305;514
29;46201;46200;86-300;1125;817;808;324;484
30;46201;46200;86-300;1633;1133;1123;375;748
31;46201;46200;86-300;1716;1183;1175;418;757
32;46201;46200;86-300;1529;1156;1143;428;715
33;46201;46200;86-300;1587;1114;1111;395;716
34;46201;46200;86-300;532;311;309;131;178
35;46201;46200;86-300;1527;1006;1001;390;611
36;46201;46200;86-300;1178;773;768;296;472
37;46201;46200;86-300;840;507;501;203;298
38;46201;46200;86-300;1723;1201;1189;475;714
39;46201;46200;86-300;1474;1071;1054;371;683
40;46201;46200;86-300;1057;732;726;246;480
41;46201;46200;86-300;1253;891;886;339;547
42;46201;46200;86-300;1396;947;940;329;611
43;46201;46200;86-300;1714;1139;1130;417;713
44;46201;46200;86-300;1528;1121;1116;424;692
45;46201;46200;86-300;1797;1350;1339;441;898
46;46201;46200;86-300;1290;946;939;329;610
47;46201;46200;86-300;1873;1381;1374;519;855
48;46201;46200;86-300;1251;816;813;386;427
49;46201;46200;86-300;1712;1162;1151;516;635
50;46201;46200;86-300;119;74;73;31;42
51;46201;46200;86-300;102;56;55;24;31
52;46201;46200;86-300;318;190;186;87;99
53;46201;46200;86-300;1060;753;744;138;606
54;46201;46200;86-300;282;205;202;34;168
55;46201;46200;86-300;51;29;27;10;17
1;46301;46300;87-100;1556;1186;1174;424;750
2;46301;46300;87-100;1814;1250;1241;486;755
3;46301;46300;87-100;673;478;470;158;312
4;46301;46300;87-100;1841;1345;1337;468;869
5;46301;46300;87-100;1418;899;891;339;552
6;46301;46300;87-100;1907;1330;1321;494;827
7;46301;46300;87-100;2156;1656;1641;677;964
8;46301;46300;87-100;1629;1314;1301;422;879
9;46301;46300;87-100;805;617;613;219;394
10;46301;46300;87-100;1663;1243;1232;485;747
11;46301;46300;87-100;1874;1552;1533;462;1071
12;46301;46300;87-100;1486;1118;1114;432;682
13;46301;46300;87-100;959;735;727;297;430
14;46301;46300;87-100;842;627;622;284;338
15;46301;46300;87-100;1219;936;930;382;548
16;46301;46300;87-100;1642;1244;1234;489;745
17;46301;46300;87-100;1487;1158;1148;465;683
18;46301;46300;87-100;1349;1060;1052;403;649
19;46301;46300;87-100;1399;1087;1076;393;683
20;46301;46300;87-100;814;600;599;256;343
21;46301;46300;87-100;1087;866;857;320;537
22;46301;46300;87-100;1125;887;876;315;561
23;46301;46300;87-100;953;727;722;282;440
24;46301;46300;87-100;1023;755;748;315;433
25;46301;46300;87-100;942;736;732;269;463
26;46301;46300;87-100;1098;808;805;349;456
27;46301;46300;87-100;1393;951;938;282;656
28;46301;46300;87-100;1911;1376;1360;483;877
29;46301;46300;87-100;722;481;477;152;325
30;46301;46300;87-100;1416;1005;997;326;671
31;46301;46300;87-100;964;724;718;269;449
32;46301;46300;87-100;763;510;507;177;330
33;46301;46300;87-100;1444;978;968;328;640
34;46301;46300;87-100;668;459;455;195;260
35;46301;46300;87-100;1839;1399;1384;428;956
36;46301;46300;87-100;814;511;505;177;328
37;46301;46300;87-100;769;561;558;180;378
38;46301;46300;87-100;969;723;720;236;484
39;46301;46300;87-100;943;652;646;241;405
40;46301;46300;87-100;1029;770;763;235;528
41;46301;46300;87-100;1104;677;671;243;428
42;46301;46300;87-100;1216;934;924;329;595
43;46301;46300;87-100;806;576;563;196;367
44;46301;46300;87-100;757;544;538;206;332
45;46301;46300;87-100;743;557;553;183;370
46;46301;46300;87-100;1659;1313;1304;434;870
47;46301;46300;87-100;507;452;451;105;346
48;46301;46300;87-100;2000;1531;1512;574;938
49;46301;46300;87-100;1447;1088;1079;411;668
50;46301;46300;87-100;487;324;319;98;221
51;46301;46300;87-100;784;537;529;225;304
52;46301;46300;87-100;364;225;221;88;133
53;46301;46300;87-100;555;360;356;128;228
54;46301;46300;87-100;800;503;494;191;303
55;46301;46300;87-100;597;371;367;142;225
56;46301;46300;87-100;588;380;379;143;236
57;46301;46300;87-100;1770;1332;1325;364;961
58;46301;46300;87-100;1474;1128;1117;381;736
59;46301;46300;87-100;1298;987;972;377;595
60;46301;46300;87-100;785;534;532;209;323
61;46301;46300;87-100;1012;737;728;233;495
62;46301;46300;87-100;1423;1107;1098;392;706
63;46301;46300;87-100;1453;1123;1119;355;764
64;46301;46300;87-100;1184;886;874;313;561
65;46301;46300;87-100;1661;1278;1259;392;867
66;46301;46300;87-100;2173;1705;1680;531;1149
67;46301;46300;87-100;1856;1536;1520;482;1038
68;46301;46300;87-100;1464;1166;1157;386;771
69;46301;46300;87-100;1902;1457;1445;471;974
70;46301;46300;87-100;1922;1428;1412;590;822
71;46301;46300;87-100;2136;1704;1686;687;999
72;46301;46300;87-100;2201;1797;1773;591;1182
73;46301;46300;87-100;2067;1657;1644;592;1052
74;46301;46300;87-100;1539;1326;1310;400;910
75;46301;46300;87-100;1337;966;958;362;596
76;46301;46300;87-100;391;187;183;91;92
77;46301;46300;87-100;543;342;338;157;181
78;46301;46300;87-100;453;300;299;103;196
79;46301;46300;87-100;1304;998;991;319;672
80;46301;46300;87-100;773;614;607;212;395
81;46301;46300;87-100;1381;1058;1047;384;663
82;46301;46300;87-100;676;462;456;193;263
83;46301;46300;87-100;934;663;658;241;417
84;46301;46300;87-100;1180;850;841;260;581
85;46301;46300;87-100;1105;782;779;277;502
86;46301;46300;87-100;728;508;504;181;323
87;46301;46300;87-100;638;479;475;161;314
88;46301;46300;87-100;1842;1435;1419;410;1009
89;46301;46300;87-100;1579;1183;1171;359;812
90;46301;46300;87-100;1092;856;849;233;616
91;46301;46300;87-100;1421;977;971;376;595
92;46301;46300;87-100;308;176;175;74;101
93;46301;46300;87-100;2045;1613;1593;492;1101
94;46301;46300;87-100;1207;875;865;330;535
95;46301;46300;87-100;1067;764;763;274;489
96;46301;46300;87-100;1433;1093;1080;394;686
97;46301;46300;87-100;635;500;497;194;303
98;46301;46300;87-100;1270;921;913;412;501
99;46301;46300;87-100;963;730;724;288;436
100;46301;46300;87-100;1068;784;779;289;490
101;46301;46300;87-100;616;483;481;135;346
102;46301;46300;87-100;1145;847;839;315;524
103;46301;46300;87-100;1050;749;744;339;405
104;46301;46300;87-100;1076;807;798;279;519
105;46301;46300;87-100;1616;1231;1226;484;742
106;46301;46300;87-100;1082;705;701;313;388
107;46301;46300;87-100;1092;813;808;344;464
108;46301;46300;87-100;986;736;735;290;445
109;46301;46300;87-100;1210;856;838;433;405
110;46301;46300;87-100;1929;1327;1317;535;782
111;46301;46300;87-100;1103;856;854;349;505
112;46301;46300;87-100;1443;1159;1152;472;680
113;46301;46300;87-100;1938;1566;1551;465;1086
114;46301;46300;87-100;1395;929;916;471;445
115;46301;46300;87-100;1176;979;975;305;670
116;46301;46300;87-100;2399;2070;2051;656;1395
117;46301;46300;87-100;125;93;93;27;66
118;46301;46300;87-100;147;79;78;35;43
119;46301;46300;87-100;288;172;171;80;91
120;46301;46300;87-100;18;17;17;3;14
121;46301;46300;87-100;144;85;82;36;46
122;46301;46300;87-100;69;14;14;5;9
123;46301;46300;87-100;51;35;35;21;14
124;46301;46300;87-100;119;42;41;21;20
125;46301;46300;87-100;33;18;18;4;14
126;46301;46300;87-100;178;175;168;44;124
1;46401;46400;87-800;1045;681;678;305;373
2;46401;46400;87-800;659;335;332;205;127
3;46401;46400;87-800;945;500;492;250;242
4;46401;46400;87-800;957;435;432;244;188
5;46401;46400;87-800;789;491;490;222;268
6;46401;46400;87-800;790;452;450;206;244
7;46401;46400;87-800;1176;731;724;288;436
8;46401;46400;87-800;1256;784;778;320;458
9;46401;46400;87-800;1315;764;764;276;488
10;46401;46400;87-800;1494;950;947;398;549
11;46401;46400;87-800;1330;906;897;359;538
12;46401;46400;87-800;1185;817;809;316;493
13;46401;46400;87-800;923;657;651;252;399
14;46401;46400;87-800;1460;987;978;420;558
15;46401;46400;87-800;1179;729;721;294;427
16;46401;46400;87-800;1492;869;862;359;503
17;46401;46400;87-800;1128;791;785;282;503
18;46401;46400;87-800;1368;981;973;400;573
19;46401;46400;87-800;1254;822;817;320;497
20;46401;46400;87-800;1211;789;778;366;412
21;46401;46400;87-800;932;649;642;249;393
22;46401;46400;87-800;1142;795;785;303;482
23;46401;46400;87-800;1012;670;661;224;437
24;46401;46400;87-800;1254;947;941;354;587
25;46401;46400;87-800;1228;864;861;312;549
26;46401;46400;87-800;867;517;514;219;295
27;46401;46400;87-800;437;284;280;106;174
28;46401;46400;87-800;1411;924;915;364;551
29;46401;46400;87-800;1353;933;926;371;555
30;46401;46400;87-800;1421;947;940;411;529
31;46401;46400;87-800;1295;891;888;370;518
32;46401;46400;87-800;999;733;726;287;439
33;46401;46400;87-800;1157;792;787;301;486
34;46401;46400;87-800;903;623;611;269;342
35;46401;46400;87-800;1425;877;874;363;511
36;46401;46400;87-800;977;631;629;283;346
37;46401;46400;87-800;873;584;577;241;336
38;46401;46400;87-800;1098;794;787;292;495
39;46401;46400;87-800;1350;972;964;354;610
40;46401;46400;87-800;1236;911;905;326;579
41;46401;46400;87-800;1124;827;821;292;529
42;46401;46400;87-800;1243;910;903;315;588
43;46401;46400;87-800;1511;1087;1068;371;697
44;46401;46400;87-800;919;665;652;257;395
45;46401;46400;87-800;1203;868;863;319;544
46;46401;46400;87-800;1060;785;778;310;468
47;46401;46400;87-800;1325;920;916;363;553
48;46401;46400;87-800;1588;1192;1187;416;771
49;46401;46400;87-800;1516;1125;1114;385;729
50;46401;46400;87-800;1475;1105;1093;377;716
51;46401;46400;87-800;898;535;528;211;317
52;46401;46400;87-800;1207;786;781;330;451
53;46401;46400;87-800;1342;869;862;335;527
54;46401;46400;87-800;1050;761;756;275;481
55;46401;46400;87-800;1512;1101;1090;401;689
56;46401;46400;87-800;1040;747;741;332;409
57;46401;46400;87-800;1093;800;795;298;497
58;46401;46400;87-800;1160;828;821;304;517
59;46401;46400;87-800;1307;950;939;374;565
60;46401;46400;87-800;955;674;665;269;396
61;46401;46400;87-800;1053;745;737;294;443
62;46401;46400;87-800;1125;750;748;359;389
63;46401;46400;87-800;784;331;327;193;134
64;46401;46400;87-800;1374;970;964;415;549
65;46401;46400;87-800;46;21;21;7;14
66;46401;46400;87-800;54;37;36;20;16
67;46401;46400;87-800;40;27;27;6;21
68;46401;46400;87-800;139;101;95;37;58
69;46401;46400;87-800;1106;889;878;103;775
1;60101;60100;21-560;1333;837;836;575;261
2;60101;60100;21-560;622;405;399;297;102
3;60101;60100;21-560;603;439;437;271;166
4;60101;60100;21-560;745;517;514;374;140
5;60101;60100;21-560;1529;1080;1075;769;306
6;60101;60100;21-560;1581;1052;1042;708;334
7;60101;60100;21-560;869;638;634;454;180
8;60101;60100;21-560;1736;1253;1235;843;392
9;60101;60100;21-560;712;474;468;311;157
10;60101;60100;21-560;1114;802;796;559;237
11;60101;60100;21-560;1148;804;799;495;304
12;60101;60100;21-560;57;44;44;34;10
1;60102;60100;21-550;1583;1100;1094;639;455
2;60102;60100;21-550;1221;815;809;510;299
3;60102;60100;21-550;1168;860;852;539;313
1;60103;60100;21-500;701;498;490;314;176
2;60103;60100;21-500;627;409;404;298;106
3;60103;60100;21-500;1339;1049;1038;582;456
4;60103;60100;21-500;366;226;225;164;61
5;60103;60100;21-500;431;274;271;201;70
6;60103;60100;21-500;1118;821;813;517;296
7;60103;60100;21-500;421;296;293;196;97
8;60103;60100;21-500;307;239;239;178;61
9;60103;60100;21-500;912;647;641;399;242
10;60103;60100;21-500;635;427;419;264;155
11;60103;60100;21-500;1124;748;741;577;164
12;60103;60100;21-500;748;551;539;356;183
13;60103;60100;21-500;603;405;404;309;95
14;60103;60100;21-500;660;473;471;362;109
15;60103;60100;21-500;157;59;57;42;15
16;60103;60100;21-500;955;640;633;431;202
17;60103;60100;21-500;280;201;197;129;68
1;60104;60100;21-570;1586;1054;1044;815;229
2;60104;60100;21-570;758;481;478;405;73
3;60104;60100;21-570;825;510;506;418;88
4;60104;60100;21-570;550;325;323;256;67
5;60104;60100;21-570;282;182;182;149;33
6;60104;60100;21-570;76;49;47;34;13
1;60105;60100;21-505;454;276;276;205;71
2;60105;60100;21-505;245;167;167;111;56
3;60105;60100;21-505;1289;869;859;532;327
4;60105;60100;21-505;512;309;308;242;66
5;60105;60100;21-505;1063;658;653;457;196
6;60105;60100;21-505;313;205;204;156;48
1;60106;60100;21-509;1666;1206;1197;815;382
2;60106;60100;21-509;351;214;214;157;57
3;60106;60100;21-509;381;213;212;150;62
4;60106;60100;21-509;244;160;159;106;53
5;60106;60100;21-509;232;156;154;88;66
1;60107;60100;21-543;988;682;672;446;226
2;60107;60100;21-543;809;510;507;397;110
3;60107;60100;21-543;178;122;122;103;19
4;60107;60100;21-543;668;443;440;369;71
5;60107;60100;21-543;273;174;174;146;28
6;60107;60100;21-543;83;40;36;20;16
1;60108;60100;21-542;1558;1063;1053;794;259
2;60108;60100;21-542;574;375;375;291;84
3;60108;60100;21-542;321;236;235;196;39
4;60108;60100;21-542;716;509;502;409;93
1;60109;60100;21-532;487;341;333;245;88
2;60109;60100;21-532;388;248;244;212;32
3;60109;60100;21-532;315;190;190;146;44
4;60109;60100;21-532;1601;1094;1083;754;329
5;60109;60100;21-532;182;130;128;112;16
6;60109;60100;21-532;189;136;135;109;26
7;60109;60100;21-532;166;101;99;81;18
8;60109;60100;21-532;299;192;191;154;37
1;60110;60100;21-560;428;280;278;233;45
2;60110;60100;21-560;705;511;508;398;110
3;60110;60100;21-560;714;492;490;423;67
4;60110;60100;21-560;686;494;492;439;53
5;60110;60100;21-560;389;293;292;267;25
6;60110;60100;21-560;362;263;263;228;35
7;60110;60100;21-560;433;308;307;259;48
8;60110;60100;21-560;538;344;342;272;70
9;60110;60100;21-560;568;410;407;330;77
10;60110;60100;21-560;614;435;430;366;64
11;60110;60100;21-560;513;320;318;277;41
12;60110;60100;21-560;759;511;506;380;126
13;60110;60100;21-560;281;198;196;175;21
14;60110;60100;21-560;350;245;242;195;47
15;60110;60100;21-560;348;242;241;200;41
1;60111;60100;21-530;694;451;444;302;142
2;60111;60100;21-530;447;273;268;229;39
3;60111;60100;21-530;334;220;220;171;49
4;60111;60100;21-530;1548;1033;1031;767;264
5;60111;60100;21-530;638;364;360;292;68
6;60111;60100;21-530;1204;729;722;592;130
7;60111;60100;21-530;390;270;264;206;58
1;60112;60100;21-504;633;418;414;315;99
2;60112;60100;21-504;285;185;184;141;43
3;60112;60100;21-504;282;170;170;137;33
4;60112;60100;21-504;266;165;165;128;37
5;60112;60100;21-504;275;150;150;116;34
6;60112;60100;21-504;437;311;306;239;67
1;60113;60100;21-533;718;581;564;467;97
2;60113;60100;21-533;667;564;551;389;162
3;60113;60100;21-533;269;182;174;122;52
1;60114;60100;21-515;849;566;560;371;189
2;60114;60100;21-515;297;190;184;113;71
3;60114;60100;21-515;317;202;201;146;55
4;60114;60100;21-515;330;214;214;147;67
1;60115;60100;21-518;394;260;256;213;43
2;60115;60100;21-518;539;297;296;205;91
3;60115;60100;21-518;499;328;327;243;84
4;60115;60100;21-518;282;183;183;123;60
1;60116;60100;21-550;429;248;246;192;54
2;60116;60100;21-540;357;265;264;187;77
3;60116;60100;21-540;1254;841;836;626;210
4;60116;60100;21-550;383;254;250;185;65
5;60116;60100;21-550;435;297;297;194;103
6;60116;60100;21-550;581;330;329;229;100
7;60116;60100;21-550;244;162;160;118;42
8;60116;60100;21-550;186;124;124;107;17
9;60116;60100;21-540;376;259;259;213;46
10;60116;60100;21-550;197;150;149;110;39
11;60116;60100;21-540;374;255;254;203;51
1;60117;60100;21-523;397;267;266;223;43
2;60117;60100;21-523;1315;802;793;625;168
3;60117;60100;21-523;542;326;324;219;105
1;60118;60100;21-580;322;227;224;166;58
2;60118;60100;21-580;549;338;338;218;120
3;60118;60100;21-580;508;338;335;243;92
4;60118;60100;21-580;1013;666;661;406;255
5;60118;60100;21-580;439;264;258;196;62
6;60118;60100;21-580;423;299;298;207;91
7;60118;60100;21-580;282;210;207;122;85
8;60118;60100;21-580;67;19;18;12;6
1;60119;60100;21-512;425;253;249;182;67
2;60119;60100;21-512;408;284;281;224;57
3;60119;60100;21-512;576;354;348;251;97
4;60119;60100;21-512;1164;756;752;534;218
5;60119;60100;21-512;357;229;226;172;54
6;60119;60100;21-512;313;197;197;157;40
1;60201;60200;23-400;1700;1187;1183;665;518
2;60201;60200;23-400;1823;1261;1256;744;512
3;60201;60200;23-400;615;439;435;271;164
4;60201;60200;23-400;1760;1252;1245;719;526
5;60201;60200;23-400;869;618;612;342;270
6;60201;60200;23-400;1657;1065;1059;621;438
7;60201;60200;23-400;1978;1381;1371;917;454
8;60201;60200;23-400;1718;1198;1187;720;467
9;60201;60200;23-400;1007;667;661;406;255
10;60201;60200;23-400;2108;1457;1449;931;518
11;60201;60200;23-400;876;609;604;312;292
12;60201;60200;23-400;1837;1245;1233;753;480
13;60201;60200;23-400;885;625;617;377;240
14;60201;60200;23-400;211;116;114;88;26
15;60201;60200;23-400;74;54;50;28;22
1;60202;60200;23-408;795;515;512;429;83
2;60202;60200;23-408;570;378;374;316;58
3;60202;60200;23-408;520;332;331;301;30
4;60202;60200;23-408;530;356;352;285;67
1;60203;60200;23-400;580;376;375;326;49
2;60203;60200;23-400;545;380;376;313;63
3;60203;60200;23-400;694;488;486;387;99
4;60203;60200;23-400;929;614;609;518;91
5;60203;60200;23-400;268;201;197;167;30
6;60203;60200;23-400;618;452;449;374;75
7;60203;60200;23-400;717;523;520;440;80
8;60203;60200;23-400;1207;856;850;660;190
9;60203;60200;23-400;565;397;397;355;42
10;60203;60200;23-400;349;256;252;219;33
11;60203;60200;23-400;365;247;244;188;56
12;60203;60200;23-400;937;627;625;436;189
13;60203;60200;23-400;792;544;544;398;146
14;60203;60200;23-400;735;503;498;430;68
15;60203;60200;23-400;221;163;158;103;55
16;60203;60200;23-400;313;222;221;174;47
17;60203;60200;23-400;93;51;36;28;8
1;60204;60200;23-425;800;576;573;478;95
2;60204;60200;23-425;771;484;480;443;37
3;60204;60200;23-425;790;452;447;369;78
4;60204;60200;23-425;494;319;315;276;39
1;60205;60200;23-440;1064;727;724;536;188
2;60205;60200;23-440;208;146;145;138;7
3;60205;60200;23-440;583;347;343;304;39
4;60205;60200;23-440;485;325;324;260;64
5;60205;60200;23-440;703;502;500;416;84
6;60205;60200;23-440;402;262;261;221;40
7;60205;60200;23-440;442;292;291;249;42
8;60205;60200;23-440;220;126;126;101;25
9;60205;60200;23-440;438;295;292;224;68
1;60206;60200;23-450;488;331;331;287;44
2;60206;60200;23-450;860;609;604;523;81
3;60206;60200;23-450;487;306;305;268;37
4;60206;60200;23-450;456;283;282;236;46
5;60206;60200;23-450;368;220;220;173;47
6;60206;60200;23-450;382;276;276;251;25
1;60207;60200;23-460;918;605;598;342;256
2;60207;60200;23-460;739;444;440;289;151
3;60207;60200;23-460;376;231;225;150;75
4;60207;60200;23-460;743;444;438;290;148
5;60207;60200;23-460;446;261;259;227;32
6;60207;60200;23-460;620;411;408;324;84
7;60207;60200;23-460;296;202;200;175;25
8;60207;60200;23-460;423;266;258;167;91
9;60207;60200;23-460;244;138;137;79;58
10;60207;60200;23-460;326;185;185;131;54
1;60208;60200;23-415;686;481;478;379;99
2;60208;60200;23-415;1717;1175;1164;936;228
3;60208;60200;23-414;987;754;747;620;127
4;60208;60200;23-415;774;511;509;422;87
5;60208;60200;23-414;257;170;168;160;8
6;60208;60200;23-415;341;258;255;207;48
7;60208;60200;23-415;297;207;205;176;29
1;60209;60200;23-412;1095;699;690;581;109
2;60209;60200;23-412;1223;870;867;752;115
3;60209;60200;23-412;784;532;527;430;97
1;60210;60200;23-413;1011;634;630;503;127
2;60210;60200;23-413;718;513;511;453;58
3;60210;60200;23-413;446;305;305;261;44
4;60210;60200;23-413;1000;673;670;600;70
1;60211;60200;23-423;1020;635;632;537;95
2;60211;60200;23-423;616;385;384;331;53
3;60211;60200;23-423;1028;700;693;604;89
4;60211;60200;23-423;1267;922;916;839;77
1;60212;60200;23-420;417;269;269;245;24
2;60212;60200;23-420;453;291;288;246;42
3;60212;60200;23-420;574;373;372;297;75
4;60212;60200;23-420;443;308;308;262;46
5;60212;60200;23-420;753;533;527;355;172
6;60212;60200;23-420;893;619;612;420;192
7;60212;60200;23-420;743;504;496;337;159
8;60212;60200;23-420;542;373;373;343;30
9;60212;60200;23-420;69;24;23;18;5
1;60213;60200;23-407;405;258;257;184;73
2;60213;60200;23-407;1142;763;755;594;161
3;60213;60200;23-407;571;387;381;291;90
4;60213;60200;23-407;641;438;433;363;70
5;60213;60200;23-407;161;109;108;90;18
1;60214;60200;23-465;641;485;482;374;108
2;60214;60200;23-465;505;379;378;338;40
3;60214;60200;23-465;257;174;172;146;26
4;60214;60200;23-465;347;252;252;235;17
5;60214;60200;23-465;390;263;262;229;33
6;60214;60200;23-465;358;290;288;219;69
7;60214;60200;23-465;191;141;140;113;27
8;60214;60200;23-465;451;327;325;291;34
9;60214;60200;23-465;371;239;238;219;19
10;60214;60200;23-465;204;138;138;121;17
11;60214;60200;23-465;229;169;169;147;22
12;60214;60200;23-465;178;128;124;97;27
13;60214;60200;23-465;239;178;176;159;17
14;60214;60200;23-465;182;126;125;109;16
15;60214;60200;23-465;23;16;16;12;4
1;60301;60300;22-170;865;548;544;399;145
2;60301;60300;22-170;1036;624;623;399;224
3;60301;60300;22-170;1275;829;821;521;300
1;60302;60300;22-135;1191;690;686;517;169
2;60302;60300;22-135;446;256;253;197;56
3;60302;60300;22-135;547;318;318;265;53
1;60303;60300;22-100;776;424;421;281;140
2;60303;60300;22-105;498;327;324;179;145
3;60303;60300;22-105;208;107;102;67;35
4;60303;60300;22-106;217;133;131;88;43
5;60303;60300;22-151;786;499;495;332;163
6;60303;60300;22-151;551;347;347;254;93
7;60303;60300;22-151;510;304;304;220;84
8;60303;60300;22-151;589;432;428;244;184
9;60303;60300;22-100;994;653;647;361;286
10;60303;60300;22-100;532;350;349;204;145
11;60303;60300;22-100;241;171;171;111;60
12;60303;60300;22-100;576;426;426;232;194
13;60303;60300;22-100;586;378;374;278;96
14;60303;60300;22-100;448;288;286;230;56
15;60303;60300;22-100;251;164;163;115;48
16;60303;60300;22-100;350;193;193;170;23
17;60303;60300;22-100;229;157;157;110;47
18;60303;60300;22-100;733;519;516;336;180
19;60303;60300;22-100;186;130;128;110;18
20;60303;60300;22-151;215;128;122;105;17
21;60303;60300;22-105;844;608;601;423;178
22;60303;60300;22-151;268;172;171;120;51
23;60303;60300;22-100;203;146;144;92;52
24;60303;60300;22-100;280;187;185;145;40
25;60303;60300;22-100;231;159;158;133;25
1;60304;60300;22-174;781;522;520;374;146
2;60304;60300;22-174;522;303;300;223;77
3;60304;60300;22-175;538;336;329;250;79
4;60304;60300;22-175;637;394;394;311;83
5;60304;60300;22-175;1048;671;664;488;176
6;60304;60300;22-175;527;299;297;254;43
7;60304;60300;22-175;617;366;364;327;37
1;60305;60300;22-145;434;245;242;185;57
2;60305;60300;22-145;1006;609;607;366;241
3;60305;60300;22-145;297;184;182;132;50
1;60306;60300;22-113;330;187;187;152;35
2;60306;60300;22-113;702;423;421;331;90
3;60306;60300;22-113;264;156;155;124;31
4;60306;60300;22-113;550;344;342;238;104
5;60306;60300;22-113;472;290;286;230;56
6;60306;60300;22-113;758;488;487;350;137
1;60307;60300;22-122;320;166;164;121;43
2;60307;60300;22-122;880;480;477;333;144
3;60307;60300;22-122;576;298;295;216;79
4;60307;60300;22-122;593;317;310;210;100
5;60307;60300;22-122;335;225;222;186;36
1;60308;60300;22-170;685;457;448;348;100
2;60308;60300;22-170;469;266;262;200;62
3;60308;60300;22-170;696;391;385;310;75
4;60308;60300;22-170;954;612;607;523;84
5;60308;60300;22-170;261;155;153;131;22
1;60309;60300;22-110;538;314;314;229;85
2;60309;60300;22-110;1596;1010;1003;717;286
3;60309;60300;22-110;573;334;333;226;107
4;60309;60300;22-110;396;224;222;177;45
5;60309;60300;22-110;226;128;121;80;41
1;60310;60300;22-107;255;156;155;118;37
2;60310;60300;22-107;580;335;331;264;67
3;60310;60300;22-107;539;329;328;272;56
4;60310;60300;22-107;202;132;131;98;33
5;60310;60300;22-107;830;539;536;427;109
6;60310;60300;22-107;1599;1034;1023;702;321
1;60311;60300;22-130;728;380;377;323;54
2;60311;60300;22-130;320;210;210;176;34
3;60311;60300;22-130;419;282;279;226;53
4;60311;60300;22-130;507;352;350;285;65
5;60311;60300;22-130;241;164;162;146;16
6;60311;60300;22-130;396;265;261;215;46
7;60311;60300;22-130;406;226;223;167;56
8;60311;60300;22-130;656;410;405;307;98
9;60311;60300;22-130;1355;892;887;625;262
1;60312;60300;22-150;212;119;119;102;17
2;60312;60300;22-150;400;253;252;224;28
3;60312;60300;22-150;337;197;195;176;19
4;60312;60300;22-150;752;565;558;427;131
5;60312;60300;22-150;244;158;157;135;22
6;60312;60300;22-150;486;276;274;226;48
7;60312;60300;22-150;195;120;117;105;12
8;60312;60300;22-150;355;234;229;192;37
9;60312;60300;22-150;240;164;162;126;36
10;60312;60300;22-150;486;331;330;258;72
1;60313;60300;22-120;380;228;225;200;25
2;60313;60300;22-120;369;254;253;212;41
3;60313;60300;22-120;1116;727;720;591;129
4;60313;60300;22-120;280;172;171;119;52
5;60313;60300;22-120;492;292;290;223;67
6;60313;60300;22-120;169;123;123;118;5
1;60314;60300;22-114;256;132;132;106;26
2;60314;60300;22-114;894;594;590;448;142
3;60314;60300;22-114;402;245;244;176;68
4;60314;60300;22-114;241;143;141;113;28
5;60314;60300;22-114;208;150;150;130;20
6;60314;60300;22-114;244;142;141;101;40
1;60315;60300;22-360;414;227;226;174;52
2;60315;60300;22-360;1111;721;715;460;255
3;60315;60300;22-360;777;447;445;364;81
4;60315;60300;22-360;714;411;405;325;80
5;60315;60300;22-360;279;176;173;125;48
6;60315;60300;22-360;404;231;231;143;88
7;60315;60300;22-360;806;474;465;356;109
8;60315;60300;22-360;169;108;107;73;34
1;60401;60400;22-500;957;689;682;455;227
2;60401;60400;22-500;918;616;612;390;222
3;60401;60400;22-500;830;550;546;349;197
4;60401;60400;22-500;824;560;555;328;227
5;60401;60400;22-500;776;515;512;263;249
6;60401;60400;22-500;1599;975;964;602;362
7;60401;60400;22-500;723;455;453;264;189
8;60401;60400;22-500;796;501;500;289;211
9;60401;60400;22-500;744;477;473;265;208
10;60401;60400;22-500;754;456;456;229;227
11;60401;60400;22-500;694;460;454;247;207
12;60401;60400;22-500;720;485;481;266;215
13;60401;60400;22-500;753;499;495;272;223
14;60401;60400;22-500;903;660;656;347;309
15;60401;60400;22-500;196;90;88;66;22
16;60401;60400;22-500;510;355;347;64;283
1;60402;60400;22-540;978;610;604;417;187
2;60402;60400;22-540;304;182;180;119;61
3;60402;60400;22-540;224;118;116;99;17
4;60402;60400;22-540;454;267;263;226;37
5;60402;60400;22-540;620;316;314;249;65
6;60402;60400;22-540;330;175;174;123;51
7;60402;60400;22-540;620;268;264;202;62
8;60402;60400;22-540;173;98;97;83;14
1;60403;60400;22-523;1216;681;677;519;158
2;60403;60400;22-523;296;149;147;124;23
3;60403;60400;22-523;291;159;157;121;36
4;60403;60400;22-523;486;292;291;211;80
5;60403;60400;22-525;1138;685;681;471;210
6;60403;60400;22-523;284;156;155;120;35
1;60404;60400;22-500;658;402;399;292;107
2;60404;60400;22-500;445;284;281;232;49
3;60404;60400;22-500;273;159;156;118;38
4;60404;60400;22-500;349;200;200;153;47
5;60404;60400;22-500;224;149;147;132;15
6;60404;60400;22-500;406;226;225;178;47
7;60404;60400;22-500;302;163;162;117;45
8;60404;60400;22-500;555;359;354;243;111
9;60404;60400;22-500;593;403;400;301;99
10;60404;60400;22-500;889;538;532;438;94
11;60404;60400;22-500;355;229;227;187;40
12;60404;60400;22-500;258;175;175;159;16
13;60404;60400;22-500;378;210;209;183;26
14;60404;60400;22-500;262;169;169;126;43
15;60404;60400;22-500;299;189;187;139;48
16;60404;60400;22-500;298;197;196;127;69
17;60404;60400;22-500;217;135;133;96;37
18;60404;60400;22-500;156;117;116;106;10
19;60404;60400;22-500;180;111;111;79;32
20;60404;60400;22-500;239;129;129;98;31
1;60405;60400;22-530;1086;671;666;455;211
2;60405;60400;22-530;306;155;154;113;41
3;60405;60400;22-530;714;433;430;332;98
4;60405;60400;22-530;356;199;196;155;41
5;60405;60400;22-530;383;224;224;192;32
6;60405;60400;22-530;590;400;396;300;96
7;60405;60400;22-530;351;199;196;129;67
8;60405;60400;22-530;412;253;253;198;55
9;60405;60400;22-530;435;270;268;226;42
10;60405;60400;22-530;518;292;292;222;70
11;60405;60400;22-530;177;57;56;41;15
1;60406;60400;22-554;974;598;591;467;124
2;60406;60400;22-554;616;371;370;334;36
3;60406;60400;22-554;1235;737;728;539;189
4;60406;60400;22-554;164;111;111;88;23
1;60407;60400;22-510;832;549;546;433;113
2;60407;60400;22-510;499;323;318;279;39
3;60407;60400;22-510;372;218;215;155;60
4;60407;60400;22-510;281;196;196;170;26
5;60407;60400;22-510;871;590;585;505;80
6;60407;60400;22-510;263;151;151;117;34
7;60407;60400;22-510;180;128;127;116;11
1;60408;60400;22-550;1137;735;728;555;173
2;60408;60400;22-550;932;605;600;421;179
3;60408;60400;22-550;274;194;193;150;43
4;60408;60400;22-550;491;305;301;244;57
5;60408;60400;22-550;832;509;504;437;67
6;60408;60400;22-550;343;216;216;168;48
7;60408;60400;22-550;719;426;426;344;82
8;60408;60400;22-550;388;201;198;156;42
9;60408;60400;22-546;323;173;172;139;33
10;60408;60400;22-546;501;265;262;204;58
11;60408;60400;22-550;237;167;166;116;50
12;60408;60400;22-550;156;89;89;72;17
13;60408;60400;22-550;210;127;126;111;15
14;60408;60400;22-550;162;86;85;73;12
15;60408;60400;22-546;49;48;48;38;10
1;60501;60500;23-320;387;308;306;280;26
2;60501;60500;23-320;972;724;718;616;102
3;60501;60500;23-320;656;491;488;461;27
4;60501;60500;23-320;423;285;284;254;30
1;60502;60500;23-305;635;551;544;509;35
2;60502;60500;23-305;503;455;453;435;18
3;60502;60500;23-305;375;296;295;279;16
4;60502;60500;23-305;387;312;312;291;21
5;60502;60500;23-305;201;166;165;156;9
1;60503;60500;23-304;939;696;692;643;49
2;60503;60500;23-304;756;582;579;535;44
3;60503;60500;23-304;574;408;405;374;31
4;60503;60500;23-304;383;280;278;265;13
5;60503;60500;23-304;364;253;252;224;28
6;60503;60500;23-304;577;399;394;368;26
7;60503;60500;23-304;538;409;405;388;17
8;60503;60500;23-304;519;382;380;345;35
1;60504;60500;23-302;1531;1254;1251;1191;60
2;60504;60500;23-302;482;379;377;358;19
3;60504;60500;23-302;242;207;207;198;9
4;60504;60500;23-302;1030;850;843;771;72
5;60504;60500;23-302;1059;850;843;815;28
1;60505;60500;23-300;1592;1158;1152;854;298
2;60505;60500;23-300;1266;813;807;593;214
3;60505;60500;23-300;1589;1234;1227;807;420
4;60505;60500;23-300;1236;833;828;567;261
5;60505;60500;23-300;1871;1444;1429;1057;372
6;60505;60500;23-300;1822;1289;1280;953;327
7;60505;60500;23-300;355;228;228;195;33
8;60505;60500;23-300;996;755;749;651;98
9;60505;60500;23-300;686;480;476;391;85
10;60505;60500;23-300;111;39;38;31;7
1;60506;60500;23-310;1417;986;976;792;184
2;60506;60500;23-310;1116;761;756;545;211
3;60506;60500;23-310;330;229;228;175;53
4;60506;60500;23-310;361;252;250;216;34
5;60506;60500;23-310;793;537;534;459;75
6;60506;60500;23-310;1192;845;837;712;125
1;60507;60500;23-313;1138;750;744;617;127
2;60507;60500;23-313;731;486;486;420;66
3;60507;60500;23-313;777;551;549;448;101
4;60507;60500;23-313;241;166;166;145;21
5;60507;60500;23-313;182;132;132;117;15
6;60507;60500;23-313;201;129;128;109;19
7;60507;60500;23-313;203;141;138;125;13
1;60601;60600;22-300;829;523;515;252;263
2;60601;60600;22-300;957;616;613;385;228
3;60601;60600;22-300;1004;623;616;370;246
4;60601;60600;22-300;672;408;406;219;187
5;60601;60600;22-300;870;589;585;339;246
6;60601;60600;22-300;711;442;441;250;191
7;60601;60600;22-300;975;649;646;371;275
8;60601;60600;22-300;691;524;522;251;271
9;60601;60600;22-300;874;571;563;316;247
10;60601;60600;22-300;785;467;467;243;224
11;60601;60600;22-300;973;646;644;348;296
12;60601;60600;22-300;780;503;500;287;213
13;60601;60600;22-300;998;648;647;339;308
14;60601;60600;22-300;1177;831;827;415;412
15;60601;60600;22-300;908;626;619;356;263
16;60601;60600;22-300;181;88;86;64;22
17;60601;60600;22-300;172;104;103;44;59
18;60601;60600;22-300;115;41;38;8;30
1;60602;60600;21-060;1045;709;701;497;204
2;60602;60600;21-060;555;372;366;293;73
3;60602;60600;21-060;787;579;579;510;69
4;60602;60600;21-060;456;313;310;237;73
5;60602;60600;21-060;520;379;377;308;69
6;60602;60600;21-060;162;123;123;112;11
1;60603;60600;22-315;606;377;375;265;110
2;60603;60600;22-315;458;288;286;221;65
3;60603;60600;22-315;390;246;244;143;101
4;60603;60600;22-315;231;147;144;126;18
5;60603;60600;22-315;469;279;276;219;57
6;60603;60600;22-315;85;50;50;35;15
7;60603;60600;22-315;161;112;111;89;22
8;60603;60600;22-315;248;151;150;94;56
1;60604;60600;22-375;1309;833;823;528;295
2;60604;60600;22-375;563;356;352;246;106
3;60604;60600;22-375;585;363;359;258;101
4;60604;60600;22-375;634;382;379;282;97
5;60604;60600;22-375;791;477;471;349;122
6;60604;60600;22-375;475;284;281;239;42
7;60604;60600;22-375;674;476;476;393;83
8;60604;60600;22-375;691;406;404;343;61
9;60604;60600;22-375;405;264;263;198;65
1;60605;60600;22-300;281;157;154;99;55
2;60605;60600;22-300;281;189;188;128;60
3;60605;60600;22-300;268;173;171;101;70
4;60605;60600;22-300;392;253;252;203;49
5;60605;60600;22-300;340;219;218;163;55
6;60605;60600;22-300;512;332;330;235;95
7;60605;60600;22-300;436;264;261;202;59
8;60605;60600;22-302;508;304;302;247;55
9;60605;60600;22-302;227;138;137;92;45
10;60605;60600;22-302;201;107;106;87;19
11;60605;60600;22-302;357;218;217;185;32
12;60605;60600;22-302;189;111;111;80;31
13;60605;60600;22-302;177;122;120;76;44
14;60605;60600;22-302;583;378;377;240;137
15;60605;60600;22-302;416;286;285;204;81
16;60605;60600;22-300;476;315;312;189;123
17;60605;60600;22-300;235;172;172;103;69
18;60605;60600;22-300;207;123;122;99;23
19;60605;60600;22-302;264;163;162;100;62
1;60606;60600;22-310;306;162;161;121;40
2;60606;60600;22-310;945;584;576;365;211
3;60606;60600;22-310;142;104;103;89;14
4;60606;60600;22-310;132;96;96;77;19
5;60606;60600;22-310;159;88;86;66;20
6;60606;60600;22-310;202;119;118;89;29
7;60606;60600;22-310;632;389;388;292;96
8;60606;60600;22-310;117;86;83;70;13
9;60606;60600;22-310;49;31;31;19;12
10;60606;60600;22-310;66;52;48;31;17
11;60606;60600;22-310;42;28;28;22;6
1;60607;60600;22-351;361;245;242;210;32
2;60607;60600;22-351;478;297;293;235;58
3;60607;60600;22-351;664;459;456;369;87
4;60607;60600;22-351;379;207;205;157;48
5;60607;60600;22-351;267;163;162;109;53
6;60607;60600;22-351;291;191;191;156;35
7;60607;60600;22-351;177;111;111;90;21
8;60607;60600;22-351;302;210;207;150;57
1;60609;60600;22-330;323;188;186;144;42
2;60609;60600;22-330;833;530;526;396;130
3;60609;60600;22-330;536;330;330;270;60
4;60609;60600;22-330;362;230;229;191;38
5;60609;60600;22-335;294;192;191;160;31
1;60610;60600;22-304;567;367;366;232;134
2;60610;60600;22-304;896;579;572;361;211
3;60610;60600;22-304;416;258;255;141;114
4;60610;60600;22-304;293;177;176;113;63
5;60610;60600;22-304;294;174;172;125;47
6;60610;60600;22-304;181;91;91;58;33
7;60610;60600;22-304;183;99;99;62;37
8;60610;60600;22-304;266;157;157;85;72
1;60611;60600;22-335;536;324;323;257;66
2;60611;60600;22-335;944;568;564;410;154
3;60611;60600;22-335;402;237;236;190;46
4;60611;60600;22-335;172;104;103;89;14
5;60611;60600;22-335;519;288;287;225;62
6;60611;60600;22-335;405;274;273;231;42
7;60611;60600;22-335;343;197;194;176;18
8;60611;60600;22-335;451;301;298;253;45
9;60611;60600;22-335;192;106;102;74;28
1;60701;60700;23-204;565;352;348;207;141
2;60701;60700;23-204;738;496;492;256;236
3;60701;60700;23-204;858;480;474;319;155
4;60701;60700;23-204;1920;1453;1436;862;574
5;60701;60700;23-204;2037;1454;1438;864;574
6;60701;60700;23-204;807;463;453;277;176
7;60701;60700;23-204;1867;1354;1337;764;573
8;60701;60700;23-204;1197;798;788;454;334
9;60701;60700;23-204;888;577;568;365;203
10;60701;60700;23-204;1262;823;810;520;290
11;60701;60700;23-204;749;496;489;290;199
12;60701;60700;23-200;789;516;509;350;159
13;60701;60700;23-200;1747;1202;1191;784;407
14;60701;60700;23-200;1339;870;858;503;355
15;60701;60700;23-200;1409;930;922;518;404
16;60701;60700;23-200;750;482;476;299;177
17;60701;60700;23-200;1210;809;797;466;331
18;60701;60700;23-200;831;568;567;358;209
19;60701;60700;23-200;1062;724;714;438;276
20;60701;60700;23-200;803;513;510;299;211
21;60701;60700;23-200;913;599;591;333;258
22;60701;60700;23-200;137;45;44;29;15
1;60702;60700;23-235;1253;849;843;544;299
2;60702;60700;23-235;305;212;212;177;35
3;60702;60700;23-235;757;468;464;360;104
4;60702;60700;23-235;635;433;429;363;66
5;60702;60700;23-235;1012;689;683;545;138
6;60702;60700;23-235;439;292;292;250;42
7;60702;60700;23-235;381;228;227;185;42
8;60702;60700;23-235;330;222;220;171;49
9;60702;60700;23-235;342;238;236;200;36
10;60702;60700;23-235;859;563;557;377;180
1;60703;60700;23-251;938;657;653;471;182
2;60703;60700;23-251;615;380;373;316;57
3;60703;60700;23-251;411;277;274;221;53
4;60703;60700;23-251;1035;707;702;481;221
5;60703;60700;23-251;350;255;251;215;36
6;60703;60700;23-251;666;454;448;375;73
1;60704;60700;23-275;855;566;563;385;178
2;60704;60700;23-275;354;239;239;203;36
3;60704;60700;23-275;414;268;265;232;33
4;60704;60700;23-275;449;254;252;226;26
5;60704;60700;23-275;473;278;275;233;42
6;60704;60700;23-275;350;225;225;177;48
7;60704;60700;23-275;455;268;267;214;53
8;60704;60700;23-275;298;199;199;158;41
9;60704;60700;23-275;658;419;417;304;113
10;60704;60700;23-275;214;104;104;77;27
11;60704;60700;23-275;308;214;214;169;45
12;60704;60700;23-275;279;187;187;146;41
13;60704;60700;23-275;185;115;115;80;35
1;60705;60700;23-200;1369;879;869;617;252
2;60705;60700;23-200;735;470;466;334;132
3;60705;60700;23-206;1187;803;797;598;199
4;60705;60700;23-206;1125;766;762;587;175
5;60705;60700;23-206;942;609;605;537;68
1;60706;60700;23-225;314;206;205;170;35
2;60706;60700;23-225;613;451;447;401;46
3;60706;60700;23-225;866;585;583;470;113
4;60706;60700;23-225;788;529;525;475;50
5;60706;60700;23-225;706;499;496;444;52
6;60706;60700;23-225;382;273;272;240;32
7;60706;60700;23-225;326;231;231;198;33
8;60706;60700;23-225;253;176;176;151;25
1;60707;60700;23-230;815;523;518;372;146
2;60707;60700;23-230;252;178;177;144;33
3;60707;60700;23-230;238;165;163;137;26
4;60707;60700;23-230;177;121;120;91;29
5;60707;60700;23-230;343;209;208;167;41
6;60707;60700;23-230;640;412;407;303;104
7;60707;60700;23-230;608;388;381;279;102
8;60707;60700;23-230;916;556;554;413;141
9;60707;60700;23-230;256;136;136;108;28
10;60707;60700;23-230;279;193;192;145;47
11;60707;60700;23-230;208;148;146;124;22
1;60708;60700;23-250;813;588;585;454;131
2;60708;60700;23-250;892;583;573;467;106
3;60708;60700;23-250;629;433;428;339;89
4;60708;60700;23-250;1189;823;812;576;236
5;60708;60700;23-250;1045;709;701;551;150
6;60708;60700;23-250;450;293;289;212;77
7;60708;60700;23-250;913;610;605;538;67
8;60708;60700;23-250;379;254;253;225;28
9;60708;60700;23-250;172;103;97;71;26
1;60709;60700;23-212;960;728;725;585;140
2;60709;60700;23-212;1114;824;813;684;129
3;60709;60700;23-212;1341;1014;1010;845;165
4;60709;60700;23-212;678;501;500;425;75
1;60710;60700;23-213;658;440;437;350;87
2;60710;60700;23-213;565;390;388;324;64
3;60710;60700;23-213;372;252;250;215;35
4;60710;60700;23-213;875;597;597;528;69
5;60710;60700;23-213;509;353;351;290;61
6;60710;60700;23-213;1542;1099;1095;839;256
7;60710;60700;23-213;281;210;208;184;24
1;60801;60800;21-100;1852;1389;1375;790;585
2;60801;60800;21-100;1675;1227;1217;652;565
3;60801;60800;21-100;1504;1160;1146;717;429
4;60801;60800;21-100;1377;996;989;540;449
5;60801;60800;21-100;1025;730;720;408;312
6;60801;60800;21-100;1107;811;797;421;376
7;60801;60800;21-100;1072;759;755;415;340
8;60801;60800;21-100;1319;931;924;552;372
9;60801;60800;21-100;1432;1041;1034;594;440
10;60801;60800;21-100;1506;1104;1092;607;485
11;60801;60800;21-100;1602;1238;1229;696;533
12;60801;60800;21-100;143;57;56;44;12
1;60802;60800;21-143;1046;764;760;645;115
2;60802;60800;21-143;276;207;206;178;28
3;60802;60800;21-143;213;158;156;132;24
4;60802;60800;21-143;306;210;209;188;21
5;60802;60800;21-143;431;305;300;249;51
6;60802;60800;21-143;429;261;258;221;37
7;60802;60800;21-143;364;263;261;230;31
1;60803;60800;21-150;557;375;373;307;66
2;60803;60800;21-150;328;232;230;193;37
3;60803;60800;21-136;1596;1070;1061;733;328
4;60803;60800;21-136;379;265;262;195;67
5;60803;60800;21-136;374;209;208;153;55
6;60803;60800;21-136;467;306;303;240;63
7;60803;60800;21-136;367;243;241;215;26
8;60803;60800;21-136;405;252;250;211;39
1;60804;60800;21-146;650;422;419;332;87
2;60804;60800;21-146;919;621;616;505;111
3;60804;60800;21-146;450;313;313;264;49
1;60805;60800;21-132;678;445;439;332;107
2;60805;60800;21-132;314;215;211;181;30
3;60805;60800;21-132;503;357;353;274;79
4;60805;60800;21-132;293;221;220;118;102
5;60805;60800;21-132;811;548;543;383;160
6;60805;60800;21-132;653;439;436;302;134
7;60805;60800;21-132;409;280;277;201;76
8;60805;60800;21-132;713;474;464;319;145
9;60805;60800;21-132;524;365;356;252;104
10;60805;60800;21-132;192;130;129;111;18
1;60806;60800;21-150;1098;728;725;562;163
2;60806;60800;21-150;1301;892;887;634;253
3;60806;60800;21-150;453;319;316;284;32
4;60806;60800;21-150;429;302;300;276;24
5;60806;60800;21-150;245;159;157;147;10
6;60806;60800;21-150;553;418;415;358;57
7;60806;60800;21-150;504;355;352;322;30
8;60806;60800;21-150;67;30;30;24;6
1;60807;60800;21-100;223;162;161;103;58
2;60807;60800;21-100;1014;732;727;449;278
3;60807;60800;21-100;370;287;280;208;72
4;60807;60800;21-100;613;430;424;304;120
5;60807;60800;21-100;462;326;323;271;52
6;60807;60800;21-100;893;630;624;415;209
7;60807;60800;21-100;840;606;602;384;218
8;60807;60800;21-100;577;395;392;275;117
9;60807;60800;21-100;642;477;473;355;118
10;60807;60800;21-100;486;344;341;266;75
11;60807;60800;21-100;556;381;380;287;93
12;60807;60800;21-100;254;185;185;156;29
13;60807;60800;21-100;271;217;211;158;53
14;60807;60800;21-100;502;353;349;247;102
15;60807;60800;21-100;761;573;568;376;192
16;60807;60800;21-100;438;327;324;229;95
17;60807;60800;21-100;69;55;54;46;8
1;60808;60800;21-140;1197;853;843;579;264
2;60808;60800;21-140;936;617;614;520;94
3;60808;60800;21-140;647;449;446;398;48
4;60808;60800;21-140;1153;714;708;573;135
5;60808;60800;21-140;293;200;200;170;30
6;60808;60800;21-140;244;157;155;124;31
1;60809;60800;21-104;848;605;603;480;123
2;60809;60800;21-104;994;687;682;564;118
3;60809;60800;21-104;797;527;523;411;112
4;60809;60800;21-104;666;500;499;408;91
5;60809;60800;21-104;880;589;583;518;65
6;60809;60800;21-104;649;442;436;347;89
1;60810;60800;21-110;1043;748;742;518;224
2;60810;60800;21-110;534;402;400;307;93
3;60810;60800;21-110;402;287;285;246;39
4;60810;60800;21-110;604;428;419;367;52
5;60810;60800;21-110;1067;744;732;574;158
6;60810;60800;21-110;212;160;159;147;12
1;60811;60800;21-102;391;282;281;250;31
2;60811;60800;21-102;411;283;280;235;45
3;60811;60800;21-102;391;261;259;212;47
4;60811;60800;21-102;692;494;489;397;92
5;60811;60800;21-102;331;226;224;179;45
6;60811;60800;21-102;636;411;410;340;70
1;60812;60800;21-107;853;607;601;477;124
2;60812;60800;21-107;711;535;529;459;70
3;60812;60800;21-107;840;627;624;544;80
4;60812;60800;21-107;925;662;651;481;170
5;60812;60800;21-107;438;334;330;288;42
1;60813;60800;21-109;748;507;503;403;100
2;60813;60800;21-109;658;489;488;398;90
3;60813;60800;21-109;642;428;426;318;108
4;60813;60800;21-109;419;301;298;192;106
1;60901;60900;24-200;1069;745;732;493;239
2;60901;60900;24-200;1095;778;769;483;286
3;60901;60900;24-200;978;769;760;528;232
4;60901;60900;24-200;544;394;391;261;130
5;60901;60900;24-200;868;583;576;407;169
6;60901;60900;24-200;731;546;535;397;138
7;60901;60900;24-200;704;449;443;349;94
8;60901;60900;24-200;799;562;556;472;84
9;60901;60900;24-200;779;531;528;416;112
10;60901;60900;24-200;652;466;463;400;63
11;60901;60900;24-200;469;325;324;264;60
12;60901;60900;24-200;322;251;249;204;45
13;60901;60900;24-200;438;344;343;252;91
14;60901;60900;24-200;239;166;166;145;21
15;60901;60900;24-200;78;22;21;17;4
1;60902;60900;24-224;909;696;690;517;173
2;60902;60900;24-224;693;519;517;466;51
3;60902;60900;24-224;487;318;315;277;38
4;60902;60900;24-224;379;255;250;222;28
5;60902;60900;24-224;223;151;151;126;25
6;60902;60900;24-224;207;153;153;136;17
1;60903;60900;23-100;626;446;444;334;110
2;60903;60900;23-100;520;369;365;259;106
3;60903;60900;23-100;742;520;508;370;138
4;60903;60900;23-100;649;433;423;163;260
5;60903;60900;23-100;523;354;350;229;121
6;60903;60900;23-100;467;286;286;194;92
7;60903;60900;23-100;683;472;469;319;150
8;60903;60900;23-100;581;383;379;302;77
9;60903;60900;23-100;487;364;362;284;78
10;60903;60900;23-100;330;232;231;183;48
11;60903;60900;23-100;367;232;226;175;51
12;60903;60900;23-100;351;246;245;213;32
13;60903;60900;23-100;578;419;418;367;51
14;60903;60900;23-100;348;222;221;191;30
15;60903;60900;23-100;503;330;328;251;77
16;60903;60900;23-100;179;130;130;112;18
17;60903;60900;23-100;200;136;136;105;31
18;60903;60900;23-100;182;136;136;118;18
19;60903;60900;23-100;323;222;220;177;43
20;60903;60900;23-100;57;25;24;18;6
1;60904;60900;21-080;1699;1265;1249;830;419
2;60904;60900;21-080;890;673;664;490;174
3;60904;60900;21-080;1362;966;957;646;311
4;60904;60900;21-080;522;381;377;293;84
5;60904;60900;21-080;1096;751;747;598;149
6;60904;60900;21-080;359;256;254;209;45
7;60904;60900;21-080;211;140;138;127;11
8;60904;60900;21-080;409;294;289;229;60
9;60904;60900;21-080;174;126;126;105;21
10;60904;60900;21-080;263;198;197;172;25
1;60905;60900;20-515;1416;1099;1092;663;429
2;60905;60900;21-040;2674;2233;2210;1071;1139
3;60905;60900;20-388;1577;1242;1231;693;538
4;60905;60900;20-388;193;133;132;83;49
5;60905;60900;20-388;1254;936;930;599;331
6;60905;60900;20-388;1028;786;778;565;213
7;60905;60900;20-388;980;755;749;458;291
8;60905;60900;20-388;347;261;257;200;57
9;60905;60900;21-040;499;393;387;231;156
10;60905;60900;20-388;242;187;186;127;59
11;60905;60900;20-388;214;152;148;83;65
1;60906;60900;23-114;595;379;378;311;67
2;60906;60900;23-114;899;625;620;445;175
3;60906;60900;23-114;1689;1211;1198;857;341
4;60906;60900;23-114;1347;848;842;658;184
5;60906;60900;23-114;896;619;613;449;164
6;60906;60900;23-114;414;296;293;220;73
7;60906;60900;23-114;564;411;406;282;124
1;60907;60900;21-002;1691;1243;1232;686;546
2;60907;60900;24-150;1121;775;770;593;177
3;60907;60900;21-002;2246;1829;1809;949;860
4;60907;60900;21-008;1016;804;796;493;303
5;60907;60900;21-008;1638;1206;1196;843;353
6;60907;60900;21-002;1035;810;801;640;161
7;60907;60900;21-008;1278;1022;1009;618;391
8;60907;60900;21-002;1375;1036;1019;608;411
1;60908;60900;21-030;1433;1098;1085;562;523
2;60908;60900;21-030;1619;1283;1269;647;622
3;60908;60900;21-030;2434;1908;1881;983;898
4;60908;60900;21-030;1947;1464;1450;897;553
5;60908;60900;20-050;1788;1479;1465;678;787
6;60908;60900;20-515;2173;1590;1566;960;606
1;60909;60900;23-110;863;592;584;400;184
2;60909;60900;23-110;506;342;340;283;57
3;60909;60900;23-110;461;342;341;289;52
4;60909;60900;23-110;509;336;332;260;72
5;60909;60900;23-110;367;240;238;204;34
6;60909;60900;23-110;718;469;466;325;141
1;60910;60900;24-220;1656;1246;1234;806;428
2;60910;60900;24-220;2036;1527;1514;1016;498
3;60910;60900;24-220;1197;863;856;646;210
4;60910;60900;24-220;303;205;203;156;47
5;60910;60900;24-220;834;619;610;397;213
6;60910;60900;24-220;360;296;291;223;68
7;60910;60900;20-515;1203;938;924;631;293
8;60910;60900;24-220;485;329;328;240;88
9;60910;60900;24-220;380;274;270;221;49
10;60910;60900;24-220;330;247;245;191;54
11;60910;60900;24-220;395;281;277;223;54
1;60911;60900;21-003;1910;1374;1363;868;495
2;60911;60900;21-003;2099;1628;1618;990;628
3;60911;60900;21-003;2310;1901;1877;949;928
4;60911;60900;21-025;2178;1591;1570;1002;568
5;60911;60900;21-003;981;756;753;383;370
6;60911;60900;21-025;1474;1128;1115;789;326
7;60911;60900;21-025;1026;731;724;488;236
8;60911;60900;21-025;2185;1653;1637;1172;465
9;60911;60900;21-025;1021;704;701;455;246
10;60911;60900;21-025;1034;776;771;561;210
11;60911;60900;21-025;307;225;224;155;69
1;60912;60900;23-107;1343;1035;1023;717;306
2;60912;60900;23-107;1032;694;689;473;216
3;60912;60900;23-107;1048;687;676;441;235
4;60912;60900;23-107;811;585;580;427;153
5;60912;60900;23-107;929;627;624;417;207
6;60912;60900;23-107;484;344;343;251;92
7;60912;60900;23-107;638;453;451;388;63
8;60912;60900;23-107;33;32;32;32;0
1;60913;60900;24-204;558;370;369;259;110
2;60913;60900;24-204;913;646;640;457;183
3;60913;60900;24-204;1158;821;815;594;221
4;60913;60900;24-150;403;303;299;198;101
5;60913;60900;24-204;633;448;443;317;126
6;60913;60900;24-204;984;670;666;528;138
1;60914;60900;20-258;1403;1042;1024;699;325
2;60914;60900;20-258;1007;725;714;536;178
3;60914;60900;20-258;429;327;324;234;90
4;60914;60900;20-258;1350;1020;1011;643;368
5;60914;60900;20-258;1136;845;833;576;257
6;60914;60900;20-258;498;420;417;272;145
7;60914;60900;20-258;1245;899;891;606;285
8;60914;60900;20-258;428;306;302;177;125
9;60914;60900;20-258;2532;2074;2054;1053;1001
1;60915;60900;23-145;215;155;155;116;39
2;60915;60900;23-145;734;516;515;479;36
3;60915;60900;23-145;506;348;344;285;59
4;60915;60900;23-145;229;161;160;146;14
5;60915;60900;23-145;350;250;250;203;47
6;60915;60900;23-145;1274;830;826;630;196
1;60916;60900;23-155;633;440;439;371;68
2;60916;60900;23-155;262;184;183;177;6
3;60916;60900;23-155;395;211;210;170;40
4;60916;60900;23-155;857;580;578;497;81
1;61001;61000;21-070;281;186;184;164;20
2;61001;61000;21-070;805;558;554;428;126
3;61001;61000;21-070;350;218;217;180;37
4;61001;61000;21-070;247;187;184;155;29
5;61001;61000;21-070;359;234;232;200;32
6;61001;61000;21-070;258;160;159;141;18
7;61001;61000;21-070;530;398;393;324;69
8;61001;61000;21-070;381;253;252;193;59
9;61001;61000;21-070;348;225;223;187;36
10;61001;61000;21-070;537;325;324;280;44
11;61001;61000;21-070;1283;896;890;663;227
12;61001;61000;21-070;373;257;256;229;27
1;61002;61000;21-075;391;303;299;200;99
2;61002;61000;21-075;927;648;637;500;137
3;61002;61000;21-075;853;630;627;483;144
4;61002;61000;21-075;880;589;581;433;148
5;61002;61000;21-075;628;476;472;402;70
6;61002;61000;21-075;272;185;183;160;23
7;61002;61000;21-075;380;283;275;165;110
1;61003;61000;21-010;1669;1203;1196;907;289
2;61003;61000;21-010;874;667;662;484;178
3;61003;61000;21-010;697;468;463;348;115
4;61003;61000;21-010;1034;719;715;507;208
5;61003;61000;21-010;1008;796;790;555;235
6;61003;61000;21-010;1078;763;761;478;283
7;61003;61000;21-010;1085;793;785;538;247
8;61003;61000;21-010;1187;844;834;504;330
9;61003;61000;21-010;1105;745;740;412;328
10;61003;61000;21-010;1058;820;809;562;247
11;61003;61000;21-010;1285;912;902;615;287
12;61003;61000;21-010;1187;893;887;601;286
13;61003;61000;21-010;784;566;561;384;177
14;61003;61000;21-010;992;752;746;532;214
15;61003;61000;21-010;1124;844;841;595;246
16;61003;61000;21-010;247;186;185;140;45
17;61003;61000;21-010;134;71;71;56;15
1;61004;61000;21-020;533;377;374;295;79
2;61004;61000;21-020;639;418;411;331;80
3;61004;61000;21-020;1138;741;737;530;207
4;61004;61000;21-020;1362;904;895;570;325
5;61004;61000;21-020;858;565;559;409;150
6;61004;61000;21-020;510;299;298;251;47
7;61004;61000;21-020;816;541;538;432;106
8;61004;61000;21-020;376;242;236;168;68
9;61004;61000;21-020;518;331;329;281;48
10;61004;61000;21-020;50;29;28;20;8
1;61005;61000;21-013;327;250;249;209;40
2;61005;61000;21-013;288;224;223;184;39
3;61005;61000;21-013;533;385;382;303;79
4;61005;61000;21-013;177;144;144;106;38
5;61005;61000;21-013;545;370;364;269;95
6;61005;61000;21-013;416;296;294;246;48
7;61005;61000;21-013;338;277;273;199;74
8;61005;61000;21-013;551;437;432;330;102
9;61005;61000;21-013;269;219;218;183;35
10;61005;61000;21-013;366;272;269;213;56
11;61005;61000;21-013;358;305;303;229;74
12;61005;61000;21-013;175;118;118;101;17
1;61006;61000;21-077;1373;1005;994;630;364
2;61006;61000;21-077;606;408;406;289;117
3;61006;61000;21-077;1135;769;762;571;191
4;61006;61000;21-077;329;221;219;174;45
5;61006;61000;21-077;551;390;387;291;96
6;61006;61000;21-077;297;226;225;185;40
7;61006;61000;21-077;236;160;159;130;29
1;61101;61100;21-400;790;548;539;334;205
2;61101;61100;21-400;1191;837;821;590;231
3;61101;61100;21-400;1110;852;845;584;261
4;61101;61100;21-400;1126;846;838;555;283
5;61101;61100;21-400;964;724;715;476;239
6;61101;61100;21-400;901;705;698;383;315
7;61101;61100;21-400;1139;863;856;561;295
8;61101;61100;21-400;992;711;701;502;199
9;61101;61100;21-400;1052;726;718;449;269
10;61101;61100;21-400;752;572;567;354;213
11;61101;61100;21-400;751;514;512;340;172
12;61101;61100;21-400;820;557;555;360;195
13;61101;61100;21-400;1089;725;719;523;196
14;61101;61100;21-400;831;661;659;412;247
15;61101;61100;21-400;840;660;655;388;267
16;61101;61100;21-400;853;620;611;394;217
17;61101;61100;21-400;737;596;591;349;242
18;61101;61100;21-400;1024;756;746;483;263
19;61101;61100;21-400;1544;1205;1196;756;440
20;61101;61100;21-400;980;711;707;471;236
21;61101;61100;21-400;963;729;723;491;232
22;61101;61100;21-400;141;119;117;88;29
1;61102;61100;21-450;1135;851;841;560;281
2;61102;61100;21-450;761;591;587;442;145
1;61103;61100;21-412;1573;1118;1105;812;293
2;61103;61100;21-481;1161;762;757;594;163
3;61103;61100;21-412;328;207;204;170;34
4;61103;61100;21-412;259;182;182;154;28
5;61103;61100;21-412;180;136;135;114;21
6;61103;61100;21-412;242;158;157;140;17
7;61103;61100;21-412;249;176;175;144;31
1;61104;61100;21-480;1112;749;746;656;90
2;61104;61100;21-480;641;444;439;380;59
3;61104;61100;21-470;1491;1057;1051;896;155
4;61104;61100;21-470;308;225;217;191;26
5;61104;61100;21-470;680;492;486;388;98
6;61104;61100;21-470;1630;1181;1175;899;276
7;61104;61100;21-470;163;117;117;106;11
8;61104;61100;21-470;263;171;170;134;36
9;61104;61100;21-470;377;275;273;255;18
10;61104;61100;21-470;190;144;142;120;22
11;61104;61100;21-470;267;206;206;179;27
12;61104;61100;21-470;313;216;213;189;24
1;61105;61100;21-400;504;371;369;310;59
2;61105;61100;21-400;672;497;489;422;67
3;61105;61100;21-400;587;426;421;349;72
4;61105;61100;21-400;1198;860;851;734;117
5;61105;61100;21-400;1098;819;813;687;126
6;61105;61100;21-400;762;576;573;436;137
7;61105;61100;21-400;949;698;691;489;202
8;61105;61100;21-400;426;328;327;272;55
9;61105;61100;21-400;349;245;240;194;46
10;61105;61100;21-400;542;376;374;340;34
11;61105;61100;21-400;916;676;670;520;150
12;61105;61100;21-400;374;275;274;250;24
13;61105;61100;21-400;749;566;561;463;98
14;61105;61100;21-400;191;141;141;124;17
15;61105;61100;21-400;336;241;241;216;25
16;61105;61100;21-400;286;238;237;217;20
17;61105;61100;21-400;229;163;162;143;19
18;61105;61100;21-400;149;118;118;91;27
19;61105;61100;21-400;285;236;234;193;41
20;61105;61100;21-400;193;140;139;124;15
21;61105;61100;21-400;350;267;266;211;55
22;61105;61100;21-400;644;486;481;380;101
23;61105;61100;21-400;218;154;152;136;16
24;61105;61100;21-400;483;360;359;303;56
25;61105;61100;21-400;147;114;114;104;10
26;61105;61100;21-400;437;321;317;266;51
27;61105;61100;21-400;305;214;211;180;31
28;61105;61100;21-400;43;39;38;34;4
1;61106;61100;21-413;372;269;268;227;41
2;61106;61100;21-413;331;240;237;201;36
3;61106;61100;21-413;402;260;260;240;20
4;61106;61100;21-413;1108;776;770;634;136
5;61106;61100;21-413;786;525;523;437;86
1;61107;61100;21-422;1063;744;736;475;261
2;61107;61100;21-421;970;729;721;621;100
3;61107;61100;21-421;307;224;217;182;35
4;61107;61100;21-421;677;460;457;398;59
5;61107;61100;21-421;341;233;231;191;40
6;61107;61100;21-421;271;194;192;170;22
7;61107;61100;21-421;901;664;659;572;87
8;61107;61100;21-421;489;350;348;310;38
9;61107;61100;21-421;483;328;325;275;50
10;61107;61100;21-421;325;246;245;223;22
11;61107;61100;21-421;321;228;226;192;34
12;61107;61100;21-421;227;171;170;153;17
13;61107;61100;21-421;453;331;331;283;48
14;61107;61100;21-421;154;109;109;91;18
1;61108;61100;21-450;391;292;290;232;58
2;61108;61100;21-450;497;361;361;319;42
3;61108;61100;21-450;370;254;251;236;15
4;61108;61100;21-450;322;217;217;204;13
5;61108;61100;21-450;312;213;211;171;40
6;61108;61100;21-450;364;259;258;223;35
7;61108;61100;21-450;623;461;458;408;50
8;61108;61100;21-450;352;260;259;219;40
9;61108;61100;21-450;272;185;180;156;24
10;61108;61100;21-450;331;219;216;193;23
11;61108;61100;21-450;246;201;198;168;30
12;61108;61100;21-450;314;238;238;214;24
13;61108;61100;21-450;171;137;136;125;11
14;61108;61100;21-450;175;129;127;112;15
15;61108;61100;21-450;172;129;129;108;21
16;61108;61100;21-450;161;119;119;93;26
17;61108;61100;21-450;276;220;219;181;38
18;61108;61100;21-450;186;115;115;95;20
19;61108;61100;21-450;171;121;120;104;16
1;61109;61100;21-404;738;535;534;456;78
2;61109;61100;21-404;401;308;305;284;21
3;61109;61100;21-404;470;379;379;362;17
4;61109;61100;21-404;747;605;601;524;77
5;61109;61100;21-404;774;601;599;543;56
6;61109;61100;21-404;1055;808;800;723;77
7;61109;61100;21-404;407;323;323;278;45
8;61109;61100;21-404;217;157;157;149;8
9;61109;61100;21-404;342;263;260;236;24
10;61109;61100;21-404;234;179;178;166;12
1;61110;61100;21-411;806;546;538;495;43
2;61110;61100;21-411;492;326;322;258;64
3;61110;61100;21-411;333;242;242;215;27
4;61110;61100;21-411;283;205;205;186;19
5;61110;61100;21-411;1149;793;789;671;118
6;61110;61100;21-411;370;252;251;208;43
7;61110;61100;21-411;373;240;239;195;44
8;61110;61100;21-411;537;381;378;340;38
9;61110;61100;21-411;428;306;304;271;33
10;61110;61100;21-411;211;168;168;157;11
1;61111;61100;21-426;705;540;539;480;59
2;61111;61100;21-426;956;664;661;542;119
3;61111;61100;21-426;1026;715;711;632;79
4;61111;61100;21-426;812;551;545;438;107
1;61201;61200;24-350;974;711;700;556;144
2;61201;61200;24-350;383;288;287;221;66
3;61201;61200;24-350;1142;736;724;614;110
4;61201;61200;24-350;394;290;287;255;32
5;61201;61200;24-350;1049;683;676;545;131
6;61201;61200;24-350;424;319;318;267;51
7;61201;61200;24-350;281;181;181;168;13
8;61201;61200;24-350;199;147;144;131;13
1;61202;61200;24-340;1776;1192;1173;837;336
2;61202;61200;24-340;677;450;447;371;76
3;61202;61200;24-340;504;335;331;295;36
4;61202;61200;24-340;676;415;412;298;114
5;61202;61200;24-340;352;215;214;153;61
6;61202;61200;24-340;318;203;201;154;47
7;61202;61200;24-340;159;118;117;102;15
8;61202;61200;24-340;414;269;265;222;43
1;61203;61200;24-310;1282;823;818;554;264
2;61203;61200;24-310;835;525;522;381;141
3;61203;61200;24-310;592;382;379;296;83
4;61203;61200;24-310;352;224;222;163;59
5;61203;61200;24-310;360;224;218;172;46
6;61203;61200;24-120;490;318;317;236;81
7;61203;61200;24-310;296;174;171;140;31
1;61204;61200;24-335;550;382;381;327;54
2;61204;61200;24-335;1007;662;658;466;192
3;61204;61200;24-335;750;487;486;345;141
4;61204;61200;24-335;609;387;386;350;36
5;61204;61200;24-335;484;323;322;260;62
6;61204;61200;24-335;293;175;175;134;41
1;61205;61200;24-300;1375;922;914;580;334
2;61205;61200;24-300;1544;1091;1082;665;417
3;61205;61200;24-300;1754;1128;1117;687;430
4;61205;61200;24-300;869;605;599;339;260
5;61205;61200;24-300;1015;662;652;437;215
6;61205;61200;24-300;581;362;360;290;70
7;61205;61200;24-300;769;510;504;408;96
8;61205;61200;24-320;673;427;423;319;104
9;61205;61200;24-300;291;198;198;160;38
10;61205;61200;24-300;566;377;376;300;76
11;61205;61200;24-300;387;280;275;222;53
12;61205;61200;24-300;430;294;294;226;68
13;61205;61200;24-300;559;324;322;255;67
14;61205;61200;24-300;299;190;189;137;52
15;61205;61200;24-300;440;294;289;220;69
16;61205;61200;24-300;334;209;208;170;38
17;61205;61200;24-300;170;121;120;77;43
18;61205;61200;24-300;153;116;115;101;14
19;61205;61200;24-300;160;97;95;73;22
20;61205;61200;24-300;470;381;372;77;295
21;61205;61200;24-300;34;0;0;0;0
1;61206;61200;24-320;1450;1068;1056;663;393
2;61206;61200;24-320;1208;841;832;484;348
3;61206;61200;24-320;796;565;563;345;218
4;61206;61200;24-320;987;640;631;371;260
5;61206;61200;24-320;841;547;542;314;228
6;61206;61200;24-320;1096;752;744;491;253
7;61206;61200;24-320;832;554;552;425;127
8;61206;61200;24-320;753;508;502;374;128
9;61206;61200;24-320;900;643;640;493;147
10;61206;61200;24-320;723;501;499;403;96
11;61206;61200;24-320;495;340;333;284;49
12;61206;61200;24-320;78;33;33;20;13
13;61206;61200;24-320;35;19;19;15;4
1;61207;61200;24-313;902;604;598;503;95
2;61207;61200;24-313;265;194;193;157;36
3;61207;61200;24-313;367;253;252;202;50
4;61207;61200;24-313;601;405;403;310;93
5;61207;61200;24-313;167;111;110;86;24
6;61207;61200;24-313;429;315;315;271;44
7;61207;61200;24-313;358;240;238;209;29
8;61207;61200;24-313;277;184;181;155;26
1;61301;61300;21-211;527;339;338;244;94
2;61301;61300;21-211;935;557;552;379;173
3;61301;61300;21-211;305;190;189;155;34
4;61301;61300;21-211;248;186;182;127;55
5;61301;61300;21-211;414;259;259;191;68
6;61301;61300;21-211;240;187;187;115;72
7;61301;61300;21-211;289;181;181;132;49
1;61302;61300;21-205;987;675;671;478;193
2;61302;61300;21-205;514;368;361;299;62
3;61302;61300;21-205;374;238;238;166;72
4;61302;61300;21-205;349;247;244;218;26
5;61302;61300;21-205;203;100;98;62;36
6;61302;61300;21-205;319;245;244;223;21
1;61303;61300;21-210;786;520;512;380;132
2;61303;61300;21-210;558;352;347;295;52
3;61303;61300;21-210;479;275;270;188;82
4;61303;61300;21-210;427;298;297;263;34
5;61303;61300;21-210;296;218;211;159;52
6;61303;61300;21-210;252;167;167;131;36
1;61304;61300;21-200;1618;1130;1118;685;433
2;61304;61300;21-200;1417;1026;1017;580;437
3;61304;61300;21-200;185;135;134;82;52
4;61304;61300;21-200;582;358;356;219;137
5;61304;61300;21-200;1586;1064;1061;587;474
6;61304;61300;21-200;320;222;221;162;59
7;61304;61300;21-200;1506;1024;1020;617;403
8;61304;61300;21-200;894;601;597;350;247
9;61304;61300;21-200;609;403;398;275;123
10;61304;61300;21-200;494;302;295;225;70
11;61304;61300;21-200;548;350;346;261;85
12;61304;61300;21-200;519;346;346;258;88
13;61304;61300;21-200;210;137;135;102;33
14;61304;61300;21-200;123;62;61;39;22
1;61305;61300;21-222;428;301;297;221;76
2;61305;61300;21-222;407;289;288;230;58
3;61305;61300;21-222;381;222;221;156;65
1;61306;61300;21-220;1198;816;813;624;189
2;61306;61300;21-220;560;352;347;256;91
3;61306;61300;21-220;384;256;256;222;34
4;61306;61300;21-220;599;392;391;327;64
5;61306;61300;21-220;303;180;178;140;38
6;61306;61300;21-220;364;242;242;184;58
1;61307;61300;21-230;486;363;358;252;106
2;61307;61300;21-230;571;405;403;236;167
3;61307;61300;21-230;481;281;279;202;77
4;61307;61300;21-230;348;209;205;154;51
1;61401;61400;24-100;1636;1074;1065;600;465
2;61401;61400;24-100;1624;1265;1251;643;608
3;61401;61400;24-100;1478;994;983;524;459
4;61401;61400;24-100;1430;1029;1018;508;510
5;61401;61400;24-100;1813;1369;1351;725;626
6;61401;61400;24-100;1552;1144;1135;510;625
7;61401;61400;24-100;586;443;441;219;222
8;61401;61400;24-100;1619;1233;1222;638;584
9;61401;61400;24-100;1799;1349;1338;748;590
10;61401;61400;24-100;1563;1018;1009;506;503
11;61401;61400;24-100;2438;1956;1927;921;1006
12;61401;61400;24-100;1759;1345;1330;597;733
13;61401;61400;24-100;1171;861;851;415;436
14;61401;61400;24-100;1591;1087;1080;566;514
15;61401;61400;24-100;1255;946;933;460;473
16;61401;61400;24-100;1688;1291;1275;620;655
17;61401;61400;24-100;1371;901;893;495;398
18;61401;61400;24-100;1303;900;891;484;407
19;61401;61400;24-100;1135;767;761;454;307
20;61401;61400;24-100;1745;1281;1275;695;580
21;61401;61400;24-100;1285;852;840;520;320
22;61401;61400;24-100;975;686;683;383;300
23;61401;61400;24-100;1128;811;796;442;354
24;61401;61400;24-100;170;107;107;69;38
1;61402;61400;24-105;788;517;511;349;162
2;61402;61400;24-105;629;419;415;293;122
3;61402;61400;24-105;203;145;145;123;22
4;61402;61400;24-105;301;219;218;182;36
5;61402;61400;24-105;229;167;166;127;39
6;61402;61400;24-105;352;245;243;209;34
7;61402;61400;24-105;173;127;127;99;28
8;61402;61400;24-105;249;161;159;120;39
9;61402;61400;24-105;35;5;5;4;1
1;61403;61400;24-123;262;194;193;123;70
2;61403;61400;24-123;773;549;543;313;230
3;61403;61400;24-123;538;374;368;258;110
4;61403;61400;24-123;414;296;294;236;58
5;61403;61400;24-123;663;480;475;287;188
6;61403;61400;24-123;239;166;166;135;31
1;61404;61400;24-120;1747;1346;1324;620;704
2;61404;61400;24-120;1609;1151;1144;750;394
3;61404;61400;24-120;990;671;667;447;220
4;61404;61400;24-120;695;402;397;290;107
5;61404;61400;24-120;567;381;378;287;91
1;61405;61400;24-130;997;746;736;468;268
2;61405;61400;24-130;912;674;665;386;279
3;61405;61400;24-130;534;385;381;231;150
4;61405;61400;24-130;491;324;321;213;108
5;61405;61400;24-130;773;577;568;408;160
6;61405;61400;24-130;616;446;444;344;100
7;61405;61400;24-130;547;398;394;290;104
8;61405;61400;24-130;445;306;303;250;53
9;61405;61400;24-130;846;559;557;444;113
10;61405;61400;24-130;447;328;325;248;77
1;61406;61400;24-170;1194;840;833;535;298
2;61406;61400;24-170;1127;848;838;585;253
3;61406;61400;24-170;537;372;370;240;130
4;61406;61400;24-170;603;420;417;326;91
5;61406;61400;24-170;554;377;372;317;55
6;61406;61400;24-170;334;222;218;205;13
7;61406;61400;24-170;996;705;698;513;185
8;61406;61400;24-150;204;123;122;88;34
9;61406;61400;24-170;274;162;161;133;28
1;61407;61400;24-173;882;656;650;476;174
2;61407;61400;24-173;663;434;430;304;126
3;61407;61400;24-173;231;176;175;156;19
4;61407;61400;24-173;510;348;347;269;78
1;61408;61400;24-150;1403;1036;1028;531;497
2;61408;61400;24-150;885;649;641;443;198
3;61408;61400;24-150;760;564;558;339;219
4;61408;61400;24-150;1020;787;782;373;409
5;61408;61400;24-150;569;405;401;307;94
6;61408;61400;24-150;451;326;322;271;51
7;61408;61400;24-150;679;476;472;329;143
8;61408;61400;24-150;546;361;359;269;90
9;61408;61400;24-150;594;435;432;281;151
10;61408;61400;24-150;311;222;219;161;58
11;61408;61400;24-150;333;288;284;154;130
12;61408;61400;24-150;135;135;134;80;54
13;61408;61400;24-150;139;126;125;55;70
14;61408;61400;24-150;92;92;92;48;44
15;61408;61400;24-150;32;30;29;25;4
16;61408;61400;24-150;118;116;112;53;59
1;61409;61400;24-100;1651;1226;1212;677;535
2;61409;61400;24-100;1361;945;936;580;356
3;61409;61400;24-100;1866;1302;1288;803;485
4;61409;61400;24-100;529;358;356;269;87
5;61409;61400;24-100;603;393;390;271;119
6;61409;61400;24-100;762;580;577;418;159
7;61409;61400;24-100;597;435;429;313;116
8;61409;61400;24-100;760;539;532;423;109
9;61409;61400;24-100;1285;926;917;654;263
1;61410;61400;24-160;1276;924;919;721;198
2;61410;61400;24-160;699;490;487;401;86
3;61410;61400;24-160;916;626;624;498;126
4;61410;61400;24-160;436;292;287;207;80
5;61410;61400;24-160;183;44;41;22;19
1;61411;61400;24-103;321;234;233;190;43
2;61411;61400;24-103;1207;825;815;521;294
3;61411;61400;24-103;731;524;517;409;108
4;61411;61400;24-103;419;330;329;268;61
5;61411;61400;24-103;476;319;317;262;55
6;61411;61400;24-103;266;180;177;120;57
7;61411;61400;24-103;375;249;246;209;37
8;61411;61400;24-103;216;139;137;110;27
9;61411;61400;24-103;285;218;217;173;44
10;61411;61400;24-103;199;132;131;94;37
11;61411;61400;24-103;282;221;221;176;45
12;61411;61400;24-103;60;55;53;9;44
1;61501;61500;21-300;1590;1151;1144;668;476
2;61501;61500;21-300;1604;1121;1105;731;374
3;61501;61500;21-300;904;642;640;438;202
4;61501;61500;21-300;1383;921;914;559;355
5;61501;61500;21-300;1379;980;972;643;329
6;61501;61500;21-300;1422;1001;998;607;391
7;61501;61500;21-300;690;471;469;285;184
8;61501;61500;21-300;612;460;454;289;165
9;61501;61500;21-300;1345;896;891;615;276
10;61501;61500;21-300;199;98;97;76;21
1;61502;61500;21-345;524;367;366;241;125
2;61502;61500;21-345;510;341;339;299;40
3;61502;61500;21-345;336;207;207;191;16
4;61502;61500;21-345;684;430;424;293;131
5;61502;61500;21-345;701;449;448;373;75
6;61502;61500;21-345;186;130;127;106;21
7;61502;61500;21-345;384;278;274;221;53
8;61502;61500;21-345;269;187;185;159;26
9;61502;61500;21-345;218;165;162;137;25
10;61502;61500;21-345;360;251;250;216;34
11;61502;61500;21-345;254;152;152;109;43
1;61503;61500;21-306;1031;735;721;471;250
2;61503;61500;21-306;533;386;381;333;48
3;61503;61500;21-306;332;228;227;186;41
4;61503;61500;21-306;322;237;235;204;31
5;61503;61500;21-306;405;276;275;215;60
6;61503;61500;21-306;223;171;170;147;23
7;61503;61500;21-306;249;183;180;155;25
8;61503;61500;21-306;170;129;129;82;47
1;61504;61500;21-302;1095;754;746;655;91
2;61504;61500;21-302;893;628;622;539;83
3;61504;61500;21-302;1073;789;786;651;135
4;61504;61500;21-302;538;384;380;326;54
5;61504;61500;21-302;506;331;328;290;38
6;61504;61500;21-302;794;497;489;409;80
7;61504;61500;21-302;452;311;306;260;46
8;61504;61500;21-302;379;262;261;232;29
9;61504;61500;21-302;247;184;182;156;26
1;61505;61500;21-311;829;570;564;373;191
2;61505;61500;21-311;337;218;216;181;35
3;61505;61500;21-311;307;175;174;104;70
4;61505;61500;21-311;521;363;360;291;69
5;61505;61500;21-311;177;118;117;95;22
6;61505;61500;21-311;346;256;255;223;32
7;61505;61500;21-311;211;140;139;117;22
8;61505;61500;21-311;206;123;123;105;18
9;61505;61500;21-311;203;153;151;116;35
1;61506;61500;21-300;331;226;225;170;55
2;61506;61500;21-300;405;281;279;209;70
3;61506;61500;21-300;788;546;545;407;138
4;61506;61500;21-300;412;267;265;227;38
5;61506;61500;21-300;598;411;407;335;72
6;61506;61500;21-300;378;263;260;217;43
7;61506;61500;21-300;1028;701;700;541;159
8;61506;61500;21-300;433;309;306;232;74
9;61506;61500;21-300;465;316;313;276;37
10;61506;61500;21-300;219;157;155;132;23
11;61506;61500;21-300;318;216;215;183;32
12;61506;61500;21-300;176;111;109;79;30
13;61506;61500;21-300;196;126;126;98;28
14;61506;61500;21-300;393;288;287;222;65
1;61507;61500;21-307;738;499;498;446;52
2;61507;61500;21-307;479;308;301;249;52
3;61507;61500;21-307;1540;1155;1146;927;219
4;61507;61500;21-307;650;462;458;420;38
5;61507;61500;21-307;380;289;287;260;27
6;61507;61500;21-307;370;255;252;205;47
7;61507;61500;21-307;247;193;192;184;8
1;61508;61500;21-310;1647;1119;1112;793;319
2;61508;61500;21-310;726;444;439;321;118
3;61508;61500;21-310;988;575;574;439;135
4;61508;61500;21-310;427;257;256;204;52
5;61508;61500;21-310;266;184;183;152;31
6;61508;61500;21-310;329;212;210;153;57
7;61508;61500;21-310;260;177;176;139;37
8;61508;61500;21-310;183;126;125;93;32
9;61508;61500;21-310;125;55;55;41;14
1;61601;61600;08-530;608;431;427;280;147
2;61601;61600;08-530;814;562;560;326;234
3;61601;61600;08-530;657;517;515;328;187
4;61601;61600;08-530;276;206;206;115;91
5;61601;61600;08-530;754;529;521;309;212
6;61601;61600;08-530;730;565;560;327;233
7;61601;61600;08-530;971;703;699;449;250
8;61601;61600;08-530;985;742;738;478;260
9;61601;61600;08-530;715;505;502;325;177
10;61601;61600;08-530;650;461;455;273;182
11;61601;61600;08-530;728;549;547;227;320
12;61601;61600;08-530;711;503;499;259;240
13;61601;61600;08-530;382;267;266;173;93
14;61601;61600;08-530;213;120;119;69;50
15;61601;61600;08-530;848;631;626;328;298
16;61601;61600;08-530;727;555;552;247;305
17;61601;61600;08-530;426;343;342;171;171
18;61601;61600;08-530;16;9;9;7;2
1;61602;61600;08-550;1047;824;815;674;141
2;61602;61600;08-550;490;353;347;290;57
3;61602;61600;08-550;304;221;218;186;32
4;61602;61600;08-550;484;347;345;308;37
5;61602;61600;08-550;281;193;192;180;12
6;61602;61600;08-550;791;566;563;505;58
7;61602;61600;08-550;222;147;145;126;19
8;61602;61600;08-550;433;312;310;284;26
9;61602;61600;08-550;248;195;194;169;25
10;61602;61600;08-550;151;111;111;93;18
11;61602;61600;08-550;346;284;283;252;31
12;61602;61600;08-550;165;126;124;99;25
13;61602;61600;08-550;271;214;213;182;31
1;61603;61600;08-503;826;587;578;459;119
2;61603;61600;08-503;295;216;216;172;44
3;61603;61600;08-503;240;185;184;154;30
4;61603;61600;08-503;772;567;564;517;47
5;61603;61600;08-503;196;137;135;104;31
6;61603;61600;08-503;231;176;176;148;28
7;61603;61600;08-503;367;273;271;246;25
8;61603;61600;08-503;133;94;94;84;10
1;61604;61600;08-500;902;641;637;394;243
2;61604;61600;08-500;1027;734;727;424;303
3;61604;61600;08-500;1046;696;685;349;336
4;61604;61600;08-500;1142;854;852;460;392
5;61604;61600;08-500;1112;836;835;554;281
6;61604;61600;08-500;1012;780;774;423;351
7;61604;61600;08-500;568;436;433;235;198
8;61604;61600;08-500;287;216;215;105;110
9;61604;61600;08-500;612;443;439;312;127
10;61604;61600;08-500;305;221;221;187;34
11;61604;61600;08-500;386;257;254;185;69
12;61604;61600;08-500;892;647;642;467;175
13;61604;61600;08-500;742;527;522;417;105
14;61604;61600;08-500;352;267;267;208;59
15;61604;61600;08-500;544;417;411;314;97
16;61604;61600;08-500;487;347;346;276;70
17;61604;61600;08-500;316;210;209;138;71
18;61604;61600;08-500;892;649;643;514;129
19;61604;61600;08-500;518;369;368;300;68
20;61604;61600;08-500;555;393;389;324;65
21;61604;61600;08-500;174;140;136;112;24
22;61604;61600;08-500;210;145;144;107;37
23;61604;61600;08-500;166;135;134;106;28
24;61604;61600;08-500;397;283;280;210;70
25;61604;61600;08-500;165;121;118;88;30
26;61604;61600;08-500;256;175;175;138;37
27;61604;61600;08-500;24;9;9;8;1
28;61604;61600;08-500;39;23;22;15;7
1;61605;61600;08-540;1555;1175;1161;769;392
2;61605;61600;08-540;344;239;239;194;45
3;61605;61600;08-540;501;368;364;243;121
4;61605;61600;08-540;300;221;219;196;23
5;61605;61600;08-540;446;328;326;271;55
6;61605;61600;08-540;397;318;318;263;55
7;61605;61600;08-540;320;227;220;186;34
1;61606;61600;08-504;502;372;361;228;133
2;61606;61600;08-504;305;219;217;161;56
3;61606;61600;08-504;463;296;288;199;89
4;61606;61600;08-504;258;190;187;132;55
5;61606;61600;08-504;200;138;135;96;39
6;61606;61600;08-504;279;195;195;131;64
7;61606;61600;08-504;330;237;236;204;32
1;61701;61700;21-040;1419;1058;1042;590;452
2;61701;61700;21-040;1223;921;910;505;405
3;61701;61700;21-040;1322;1007;996;559;437
4;61701;61700;21-040;1614;1113;1103;591;512
5;61701;61700;21-040;1614;1149;1136;654;482
6;61701;61700;21-040;1262;863;859;488;371
7;61701;61700;21-040;1197;800;790;503;287
8;61701;61700;21-040;1115;765;762;416;346
9;61701;61700;21-040;1254;785;778;475;303
10;61701;61700;21-040;1337;892;888;541;347
11;61701;61700;21-040;1465;1039;1028;590;438
12;61701;61700;21-040;1334;951;941;580;361
13;61701;61700;21-040;1353;985;985;575;410
14;61701;61700;21-040;1344;960;949;547;402
15;61701;61700;21-040;1357;1096;1084;567;517
16;61701;61700;21-040;1419;1068;1061;634;427
17;61701;61700;21-040;1333;991;981;543;438
18;61701;61700;21-040;1342;970;957;561;396
19;61701;61700;21-040;1344;1012;994;476;518
20;61701;61700;21-040;1100;884;869;385;484
21;61701;61700;21-040;1407;1096;1090;560;530
22;61701;61700;21-040;101;40;38;26;12
23;61701;61700;21-040;139;47;46;30;16
1;61702;61700;21-007;527;353;350;291;59
2;61702;61700;21-007;680;449;440;345;95
3;61702;61700;21-007;819;649;642;344;298
4;61702;61700;21-007;595;374;371;280;91
5;61702;61700;21-007;1027;719;710;486;224
6;61702;61700;21-007;935;620;614;427;187
7;61702;61700;21-007;981;761;751;458;293
8;61702;61700;21-007;541;410;403;264;139
9;61702;61700;21-007;233;175;173;145;28
10;61702;61700;21-007;161;126;126;92;34
11;61702;61700;21-007;1477;1083;1072;643;429
1;61703;61700;21-050;244;146;145;108;37
2;61703;61700;21-050;404;299;297;194;103
3;61703;61700;21-050;523;350;347;243;104
4;61703;61700;21-050;703;509;506;378;128
5;61703;61700;21-050;289;182;181;151;30
6;61703;61700;21-050;528;387;383;273;110
7;61703;61700;21-050;472;322;317;225;92
8;61703;61700;21-050;624;435;431;313;118
9;61703;61700;21-050;494;333;332;260;72
10;61703;61700;21-050;868;591;583;383;200
11;61703;61700;21-050;1018;744;741;473;268
12;61703;61700;21-050;414;289;286;242;44
13;61703;61700;21-050;338;221;219;165;54
14;61703;61700;21-050;285;201;199;136;63
15;61703;61700;21-050;237;176;176;124;52
16;61703;61700;21-050;298;187;186;137;49
17;61703;61700;21-050;290;199;198;149;49
1;61704;61700;21-065;607;421;417;333;84
2;61704;61700;21-065;319;215;210;196;14
3;61704;61700;21-065;567;393;392;341;51
4;61704;61700;21-065;339;223;223;201;22
5;61704;61700;21-065;770;528;520;429;91
6;61704;61700;21-065;40;21;20;11;9
1;61705;61700;21-044;1271;812;804;608;196
2;61705;61700;21-044;588;333;331;246;85
3;61705;61700;21-044;860;571;569;495;74
4;61705;61700;21-044;1304;849;838;671;167
5;61705;61700;21-044;2005;1338;1331;935;396
6;61705;61700;21-044;640;399;394;251;143
1;61801;61800;22-600;1800;1221;1207;722;485
2;61801;61800;22-600;846;536;535;317;218
3;61801;61800;22-600;884;606;604;369;235
4;61801;61800;22-600;1787;1224;1215;759;456
5;61801;61800;22-600;929;658;655;357;298
6;61801;61800;22-600;936;648;641;348;293
7;61801;61800;22-600;905;643;639;335;304
8;61801;61800;22-600;1032;696;690;437;253
9;61801;61800;22-600;981;713;704;456;248
10;61801;61800;22-600;1726;1212;1206;740;466
11;61801;61800;22-600;1693;1214;1203;659;544
12;61801;61800;22-600;236;106;105;80;25
1;61802;61800;22-670;1228;797;790;538;252
2;61802;61800;22-670;684;418;413;285;128
3;61802;61800;22-670;267;176;175;152;23
4;61802;61800;22-670;203;132;131;107;24
1;61803;61800;22-664;624;392;391;291;100
2;61803;61800;22-664;803;521;519;452;67
3;61803;61800;22-664;442;278;275;228;47
4;61803;61800;22-664;508;281;275;226;49
5;61803;61800;22-664;170;109;106;85;21
1;61804;61800;22-610;534;372;368;256;112
2;61804;61800;22-610;440;265;263;216;47
3;61804;61800;22-610;178;117;117;91;26
4;61804;61800;22-610;286;170;170;139;31
5;61804;61800;22-610;318;217;217;191;26
6;61804;61800;22-610;160;104;103;89;14
7;61804;61800;22-610;158;116;115;83;32
8;61804;61800;22-610;149;103;101;83;18
9;61804;61800;22-610;225;157;156;121;35
1;61805;61800;22-680;366;199;199;165;34
2;61805;61800;22-680;1365;867;857;479;378
3;61805;61800;22-680;392;215;214;168;46
4;61805;61800;22-680;430;231;230;182;48
5;61805;61800;22-680;261;145;144;97;47
6;61805;61800;22-680;1095;554;553;420;133
7;61805;61800;22-680;184;139;137;108;29
8;61805;61800;22-680;342;204;202;150;52
9;61805;61800;22-680;222;97;97;56;41
1;61806;61800;22-650;818;526;519;374;145
2;61806;61800;22-650;916;619;614;384;230
3;61806;61800;22-650;227;145;144;128;16
4;61806;61800;22-650;337;224;224;170;54
5;61806;61800;22-650;313;204;202;149;53
6;61806;61800;22-650;391;234;232;184;48
7;61806;61800;22-650;333;213;213;190;23
8;61806;61800;22-650;352;200;199;167;32
9;61806;61800;22-650;208;134;133;115;18
10;61806;61800;22-650;266;165;164;129;35
11;61806;61800;22-650;176;115;115;86;29
1;61807;61800;22-640;602;422;420;352;68
2;61807;61800;22-640;206;139;139;124;15
3;61807;61800;22-640;315;196;194;173;21
4;61807;61800;22-640;215;127;124;91;33
5;61807;61800;22-640;777;453;451;359;92
6;61807;61800;22-640;187;118;118;98;20
7;61807;61800;22-640;635;367;366;283;83
8;61807;61800;22-640;287;189;185;160;25
9;61807;61800;22-640;239;155;154;126;28
10;61807;61800;22-640;283;207;203;150;53
1;61808;61800;22-672;563;362;361;310;51
2;61808;61800;22-672;693;475;472;397;75
3;61808;61800;22-672;928;599;592;418;174
4;61808;61800;22-672;998;609;608;493;115
5;61808;61800;22-672;492;305;304;221;83
6;61808;61800;22-672;1515;971;961;639;322
7;61808;61800;22-672;406;247;245;224;21
1;61809;61800;22-604;875;562;559;470;89
2;61809;61800;22-604;829;576;573;466;107
3;61809;61800;22-600;371;239;238;209;29
4;61809;61800;22-604;471;285;283;253;30
5;61809;61800;22-604;364;240;236;210;26
1;61810;61800;22-652;859;547;537;428;109
2;61810;61800;22-652;459;253;248;140;108
3;61810;61800;22-652;200;138;137;105;32
4;61810;61800;22-652;692;419;418;334;84
5;61810;61800;22-652;227;137;136;113;23
6;61810;61800;22-652;190;117;116;96;20
7;61810;61800;22-652;181;120;120;108;12
1;61811;61800;22-600;818;557;553;388;165
2;61811;61800;22-600;216;137;137;120;17
3;61811;61800;22-600;732;483;479;368;111
4;61811;61800;22-600;446;313;311;245;66
5;61811;61800;22-600;400;253;249;181;68
6;61811;61800;22-600;904;584;581;452;129
7;61811;61800;22-600;808;518;516;387;129
8;61811;61800;22-600;691;458;457;400;57
9;61811;61800;22-600;280;183;182;151;31
10;61811;61800;22-600;518;380;379;326;53
11;61811;61800;22-600;362;232;230;190;40
12;61811;61800;22-600;1513;1028;1023;718;305
13;61811;61800;22-600;326;220;220;167;53
14;61811;61800;22-600;182;121;120;98;22
15;61811;61800;22-600;268;193;190;169;21
1;61812;61800;22-630;652;409;405;258;147
2;61812;61800;22-630;820;516;515;386;129
3;61812;61800;22-630;855;540;536;444;92
4;61812;61800;22-630;455;312;310;252;58
5;61812;61800;22-630;268;183;183;157;26
6;61812;61800;22-630;499;260;257;207;50
7;61812;61800;22-630;225;142;141;117;24
8;61812;61800;22-630;278;186;185;175;10
9;61812;61800;22-630;110;82;80;67;13
1;61813;61800;22-678;368;215;213;179;34
2;61813;61800;22-678;475;313;311;228;83
3;61813;61800;22-678;631;328;327;269;58
4;61813;61800;22-678;271;141;141;118;23
5;61813;61800;22-678;165;83;81;66;15
6;61813;61800;22-678;433;266;264;224;40
7;61813;61800;22-678;232;140;140;118;22
8;61813;61800;22-678;204;121;121;109;12
9;61813;61800;22-678;290;163;163;130;33
10;61813;61800;22-678;204;115;114;94;20
1;61901;61900;22-200;1954;1334;1321;684;637
2;61901;61900;22-200;1597;1046;1038;525;513
3;61901;61900;22-200;1924;1295;1282;663;619
4;61901;61900;22-200;1531;987;982;525;457
5;61901;61900;22-200;1940;1284;1272;624;648
6;61901;61900;22-200;663;493;486;42;444
7;61901;61900;22-200;112;68;66;50;16
1;61902;61900;22-220;783;512;509;346;163
2;61902;61900;22-220;420;273;271;202;69
3;61902;61900;22-220;221;140;139;94;45
4;61902;61900;22-220;384;219;216;155;61
5;61902;61900;22-220;264;148;147;100;47
1;61903;61900;22-235;749;431;425;269;156
2;61903;61900;22-235;306;211;209;153;56
3;61903;61900;22-235;1309;820;809;569;240
4;61903;61900;22-235;351;205;203;139;64
1;61904;61900;22-244;737;504;500;362;138
2;61904;61900;22-244;354;255;250;191;59
3;61904;61900;22-244;150;98;98;65;33
4;61904;61900;22-244;279;172;170;143;27
1;61905;61900;22-234;465;312;310;221;89
2;61905;61900;22-234;876;699;695;457;238
3;61905;61900;22-234;356;219;214;175;39
4;61905;61900;22-234;439;308;306;259;47
5;61905;61900;22-234;1085;794;791;611;180
1;61906;61900;22-200;579;417;413;222;191
2;61906;61900;22-200;899;651;641;365;276
3;61906;61900;22-200;345;210;208;146;62
4;61906;61900;22-200;352;224;223;131;92
5;61906;61900;22-200;176;102;100;56;44
6;61906;61900;22-200;245;132;132;84;48
7;61906;61900;22-200;352;210;210;133;77
8;61906;61900;22-200;803;510;504;301;203
9;61906;61900;22-200;318;194;190;145;45
10;61906;61900;22-200;189;134;132;83;49
11;61906;61900;22-200;163;112;112;78;34
12;61906;61900;22-200;177;74;71;41;30
1;61907;61900;22-230;372;231;225;151;74
2;61907;61900;22-230;457;268;267;177;90
3;61907;61900;22-230;442;280;280;185;95
4;61907;61900;22-230;394;257;251;166;85
5;61907;61900;22-230;450;275;273;202;71
6;61907;61900;22-230;334;197;197;148;49
7;61907;61900;22-230;190;123;123;81;42
8;61907;61900;22-230;264;168;167;123;44
1;61908;61900;22-205;702;454;451;336;115
2;61908;61900;22-200;224;140;140;115;25
3;61908;61900;22-205;157;92;91;63;28
4;61908;61900;22-205;263;150;148;91;57
5;61908;61900;22-205;276;166;164;107;57
6;61908;61900;22-205;216;111;111;82;29
7;61908;61900;22-200;46;15;15;10;5
1;62001;62000;22-442;1032;653;648;537;111
2;62001;62000;22-442;428;284;280;226;54
3;62001;62000;22-442;435;291;288;217;71
4;62001;62000;22-442;555;360;356;267;89
5;62001;62000;22-442;729;495;490;414;76
6;62001;62000;22-442;174;130;130;107;23
7;62001;62000;22-442;257;167;166;134;32
1;62002;62000;22-425;926;612;610;490;120
2;62002;62000;22-425;433;254;253;188;65
3;62002;62000;22-425;411;264;258;219;39
4;62002;62000;22-425;616;375;374;330;44
5;62002;62000;22-425;223;137;137;125;12
6;62002;62000;22-425;333;216;214;147;67
1;62003;62000;22-435;203;138;138;114;24
2;62003;62000;22-435;428;306;305;233;72
3;62003;62000;22-435;601;421;414;289;125
4;62003;62000;22-435;745;518;515;351;164
5;62003;62000;22-435;436;302;300;219;81
6;62003;62000;22-435;292;200;198;143;55
7;62003;62000;22-435;395;246;246;208;38
8;62003;62000;22-435;195;144;144;111;33
9;62003;62000;22-435;165;121;120;102;18
10;62003;62000;22-435;220;153;152;134;18
11;62003;62000;22-435;14;9;9;5;4
1;62004;62000;22-440;1590;1144;1141;887;254
2;62004;62000;22-440;362;277;274;194;80
3;62004;62000;22-440;749;562;558;457;101
4;62004;62000;22-440;207;166;165;160;5
5;62004;62000;22-440;258;170;169;154;15
6;62004;62000;22-440;429;275;274;199;75
7;62004;62000;22-440;438;266;263;218;45
8;62004;62000;22-440;302;229;227;207;20
9;62004;62000;22-440;302;213;211;188;23
10;62004;62000;22-440;553;388;387;372;15
11;62004;62000;22-440;165;116;116;98;18
12;62004;62000;22-440;85;46;43;31;12
13;62004;62000;22-440;41;37;34;30;4
1;62005;62000;22-437;315;224;220;195;25
2;62005;62000;22-437;1208;880;870;712;158
3;62005;62000;22-437;1320;939;930;738;192
4;62005;62000;22-437;640;461;461;370;91
5;62005;62000;22-437;482;305;302;249;53
6;62005;62000;22-437;197;140;140;126;14
7;62005;62000;22-437;281;192;192;159;33
8;62005;62000;22-437;233;153;153;125;28
1;62006;62000;22-455;326;177;175;146;29
2;62006;62000;22-455;1051;649;646;478;168
3;62006;62000;22-455;457;297;297;240;57
4;62006;62000;22-455;483;271;269;230;39
5;62006;62000;22-455;550;340;338;280;58
6;62006;62000;22-455;345;229;226;191;35
7;62006;62000;22-455;377;214;213;137;76
8;62006;62000;22-455;293;161;160;135;25
9;62006;62000;22-455;208;133;132;122;10
1;62007;62000;22-413;952;619;611;454;157
2;62007;62000;22-413;485;306;302;232;70
3;62007;62000;22-413;902;501;500;403;97
4;62007;62000;22-413;964;636;630;511;119
5;62007;62000;22-413;333;179;177;150;27
6;62007;62000;22-413;328;201;199;163;36
7;62007;62000;22-413;241;139;137;121;16
1;62008;62000;22-463;463;316;314;272;42
2;62008;62000;22-463;333;236;234;191;43
3;62008;62000;22-463;520;334;333;243;90
4;62008;62000;22-463;402;257;257;218;39
5;62008;62000;22-463;485;328;327;278;49
6;62008;62000;22-463;602;402;402;367;35
7;62008;62000;22-463;350;229;227;200;27
8;62008;62000;22-463;287;189;188;143;45
9;62008;62000;22-463;211;156;155;129;26
10;62008;62000;22-463;347;240;240;194;46
11;62008;62000;22-463;204;88;88;54;34
1;62009;62000;22-424;479;316;314;231;83
2;62009;62000;22-424;305;178;178;155;23
3;62009;62000;22-424;427;272;270;212;58
4;62009;62000;22-424;766;541;539;476;63
5;62009;62000;22-424;1204;828;818;607;211
6;62009;62000;22-424;554;362;359;295;64
7;62009;62000;22-424;308;236;233;214;19
8;62009;62000;22-424;505;345;344;304;40
9;62009;62000;22-424;299;192;190;160;30
10;62009;62000;22-424;188;128;127;104;23
1;62010;62000;22-420;1857;1234;1232;984;248
2;62010;62000;22-420;283;191;191;171;20
3;62010;62000;22-420;272;165;164;144;20
4;62010;62000;22-420;504;337;334;289;45
5;62010;62000;22-420;661;391;389;325;64
6;62010;62000;22-420;247;128;128;115;13
1;62011;62000;22-417;403;278;277;234;43
2;62011;62000;22-417;988;697;692;549;143
3;62011;62000;22-417;913;580;576;431;145
4;62011;62000;22-417;373;264;260;205;55
5;62011;62000;22-417;323;213;211;141;70
6;62011;62000;22-417;456;310;308;241;67
7;62011;62000;22-417;284;185;185;137;48
8;62011;62000;22-417;178;128;128;112;16
1;62012;62000;22-448;485;317;314;257;57
2;62012;62000;22-448;701;465;459;378;81
3;62012;62000;22-448;457;296;295;241;54
4;62012;62000;22-448;581;367;361;300;61
5;62012;62000;22-448;575;337;335;257;78
6;62012;62000;22-448;274;178;177;158;19
7;62012;62000;22-448;234;166;166;131;35
1;62013;62000;22-460;1061;681;677;407;270
2;62013;62000;22-460;871;496;493;342;151
3;62013;62000;22-460;605;357;352;257;95
4;62013;62000;22-460;795;473;471;361;110
5;62013;62000;22-460;670;443;434;357;77
6;62013;62000;22-460;1438;890;883;720;163
7;62013;62000;22-460;415;256;252;170;82
8;62013;62000;22-460;413;256;251;188;63
9;62013;62000;22-460;749;479;475;402;73
10;62013;62000;22-460;599;404;404;310;94
11;62013;62000;22-460;364;253;252;219;33
12;62013;62000;22-460;212;122;120;96;24
13;62013;62000;22-460;20;12;12;7;5
1;62014;62000;22-400;723;513;507;302;205
2;62014;62000;22-400;627;427;422;256;166
3;62014;62000;22-400;1797;1215;1206;773;433
4;62014;62000;22-470;563;395;391;319;72
5;62014;62000;22-400;557;376;370;315;55
6;62014;62000;22-400;636;423;421;301;120
7;62014;62000;22-400;1593;1165;1151;693;458
8;62014;62000;22-400;371;242;241;176;65
9;62014;62000;22-400;548;377;370;245;125
10;62014;62000;22-400;871;602;600;415;185
11;62014;62000;22-400;1600;1094;1082;670;412
12;62014;62000;22-400;1422;959;954;706;248
13;62014;62000;22-400;784;579;572;371;201
14;62014;62000;22-400;458;295;293;228;65
15;62014;62000;22-400;507;366;366;288;78
16;62014;62000;22-400;762;534;531;404;127
17;62014;62000;22-400;426;296;295;228;67
18;62014;62000;22-400;323;202;201;155;46
19;62014;62000;22-400;803;597;586;339;247
20;62014;62000;22-400;538;367;364;276;88
21;62014;62000;22-400;628;486;482;342;140
22;62014;62000;22-400;532;327;323;225;98
23;62014;62000;22-400;400;264;262;198;64
24;62014;62000;22-400;202;143;143;113;30
25;62014;62000;22-400;263;172;170;125;45
26;62014;62000;22-400;44;15;14;6;8
1;62015;62000;22-470;431;304;296;168;128
2;62015;62000;22-470;688;441;439;224;215
3;62015;62000;22-470;563;331;329;235;94
4;62015;62000;22-470;447;301;300;214;86
5;62015;62000;22-470;568;340;338;254;84
6;62015;62000;22-470;291;172;169;119;50
7;62015;62000;22-470;251;177;175;146;29
8;62015;62000;22-470;199;125;125;76;49
9;62015;62000;22-470;279;176;176;141;35
10;62015;62000;22-470;663;464;459;234;225
11;62015;62000;22-470;612;405;402;194;208
1;66101;66100;21-500;1250;829;824;463;361
2;66101;66100;21-500;1196;799;793;454;339
3;66101;66100;21-500;1159;739;734;425;309
4;66101;66100;21-500;1066;753;745;427;318
5;66101;66100;21-500;1315;941;930;526;404
6;66101;66100;21-500;1407;1032;1024;575;449
7;66101;66100;21-500;1252;890;883;498;385
8;66101;66100;21-500;771;518;511;310;201
9;66101;66100;21-500;954;659;656;457;199
10;66101;66100;21-500;869;586;578;306;272
11;66101;66100;21-500;660;436;431;263;168
12;66101;66100;21-500;2482;1768;1756;1067;689
13;66101;66100;21-500;2414;1750;1740;948;792
14;66101;66100;21-500;1503;1097;1084;724;360
15;66101;66100;21-500;1359;1005;981;661;320
16;66101;66100;21-500;2297;1656;1644;1037;607
17;66101;66100;21-500;1713;1282;1272;858;414
18;66101;66100;21-500;1583;1138;1128;588;540
19;66101;66100;21-500;1545;1129;1122;608;514
20;66101;66100;21-500;1906;1480;1464;789;675
21;66101;66100;21-500;1781;1324;1318;740;578
22;66101;66100;21-500;1705;1205;1197;677;520
23;66101;66100;21-500;1646;1215;1207;667;540
24;66101;66100;21-500;2323;1713;1701;928;773
25;66101;66100;21-500;2052;1475;1457;830;627
26;66101;66100;21-500;550;406;403;260;143
27;66101;66100;21-500;1515;989;980;682;298
28;66101;66100;21-500;254;173;172;116;56
29;66101;66100;21-500;189;130;129;47;82
1;66201;66200;22-100;1248;922;915;529;386
2;66201;66200;22-100;1711;1220;1207;676;531
3;66201;66200;22-100;1604;1105;1098;641;457
4;66201;66200;22-100;1270;835;825;469;356
5;66201;66200;22-100;1710;1153;1142;638;504
6;66201;66200;22-100;608;449;448;243;205
7;66201;66200;22-100;1171;777;772;440;332
8;66201;66200;22-100;1663;1062;1054;590;464
9;66201;66200;22-100;1054;691;687;385;302
10;66201;66200;22-100;1237;816;804;442;362
11;66201;66200;22-100;1596;1002;1000;584;416
12;66201;66200;22-100;1149;760;754;384;370
13;66201;66200;22-100;1230;711;709;383;326
14;66201;66200;22-100;1110;702;698;333;365
15;66201;66200;22-100;1394;910;901;456;445
16;66201;66200;22-100;1255;761;756;414;342
17;66201;66200;22-100;717;415;412;248;164
18;66201;66200;22-100;819;487;484;260;224
19;66201;66200;22-100;1755;1115;1101;609;492
20;66201;66200;22-100;431;293;292;149;143
21;66201;66200;22-100;1587;1138;1132;656;476
22;66201;66200;22-100;791;532;527;319;208
23;66201;66200;22-100;1556;1125;1117;633;484
24;66201;66200;22-100;979;653;649;324;325
25;66201;66200;22-100;1375;941;935;469;466
26;66201;66200;22-100;1590;1130;1125;559;566
27;66201;66200;22-100;1338;891;886;460;426
28;66201;66200;22-100;1859;1338;1327;675;652
29;66201;66200;22-100;1247;835;830;445;385
30;66201;66200;22-100;1257;827;822;443;379
31;66201;66200;22-100;1386;929;923;483;440
32;66201;66200;22-100;1166;780;775;393;382
33;66201;66200;22-100;1426;1028;1019;510;509
34;66201;66200;22-100;669;340;337;213;124
35;66201;66200;22-100;592;359;353;58;295
36;66201;66200;22-100;451;155;153;97;56
1;66301;66300;20-808;1491;1151;1138;549;589
2;66301;66300;20-803;1954;1563;1554;764;790
3;66301;66300;20-802;1946;1595;1582;666;916
4;66301;66300;20-055;1049;740;739;393;346
5;66301;66300;20-054;1427;1093;1078;485;593
6;66301;66300;20-047;1713;1289;1269;568;701
7;66301;66300;20-052;1807;1349;1332;584;748
8;66301;66300;20-032;1498;1123;1115;429;686
9;66301;66300;20-043;726;567;561;240;321
10;66301;66300;20-045;753;623;619;236;383
11;66301;66300;20-038;500;408;407;142;265
12;66301;66300;20-089;1538;1174;1165;516;649
13;66301;66300;20-124;1249;769;764;404;360
14;66301;66300;20-089;1146;795;789;384;405
15;66301;66300;20-124;564;312;312;178;134
16;66301;66300;20-071;610;448;444;183;261
17;66301;66300;20-075;864;648;644;272;372
18;66301;66300;20-080;929;620;612;294;318
19;66301;66300;20-033;602;483;477;217;260
20;66301;66300;20-020;529;359;357;148;209
21;66301;66300;20-007;1190;886;878;391;487
22;66301;66300;20-109;609;423;419;211;208
23;66301;66300;20-020;1067;770;763;334;429
24;66301;66300;20-005;655;406;400;208;192
25;66301;66300;20-005;551;353;350;221;129
26;66301;66300;20-016;761;570;564;247;317
27;66301;66300;20-620;536;382;381;150;231
28;66301;66300;20-620;873;648;640;265;375
29;66301;66300;20-116;658;320;318;164;154
30;66301;66300;20-112;490;321;321;179;142
31;66301;66300;20-117;395;284;283;156;127
32;66301;66300;20-301;1767;1134;1122;631;491
33;66301;66300;20-322;1263;914;900;488;412
34;66301;66300;20-322;1200;867;865;505;360
35;66301;66300;20-320;1560;1052;1040;557;483
36;66301;66300;20-337;1524;1114;1106;573;533
37;66301;66300;20-337;1597;1059;1052;556;496
38;66301;66300;20-337;1064;707;701;360;341
39;66301;66300;20-336;1097;897;883;445;438
40;66301;66300;20-718;782;685;665;247;418
41;66301;66300;20-716;740;614;608;265;343
42;66301;66300;20-716;1222;903;890;455;435
43;66301;66300;20-828;1487;1251;1237;522;715
44;66301;66300;20-828;1492;1258;1239;495;744
45;66301;66300;20-704;1275;1061;1052;451;601
46;66301;66300;20-704;1461;1165;1145;549;596
47;66301;66300;20-709;1725;1322;1312;604;708
48;66301;66300;20-718;1796;1377;1359;697;662
49;66301;66300;20-601;1454;1064;1054;509;545
50;66301;66300;20-601;816;614;611;278;333
51;66301;66300;20-604;818;653;649;262;387
52;66301;66300;20-604;832;651;645;296;349
53;66301;66300;20-604;1036;792;782;322;460
54;66301;66300;20-605;749;616;610;251;359
55;66301;66300;20-610;961;732;729;345;384
56;66301;66300;20-611;1361;1027;1018;407;611
57;66301;66300;20-620;1263;928;922;448;474
58;66301;66300;20-617;1248;888;884;418;466
59;66301;66300;20-625;770;583;580;272;308
60;66301;66300;20-627;941;731;726;294;432
61;66301;66300;20-627;988;749;739;345;394
62;66301;66300;20-627;1807;1387;1376;605;771
63;66301;66300;20-632;1600;1244;1233;594;639
64;66301;66300;20-637;1536;1167;1154;562;592
65;66301;66300;20-637;1461;1117;1102;457;645
66;66301;66300;20-618;1772;1284;1271;550;721
67;66301;66300;20-401;571;377;372;235;137
68;66301;66300;20-401;486;245;243;168;75
69;66301;66300;20-407;532;348;344;164;180
70;66301;66300;20-407;625;343;340;211;129
71;66301;66300;20-582;1473;1253;1233;522;711
72;66301;66300;20-582;1745;1413;1385;605;780
73;66301;66300;20-719;1395;1159;1146;506;640
74;66301;66300;20-722;845;706;698;321;377
75;66301;66300;20-722;1647;1371;1361;595;766
76;66301;66300;20-554;1593;1233;1225;593;632
77;66301;66300;20-553;1758;1363;1350;628;722
78;66301;66300;20-552;1459;1129;1123;513;610
79;66301;66300;20-539;1960;1564;1544;722;822
80;66301;66300;20-543;760;618;609;241;368
81;66301;66300;20-543;1370;1041;1031;527;504
82;66301;66300;20-542;1516;1133;1132;592;540
83;66301;66300;20-538;1673;1280;1261;612;649
84;66301;66300;20-538;1099;884;877;413;464
85;66301;66300;20-530;1414;1116;1098;525;573
86;66301;66300;20-530;1573;1213;1205;612;593
87;66301;66300;20-530;1747;1299;1295;636;659
88;66301;66300;20-534;1504;1147;1135;537;598
89;66301;66300;20-576;1533;1271;1258;511;747
90;66301;66300;20-576;972;751;743;346;397
91;66301;66300;20-574;1503;1224;1202;508;694
92;66301;66300;20-576;894;711;702;288;414
93;66301;66300;20-570;1597;1250;1242;605;637
94;66301;66300;20-576;932;766;758;330;428
95;66301;66300;20-576;1343;1100;1088;452;636
96;66301;66300;20-560;1685;1311;1302;657;645
97;66301;66300;20-560;1170;914;908;455;453
98;66301;66300;20-562;1116;916;904;395;509
99;66301;66300;20-824;2218;1689;1674;828;846
100;66301;66300;20-827;1666;1351;1337;611;726
101;66301;66300;20-810;1571;1288;1274;521;753
102;66301;66300;20-819;2032;1683;1663;685;978
103;66301;66300;20-810;2252;1758;1733;826;907
104;66301;66300;20-853;1399;1044;1034;509;525
105;66301;66300;20-868;1691;1387;1379;532;847
106;66301;66300;20-858;1354;1067;1060;485;575
107;66301;66300;20-860;1324;966;957;489;468
108;66301;66300;20-861;1227;940;929;460;469
109;66301;66300;20-861;1218;932;924;442;482
110;66301;66300;20-853;1574;1187;1175;549;626
111;66301;66300;20-853;1528;1187;1177;590;587
112;66301;66300;20-815;1760;1307;1295;618;677
113;66301;66300;20-844;1743;1352;1341;675;666
114;66301;66300;20-844;1527;1138;1125;599;526
115;66301;66300;20-864;1348;1049;1045;536;509
116;66301;66300;20-863;1894;1504;1498;668;830
117;66301;66300;20-838;1236;901;894;447;447
118;66301;66300;20-836;1229;929;919;500;419
119;66301;66300;20-850;1365;998;993;453;540
120;66301;66300;20-850;1346;1016;1006;487;519
121;66301;66300;20-850;1383;1042;1038;526;512
122;66301;66300;20-848;1295;1037;1027;434;593
123;66301;66300;20-880;1358;1093;1082;443;639
124;66301;66300;20-223;1998;1640;1623;720;903
125;66301;66300;20-232;500;355;349;238;111
126;66301;66300;20-147;1507;1215;1204;472;732
127;66301;66300;20-138;1332;995;992;502;490
128;66301;66300;20-143;1158;893;878;499;379
129;66301;66300;20-143;1719;1345;1336;664;672
130;66301;66300;20-140;1702;1343;1329;658;671
131;66301;66300;20-137;922;646;640;309;331
132;66301;66300;20-247;1163;869;864;463;401
133;66301;66300;20-246;1222;890;879;439;440
134;66301;66300;20-247;1083;790;782;408;374
135;66301;66300;20-137;1869;1375;1365;730;635
136;66301;66300;20-250;1513;1165;1157;661;496
137;66301;66300;20-128;1552;1092;1076;551;525
138;66301;66300;20-138;1243;894;884;467;417
139;66301;66300;20-243;1402;1022;1017;535;482
140;66301;66300;20-126;1265;878;867;470;397
141;66301;66300;20-128;1145;810;803;393;410
142;66301;66300;20-241;931;702;697;345;352
143;66301;66300;20-201;757;578;571;300;271
144;66301;66300;20-215;960;587;586;376;210
145;66301;66300;20-314;826;580;575;324;251
146;66301;66300;20-314;842;584;577;315;262
147;66301;66300;20-215;1016;625;620;342;278
148;66301;66300;20-213;869;560;555;298;257
149;66301;66300;20-213;737;466;463;286;177
150;66301;66300;20-218;946;554;547;291;256
151;66301;66300;20-218;786;497;493;271;222
152;66301;66300;20-218;707;418;415;249;166
153;66301;66300;20-209;451;288;284;148;136
154;66301;66300;20-232;1567;900;888;601;287
155;66301;66300;20-283;355;242;239;144;95
156;66301;66300;20-281;1675;1246;1228;652;576
157;66301;66300;20-281;838;625;621;354;267
158;66301;66300;20-283;1793;1226;1212;692;520
159;66301;66300;20-509;840;620;615;321;294
160;66301;66300;20-518;1732;1247;1235;709;526
161;66301;66300;20-470;2103;1538;1530;908;622
162;66301;66300;20-470;1580;1105;1100;685;415
163;66301;66300;20-485;1750;1289;1284;718;566
164;66301;66300;20-470;1578;1105;1096;634;462
165;66301;66300;20-485;1271;895;888;506;382
166;66301;66300;20-470;2413;1877;1863;941;922
167;66301;66300;20-492;2114;1737;1713;702;1011
168;66301;66300;20-418;1541;1164;1153;614;539
169;66301;66300;20-417;1779;1144;1135;674;461
170;66301;66300;20-425;1039;744;736;434;302
171;66301;66300;20-436;1898;1391;1376;751;625
172;66301;66300;20-466;1058;788;782;394;388
173;66301;66300;20-468;1420;993;985;515;470
174;66301;66300;20-468;1161;810;804;407;397
175;66301;66300;20-433;1322;990;977;505;472
176;66301;66300;20-466;936;669;665;375;290
177;66301;66300;20-442;1811;1259;1247;697;550
178;66301;66300;20-445;448;325;322;156;166
179;66301;66300;20-442;1256;998;985;519;466
180;66301;66300;20-346;1384;968;959;496;463
181;66301;66300;20-349;1417;861;851;498;353
182;66301;66300;20-349;1294;942;939;473;466
183;66301;66300;20-349;1240;880;877;474;403
184;66301;66300;20-362;1494;1124;1111;616;495
185;66301;66300;20-360;1483;1000;997;553;444
186;66301;66300;20-433;1052;807;796;481;315
187;66301;66300;20-391;1233;927;922;545;377
188;66301;66300;20-383;1664;1284;1273;712;561
189;66301;66300;20-582;1625;1347;1342;603;739
190;66301;66300;20-582;1938;1584;1563;591;972
191;66301;66300;20-827;1440;1198;1190;472;718
192;66301;66300;20-853;1854;1581;1566;586;980
193;66301;66300;20-145;978;802;797;308;489
194;66301;66300;20-281;1280;984;972;518;454
195;66301;66300;20-466;1166;896;883;433;450
196;66301;66300;20-281;931;743;738;414;324
197;66301;66300;20-081;250;121;121;72;49
198;66301;66300;20-439;79;45;45;31;14
199;66301;66300;20-079;34;3;3;2;1
200;66301;66300;20-089;100;34;34;15;19
201;66301;66300;20-286;171;98;98;58;40
202;66301;66300;20-123;20;18;18;12;6
203;66301;66300;20-090;390;157;155;92;63
204;66301;66300;20-954;401;210;203;119;84
205;66301;66300;20-090;469;212;209;130;79
206;66301;66300;20-090;103;67;67;48;19
207;66301;66300;20-049;275;103;103;70;33
208;66301;66300;20-550;474;246;242;126;116
209;66301;66300;20-331;164;60;59;38;21
210;66301;66300;20-442;734;220;216;149;67
211;66301;66300;20-577;55;32;32;19;13
212;66301;66300;20-358;89;63;61;41;20
213;66301;66300;20-201;152;64;61;46;15
214;66301;66300;20-718;129;81;75;45;30
215;66301;66300;20-113;38;30;26;15;11
216;66301;66300;20-060;104;57;56;41;15
217;66301;66300;20-482;740;587;569;131;438
1;66401;66400;22-400;1386;825;818;465;353
2;66401;66400;22-400;1546;1071;1058;658;400
3;66401;66400;22-400;1837;1295;1284;721;563
4;66401;66400;22-400;1501;1065;1059;570;489
5;66401;66400;22-400;1179;796;791;429;362
6;66401;66400;22-400;1439;993;985;518;467
7;66401;66400;22-400;1640;1073;1064;615;449
8;66401;66400;22-400;1342;959;954;541;413
9;66401;66400;22-400;1640;1020;1017;606;411
10;66401;66400;22-400;1181;848;844;493;351
11;66401;66400;22-400;1770;1275;1259;764;495
12;66401;66400;22-400;1726;1219;1210;765;445
13;66401;66400;22-400;1871;1239;1230;594;636
14;66401;66400;22-400;1417;986;978;512;466
15;66401;66400;22-400;1193;728;726;446;280
16;66401;66400;22-400;748;470;466;262;204
17;66401;66400;22-400;1785;1231;1222;729;493
18;66401;66400;22-400;1707;1233;1224;674;550
19;66401;66400;22-400;1662;1209;1201;651;550
20;66401;66400;22-400;1216;828;825;498;327
21;66401;66400;22-400;780;531;528;287;241
22;66401;66400;22-400;1510;1006;996;593;403
23;66401;66400;22-400;1053;711;709;386;323
24;66401;66400;22-400;1770;1161;1155;696;459
25;66401;66400;22-400;1443;937;935;561;374
26;66401;66400;22-400;1769;1155;1149;648;501
27;66401;66400;22-400;1726;1273;1270;671;599
28;66401;66400;22-400;1860;1290;1278;739;539
29;66401;66400;22-400;1298;904;896;556;340
30;66401;66400;22-400;704;517;513;280;233
31;66401;66400;22-400;216;172;169;45;124
32;66401;66400;22-400;271;207;205;58;147
33;66401;66400;22-400;179;55;55;42;13
34;66401;66400;22-400;325;183;183;129;54
35;66401;66400;22-400;15;10;10;5;5
1;80101;80100;66-470;909;667;662;238;424
2;80101;80100;66-470;732;489;486;182;304
3;80101;80100;66-470;974;628;622;218;404
4;80101;80100;66-470;938;640;636;188;448
5;80101;80100;66-470;801;581;580;190;390
6;80101;80100;66-470;759;526;519;167;352
7;80101;80100;66-470;817;500;496;205;291
8;80101;80100;66-470;710;428;423;131;292
9;80101;80100;66-470;893;581;579;209;370
10;80101;80100;66-470;789;554;547;200;347
11;80101;80100;66-470;728;501;500;161;339
12;80101;80100;66-470;726;508;505;201;304
13;80101;80100;66-470;810;545;538;164;374
14;80101;80100;66-470;740;505;503;184;319
15;80101;80100;66-470;1179;867;856;292;564
16;80101;80100;66-470;84;33;33;13;20
17;80101;80100;66-470;49;25;25;13;12
1;80102;80100;66-450;1873;1362;1350;621;729
2;80102;80100;66-450;751;440;433;259;174
3;80102;80100;66-450;591;375;373;199;174
4;80102;80100;66-450;1477;1090;1081;492;589
5;80102;80100;66-450;377;246;241;111;130
6;80102;80100;66-432;276;184;183;88;95
1;80103;80100;66-446;1057;760;756;323;433
2;80103;80100;66-446;644;448;443;238;205
3;80103;80100;66-446;991;680;678;286;392
4;80103;80100;66-446;1159;727;718;437;281
5;80103;80100;66-446;828;562;561;321;240
6;80103;80100;66-446;1444;1066;1060;396;664
7;80103;80100;66-446;1299;947;931;398;533
8;80103;80100;66-446;734;535;530;201;329
1;80104;80100;66-415;1475;1122;1105;399;706
2;80104;80100;66-415;1181;869;857;340;517
3;80104;80100;66-415;1011;825;815;236;579
4;80104;80100;66-415;707;441;434;184;250
5;80104;80100;66-415;369;240;239;100;139
6;80104;80100;66-415;698;532;530;203;327
7;80104;80100;66-415;922;726;716;234;482
8;80104;80100;66-415;276;212;210;119;91
9;80104;80100;66-415;176;110;109;34;75
1;80105;80100;66-433;569;339;338;196;142
2;80105;80100;66-433;779;452;447;278;169
3;80105;80100;66-433;855;535;528;239;289
4;80105;80100;66-433;440;277;277;147;130
5;80105;80100;66-450;541;325;323;151;172
6;80105;80100;66-432;1253;919;908;354;554
7;80105;80100;66-433;486;295;290;166;124
8;80105;80100;66-432;409;257;257;127;130
1;80106;80100;66-431;434;346;341;146;195
2;80106;80100;66-400;1527;1108;1100;380;720
3;80106;80100;66-431;1614;1168;1155;426;729
4;80106;80100;66-431;772;499;489;249;240
5;80106;80100;66-431;716;461;457;212;245
6;80106;80100;66-431;505;331;324;176;148
7;80106;80100;66-431;274;149;148;72;76
8;80106;80100;66-431;1213;699;698;327;371
1;80107;80100;66-460;1112;691;684;330;354
2;80107;80100;66-460;1750;1043;1032;545;487
3;80107;80100;66-460;1840;1135;1130;514;616
4;80107;80100;66-460;213;152;148;84;64
5;80107;80100;66-460;545;326;326;187;139
6;80107;80100;66-460;418;250;246;141;105
7;80107;80100;66-460;458;274;268;167;101
8;80107;80100;66-460;576;375;372;190;182
9;80107;80100;66-460;904;578;574;227;347
10;80107;80100;66-460;471;299;298;142;156
11;80107;80100;66-460;209;143;142;79;63
12;80107;80100;66-460;291;179;178;119;59
13;80107;80100;66-460;304;196;196;110;86
14;80107;80100;66-460;35;16;16;5;11
1;80201;80200;66-620;1661;1042;1033;319;714
2;80201;80200;66-620;1783;1171;1161;383;778
3;80201;80200;66-620;825;541;537;173;364
4;80201;80200;66-620;1146;686;677;244;433
5;80201;80200;66-620;2106;1348;1339;462;877
6;80201;80200;66-620;1396;867;857;274;583
7;80201;80200;66-620;830;500;499;158;341
8;80201;80200;66-620;930;591;582;211;371
9;80201;80200;66-620;940;626;613;177;436
10;80201;80200;66-620;64;27;27;13;14
1;80202;80200;66-627;924;581;577;279;298
2;80202;80200;66-627;683;443;438;218;220
3;80202;80200;66-627;359;220;219;125;94
4;80202;80200;66-627;277;193;191;91;100
5;80202;80200;66-627;170;91;91;43;48
1;80203;80200;66-630;1153;679;676;334;342
2;80203;80200;66-630;427;232;232;128;104
3;80203;80200;66-630;224;133;133;67;66
1;80204;80200;66-600;540;341;341;137;204
2;80204;80200;66-615;397;276;276;118;158
3;80204;80200;66-615;336;172;171;117;54
4;80204;80200;66-615;554;357;355;190;165
5;80204;80200;66-627;466;286;286;153;133
6;80204;80200;66-615;377;241;239;125;114
7;80204;80200;66-615;62;33;33;20;13
8;80204;80200;66-615;477;294;293;154;139
9;80204;80200;66-615;303;185;184;87;97
10;80204;80200;66-600;211;125;120;67;53
1;80205;80200;66-620;509;339;336;140;196
2;80205;80200;66-620;332;204;203;69;134
3;80205;80200;66-620;365;214;210;112;98
4;80205;80200;66-620;376;218;218;95;123
5;80205;80200;66-620;950;485;483;224;259
6;80205;80200;66-620;717;396;388;193;195
7;80205;80200;66-620;350;201;199;128;71
8;80205;80200;66-620;389;233;232;111;121
9;80205;80200;66-620;449;269;269;127;142
10;80205;80200;66-620;369;223;222;88;134
11;80205;80200;66-620;346;219;219;101;118
12;80205;80200;66-620;358;214;212;90;122
1;80206;80200;66-600;841;500;493;226;267
2;80206;80200;66-600;772;492;485;171;314
3;80206;80200;66-600;1439;1077;1070;348;722
4;80206;80200;66-600;1350;921;912;290;622
5;80206;80200;66-600;677;449;449;150;299
6;80206;80200;66-600;857;545;541;224;317
7;80206;80200;66-600;901;688;680;249;431
8;80206;80200;66-600;882;590;589;238;351
9;80206;80200;66-600;190;134;133;51;82
10;80206;80200;66-600;983;522;515;258;257
11;80206;80200;66-600;406;242;238;136;102
12;80206;80200;66-600;1179;830;829;315;514
13;80206;80200;66-600;618;364;360;219;141
14;80206;80200;66-600;337;205;204;120;84
15;80206;80200;66-600;378;232;231;111;120
16;80206;80200;66-600;518;365;351;164;187
17;80206;80200;66-600;215;113;110;48;62
18;80206;80200;66-600;35;19;19;7;12
1;80207;80200;66-614;615;400;393;218;175
2;80207;80200;66-614;555;305;302;170;132
3;80207;80200;66-614;252;162;161;90;71
4;80207;80200;66-614;506;306;303;191;112
5;80207;80200;66-614;218;156;156;94;62
1;80301;80300;66-350;759;510;508;213;295
2;80301;80300;66-350;678;414;410;164;246
3;80301;80300;66-350;330;224;223;103;120
4;80301;80300;66-350;538;305;303;198;105
5;80301;80300;66-350;363;216;215;123;92
6;80301;80300;66-350;476;296;296;166;130
1;80302;80300;66-300;1253;840;828;302;526
2;80302;80300;66-300;1004;595;590;245;345
3;80302;80300;66-300;1617;1118;1111;414;697
4;80302;80300;66-300;1341;944;937;305;632
5;80302;80300;66-300;1294;917;913;344;569
6;80302;80300;66-300;1555;997;985;374;611
7;80302;80300;66-300;868;530;525;203;322
8;80302;80300;66-300;750;559;554;234;320
9;80302;80300;66-300;1060;752;750;240;510
10;80302;80300;66-300;1423;1015;1006;404;602
11;80302;80300;66-300;716;454;454;270;184
12;80302;80300;66-300;566;352;348;121;227
13;80302;80300;66-300;1026;756;752;268;484
14;80302;80300;66-300;633;385;382;155;227
15;80302;80300;66-300;716;436;429;173;256
16;80302;80300;66-300;448;297;296;148;148
17;80302;80300;66-300;209;145;143;70;73
18;80302;80300;66-300;193;142;142;58;84
19;80302;80300;66-300;421;296;296;92;204
20;80302;80300;66-300;347;258;254;104;150
21;80302;80300;66-300;43;32;32;12;20
22;80302;80300;66-300;363;270;266;45;221
23;80302;80300;66-300;379;161;157;61;96
1;80303;80300;66-340;342;203;201;104;97
2;80303;80300;66-340;583;291;290;158;132
3;80303;80300;66-340;966;670;664;295;369
4;80303;80300;66-340;407;234;233;123;110
5;80303;80300;66-340;244;169;167;43;124
6;80303;80300;66-340;320;197;196;108;88
7;80303;80300;66-340;291;188;188;81;107
8;80303;80300;66-340;945;615;610;307;303
1;80304;80300;66-330;824;552;547;240;307
2;80304;80300;66-330;311;190;185;102;83
3;80304;80300;66-330;274;168;165;93;72
4;80304;80300;66-330;351;188;188;98;90
5;80304;80300;66-330;294;208;206;108;98
6;80304;80300;66-330;223;143;139;83;56
7;80304;80300;66-330;216;113;111;55;56
8;80304;80300;66-330;917;605;600;269;331
1;80305;80300;66-440;975;672;665;239;426
2;80305;80300;66-440;1225;841;827;337;490
3;80305;80300;66-440;1158;828;822;305;517
4;80305;80300;66-440;1121;730;726;299;427
5;80305;80300;66-440;1195;720;710;303;407
6;80305;80300;66-440;959;569;563;273;290
7;80305;80300;66-440;459;302;302;156;146
8;80305;80300;66-440;640;364;360;172;188
9;80305;80300;66-440;344;212;211;88;123
10;80305;80300;66-440;192;129;128;60;68
11;80305;80300;66-440;265;167;164;85;79
12;80305;80300;66-440;82;12;12;5;7
1;80306;80300;66-320;1754;1152;1141;470;671
2;80306;80300;66-320;591;409;406;187;219
3;80306;80300;66-304;574;328;322;157;165
4;80306;80300;66-304;705;393;392;171;221
5;80306;80300;66-304;252;147;144;97;47
6;80306;80300;66-304;328;198;194;67;127
7;80306;80300;66-320;176;123;123;39;84
8;80306;80300;66-320;182;119;118;53;65
9;80306;80300;66-320;215;144;144;74;70
1;80401;80400;67-100;1758;1201;1191;467;724
2;80401;80400;67-100;1958;1480;1466;526;940
3;80401;80400;67-100;1861;1352;1340;550;790
4;80401;80400;67-100;1359;1028;1019;392;627
5;80401;80400;67-100;2011;1478;1466;593;873
6;80401;80400;67-100;1010;698;692;300;392
7;80401;80400;67-100;1544;992;986;430;556
8;80401;80400;67-100;1545;1125;1110;437;673
9;80401;80400;67-100;1743;1248;1239;443;796
10;80401;80400;67-100;1943;1361;1348;574;774
11;80401;80400;67-100;1599;1034;1031;400;631
12;80401;80400;67-100;1030;702;696;265;431
13;80401;80400;67-100;1265;781;778;294;484
14;80401;80400;67-100;1580;906;897;451;446
15;80401;80400;67-100;1416;857;850;388;462
16;80401;80400;67-100;1346;896;894;349;545
17;80401;80400;67-100;1430;925;920;374;546
18;80401;80400;67-100;287;161;159;71;88
1;80402;80400;67-115;1819;1206;1202;521;681
2;80402;80400;67-115;1483;880;875;396;479
3;80402;80400;67-115;365;253;248;137;111
4;80402;80400;67-115;283;171;165;83;82
1;80403;80400;67-415;1611;1038;1024;528;496
2;80403;80400;67-416;1026;628;616;350;266
1;80404;80400;67-120;679;415;414;153;261
2;80404;80400;67-120;1340;836;827;331;496
3;80404;80400;67-120;1556;932;923;407;516
4;80404;80400;67-120;1545;958;948;437;511
5;80404;80400;67-120;2238;1522;1511;655;856
6;80404;80400;67-120;60;31;29;14;15
7;80404;80400;67-120;748;437;433;250;183
8;80404;80400;67-120;573;375;374;210;164
9;80404;80400;67-120;510;310;306;180;126
10;80404;80400;67-120;461;275;272;157;115
11;80404;80400;67-120;724;409;406;196;210
12;80404;80400;67-120;304;207;204;95;109
13;80404;80400;67-120;455;278;273;157;116
14;80404;80400;67-120;204;112;112;68;44
1;80405;80400;67-100;492;327;324;167;157
2;80405;80400;67-100;583;390;387;232;155
3;80405;80400;67-100;993;640;630;297;333
4;80405;80400;67-100;934;632;622;220;402
5;80405;80400;67-100;514;378;374;142;232
6;80405;80400;67-100;299;194;188;119;69
7;80405;80400;67-100;1209;785;777;439;338
8;80405;80400;67-100;265;161;160;105;55
9;80405;80400;67-100;287;215;211;78;133
1;80406;80400;67-124;1108;722;720;361;359
2;80406;80400;67-124;865;559;556;310;246
3;80406;80400;67-124;570;345;341;222;119
4;80406;80400;67-124;475;275;268;170;98
5;80406;80400;67-124;225;121;121;96;25
6;80406;80400;67-124;236;117;115;57;58
7;80406;80400;67-124;199;125;124;86;38
8;80406;80400;67-124;170;99;97;49;48
1;80407;80400;67-106;1307;884;874;350;524
2;80407;80400;67-106;1447;1036;1022;487;535
3;80407;80400;67-106;611;409;404;201;203
4;80407;80400;67-106;1075;689;670;320;350
5;80407;80400;67-106;412;260;258;100;158
6;80407;80400;67-106;539;348;345;204;141
1;80408;80400;67-112;615;361;359;245;114
2;80408;80400;67-112;1500;994;983;553;430
3;80408;80400;67-112;294;196;195;129;66
4;80408;80400;67-112;204;126;123;66;57
1;80501;80500;69-108;2074;1317;1305;542;763
2;80501;80500;69-108;1070;566;561;321;240
3;80501;80500;69-108;431;232;230;112;118
4;80501;80500;69-108;561;288;285;150;135
5;80501;80500;69-108;704;427;424;230;194
1;80502;80500;69-113;1428;881;867;370;497
2;80502;80500;69-113;649;426;420;275;145
3;80502;80500;69-113;476;251;251;162;89
4;80502;80500;69-113;605;348;345;182;163
1;80503;80500;69-220;1164;741;733;317;416
2;80503;80500;69-220;1086;700;693;274;419
3;80503;80500;69-220;1623;946;941;441;500
4;80503;80500;69-220;752;432;427;202;225
1;80504;80500;69-110;1529;931;917;429;488
2;80504;80500;69-110;1303;850;843;336;507
3;80504;80500;69-110;1330;864;859;394;465
4;80504;80500;69-110;1611;1094;1083;459;624
5;80504;80500;69-110;1381;823;815;376;439
1;80505;80500;69-100;1274;954;949;287;662
2;80505;80500;69-100;835;569;561;200;361
3;80505;80500;69-100;978;639;638;195;443
4;80505;80500;69-100;877;612;607;222;385
5;80505;80500;69-100;908;601;599;197;402
6;80505;80500;69-100;872;637;633;227;406
7;80505;80500;69-100;684;447;444;170;274
8;80505;80500;69-100;817;500;498;181;317
9;80505;80500;69-100;760;487;485;172;313
10;80505;80500;69-100;888;576;574;164;410
11;80505;80500;69-100;1025;702;695;255;440
12;80505;80500;69-100;1034;673;666;238;428
13;80505;80500;69-100;1480;983;978;357;621
14;80505;80500;69-100;388;247;243;118;125
15;80505;80500;69-100;424;261;261;133;128
16;80505;80500;69-100;1130;836;825;248;577
17;80505;80500;69-100;305;197;194;86;108
18;80505;80500;69-100;171;100;97;47;50
19;80505;80500;69-100;148;84;84;39;45
20;80505;80500;69-100;275;174;169;63;106
21;80505;80500;69-100;70;38;38;8;30
1;80601;80600;66-520;1795;1105;1095;574;521
2;80601;80600;66-520;1246;819;818;381;437
3;80601;80600;66-520;378;216;215;110;105
4;80601;80600;66-520;425;233;233;118;115
5;80601;80600;66-520;221;145;144;47;97
6;80601;80600;66-520;356;221;220;131;89
7;80601;80600;66-520;339;234;231;129;102
8;80601;80600;66-520;45;22;20;13;7
1;80602;80600;66-530;913;621;616;325;291
2;80602;80600;66-530;1255;762;759;335;424
3;80602;80600;66-530;1364;826;819;330;489
4;80602;80600;66-530;1006;701;698;325;373
5;80602;80600;66-530;1692;1105;1097;498;599
6;80602;80600;66-530;736;537;531;241;290
7;80602;80600;66-530;383;221;221;98;123
8;80602;80600;66-530;346;213;212;89;123
9;80602;80600;66-530;555;372;371;176;195
10;80602;80600;66-530;1138;714;708;401;307
11;80602;80600;66-530;458;300;297;127;170
12;80602;80600;66-530;986;584;578;326;252
13;80602;80600;66-530;247;140;140;87;53
14;80602;80600;66-530;558;301;299;186;113
15;80602;80600;66-530;357;196;196;127;69
16;80602;80600;66-530;396;245;242;134;108
17;80602;80600;66-530;80;39;39;14;25
1;80603;80600;66-540;766;501;497;235;262
2;80603;80600;66-540;424;234;234;144;90
3;80603;80600;66-540;363;222;219;129;90
4;80603;80600;66-540;256;131;130;83;47
5;80603;80600;66-540;170;95;94;40;54
6;80603;80600;66-540;157;93;93;55;38
7;80603;80600;66-540;793;504;502;206;296
1;80604;80600;66-500;1587;1004;999;365;634
2;80604;80600;66-500;1708;1121;1120;436;684
3;80604;80600;66-500;1661;1030;1025;385;640
4;80604;80600;66-500;1074;751;746;241;505
5;80604;80600;66-500;1517;1026;1021;356;665
6;80604;80600;66-500;716;409;407;188;219
7;80604;80600;66-500;270;157;155;94;61
8;80604;80600;66-510;414;234;234;124;110
9;80604;80600;66-510;848;472;469;235;234
10;80604;80600;66-510;384;239;238;121;117
11;80604;80600;66-500;445;229;229;126;103
12;80604;80600;66-500;301;158;158;70;88
13;80604;80600;66-510;309;205;203;91;112
14;80604;80600;66-500;344;228;228;99;129
15;80604;80600;66-500;327;184;183;65;118
16;80604;80600;66-510;217;117;116;68;48
1;80605;80600;66-542;670;387;384;257;127
2;80605;80600;66-542;280;161;158;98;60
3;80605;80600;66-542;941;542;539;267;272
4;80605;80600;66-542;411;277;274;132;142
5;80605;80600;66-542;860;559;557;263;294
1;80701;80700;66-435;1619;1104;1090;564;526
2;80701;80700;66-435;677;399;395;210;185
3;80701;80700;66-435;779;494;492;289;203
4;80701;80700;66-435;189;138;136;82;54
5;80701;80700;66-435;292;200;199;78;121
1;80702;80700;69-210;1503;1048;1044;394;650
2;80702;80700;69-210;135;68;65;47;18
3;80702;80700;69-210;210;120;116;69;47
4;80702;80700;69-210;538;343;341;184;157
1;80703;80700;66-436;1234;796;791;413;378
2;80703;80700;66-436;996;630;628;296;332
3;80703;80700;66-436;427;264;261;147;114
4;80703;80700;66-436;429;242;238;153;85
5;80703;80700;66-436;248;153;153;78;75
6;80703;80700;66-436;153;111;110;85;25
7;80703;80700;66-436;270;182;182;29;153
1;80704;80700;69-200;891;639;633;285;348
2;80704;80700;69-200;716;511;508;243;265
3;80704;80700;69-200;725;477;475;200;275
4;80704;80700;69-200;713;484;477;214;263
5;80704;80700;69-200;973;710;704;264;440
6;80704;80700;69-200;644;457;457;255;202
7;80704;80700;69-200;728;428;423;207;216
8;80704;80700;69-200;778;443;441;235;206
9;80704;80700;69-200;908;636;630;300;330
10;80704;80700;69-200;531;358;348;176;172
11;80704;80700;69-200;421;240;236;143;93
12;80704;80700;69-200;435;284;282;166;116
13;80704;80700;69-211;783;571;565;352;213
14;80704;80700;69-200;484;329;326;214;112
15;80704;80700;69-200;177;118;116;50;66
16;80704;80700;69-200;371;195;194;119;75
17;80704;80700;69-200;214;115;114;70;44
18;80704;80700;69-200;163;97;93;47;46
19;80704;80700;69-200;214;143;143;95;48
20;80704;80700;69-200;215;135;133;87;46
21;80704;80700;69-200;96;46;45;20;25
22;80704;80700;69-200;151;77;76;46;30
1;80705;80700;66-235;1302;882;870;387;483
2;80705;80700;66-235;569;390;386;142;244
3;80705;80700;66-235;338;175;174;113;61
4;80705;80700;66-235;929;510;507;236;271
5;80705;80700;66-235;206;106;102;48;54
6;80705;80700;66-235;658;403;399;207;192
7;80705;80700;66-235;296;175;173;107;66
8;80705;80700;66-235;249;159;158;97;61
9;80705;80700;66-235;202;106;106;40;66
10;80705;80700;66-235;143;47;47;27;20
11;80705;80700;66-235;113;102;101;34;67
1;80801;80800;66-218;898;641;633;292;341
2;80801;80800;66-218;622;388;382;165;217
3;80801;80800;66-218;252;146;146;81;65
4;80801;80800;66-218;252;152;152;93;59
5;80801;80800;66-218;328;258;254;107;147
6;80801;80800;66-218;432;280;276;178;98
1;80802;80800;66-220;1415;937;922;391;531
2;80802;80800;66-220;1000;570;563;292;271
3;80802;80800;66-220;644;358;357;192;165
4;80802;80800;66-220;367;263;261;128;133
5;80802;80800;66-220;217;128;128;64;64
6;80802;80800;66-220;208;147;146;85;61
1;80803;80800;66-213;987;607;599;296;303
2;80803;80800;66-213;1134;778;776;252;524
3;80803;80800;66-213;330;212;209;102;107
4;80803;80800;66-213;265;149;149;73;76
5;80803;80800;66-213;201;126;124;62;62
6;80803;80800;66-213;495;319;314;167;147
7;80803;80800;66-213;381;258;255;132;123
8;80803;80800;66-213;474;185;180;97;83
1;80804;80800;66-225;1062;707;697;394;303
2;80804;80800;66-225;533;298;290;155;135
3;80804;80800;66-225;774;438;436;275;161
4;80804;80800;66-225;300;206;205;127;78
5;80804;80800;66-225;143;98;95;48;47
1;80805;80800;66-200;2003;1390;1380;566;814
2;80805;80800;66-200;1427;982;975;406;569
3;80805;80800;66-200;940;604;598;239;359
4;80805;80800;66-200;608;429;429;155;274
5;80805;80800;66-200;1101;685;675;269;406
6;80805;80800;66-200;1834;1130;1119;511;608
7;80805;80800;66-200;1001;641;638;268;370
8;80805;80800;66-200;1116;712;707;205;502
9;80805;80800;66-200;2175;1534;1521;627;894
10;80805;80800;66-200;1068;779;777;313;464
11;80805;80800;66-200;1645;1200;1192;492;700
12;80805;80800;66-200;747;468;465;258;207
13;80805;80800;66-200;351;231;228;151;77
14;80805;80800;66-200;645;394;393;199;194
15;80805;80800;66-200;349;212;211;151;60
16;80805;80800;66-200;549;360;359;183;176
17;80805;80800;66-200;673;424;421;229;192
18;80805;80800;66-200;458;302;300;143;157
19;80805;80800;66-200;1023;655;651;283;368
20;80805;80800;66-200;216;131;128;68;60
21;80805;80800;66-200;303;224;221;88;133
22;80805;80800;66-200;232;143;139;74;65
23;80805;80800;66-200;206;127;124;60;64
24;80805;80800;66-200;163;94;92;62;30
25;80805;80800;66-200;246;160;158;78;80
26;80805;80800;66-200;61;12;12;5;7
27;80805;80800;66-200;81;63;63;28;35
1;80806;80800;66-210;1251;880;866;345;521
2;80806;80800;66-210;1250;881;873;369;504
3;80806;80800;66-210;1252;901;894;267;627
4;80806;80800;66-210;934;628;619;220;399
5;80806;80800;66-210;796;512;507;225;282
6;80806;80800;66-210;217;130;130;85;45
7;80806;80800;66-210;332;234;228;104;124
1;80901;80900;66-110;1350;911;904;336;568
2;80901;80900;66-110;1453;954;946;399;547
3;80901;80900;66-111;660;433;430;241;189
4;80901;80900;66-110;395;282;276;156;120
5;80901;80900;66-111;413;281;280;155;125
6;80901;80900;66-110;309;211;209;99;110
1;80902;80900;66-130;1038;638;633;261;372
2;80902;80900;66-133;842;567;560;269;291
3;80902;80900;66-130;282;161;160;88;72
4;80902;80900;66-130;317;195;191;129;62
1;80903;80900;66-016;1546;1083;1069;378;691
2;80903;80900;66-016;1432;929;918;335;583
3;80903;80900;66-016;990;626;620;289;331
4;80903;80900;66-016;623;386;385;174;211
5;80903;80900;66-100;687;394;391;217;174
6;80903;80900;66-016;1437;1064;1056;317;739
7;80903;80900;66-016;387;272;272;155;117
8;80903;80900;66-016;205;122;122;59;63
9;80903;80900;66-100;187;103;102;73;29
1;80904;80900;66-120;1371;883;873;351;522
2;80904;80900;66-120;1720;1049;1040;456;584
3;80904;80900;66-120;682;438;437;187;250
4;80904;80900;66-120;290;191;188;119;69
5;80904;80900;66-120;318;235;233;107;126
1;80905;80900;66-010;900;592;586;228;358
2;80905;80900;66-010;1635;1086;1078;425;653
3;80905;80900;66-010;622;360;360;180;180
4;80905;80900;66-010;522;332;332;156;176
5;80905;80900;66-010;327;218;216;82;134
6;80905;80900;66-010;331;222;218;93;125
7;80905;80900;66-010;168;112;110;61;49
8;80905;80900;66-010;227;150;147;76;71
9;80905;80900;66-010;295;170;168;113;55
10;80905;80900;66-010;305;171;167;89;78
11;80905;80900;66-010;293;184;184;103;81
12;80905;80900;66-010;211;146;145;72;73
13;80905;80900;66-010;935;644;635;271;364
14;80905;80900;66-010;766;617;598;61;537
1;80906;80900;66-100;883;676;671;257;414
2;80906;80900;66-100;1131;779;772;309;463
3;80906;80900;66-100;1403;947;941;358;583
4;80906;80900;66-100;1477;944;935;394;541
5;80906;80900;66-100;983;667;661;253;408
6;80906;80900;66-100;1762;1207;1197;444;753
7;80906;80900;66-111;552;284;283;115;168
8;80906;80900;66-131;1159;803;797;269;528
9;80906;80900;66-100;383;208;204;113;91
10;80906;80900;66-100;758;477;474;223;251
11;80906;80900;66-105;472;288;285;137;148
12;80906;80900;66-100;613;391;386;151;235
13;80906;80900;66-105;495;273;269;128;141
14;80906;80900;66-100;1754;1274;1262;463;799
15;80906;80900;66-100;750;586;582;252;330
16;80906;80900;66-111;205;122;121;64;57
17;80906;80900;66-100;808;588;584;205;379
18;80906;80900;66-100;271;184;184;103;81
19;80906;80900;66-100;1013;698;691;266;425
20;80906;80900;66-100;1106;714;713;285;428
21;80906;80900;66-100;817;573;566;227;339
22;80906;80900;66-100;70;55;54;25;29
1;80907;80900;66-008;1736;1266;1252;423;829
2;80907;80900;66-014;543;414;408;123;285
3;80907;80900;66-014;485;299;296;111;185
4;80907;80900;66-008;903;685;677;190;487
5;80907;80900;66-014;706;471;461;212;249
6;80907;80900;66-014;803;611;607;222;385
1;80908;80900;66-132;927;595;591;252;339
2;80908;80900;66-132;36;29;29;15;14
3;80908;80900;66-132;422;228;226;124;102
4;80908;80900;66-132;230;149;149;86;63
5;80908;80900;66-133;430;225;223;108;115
6;80908;80900;66-132;184;104;103;66;37
7;80908;80900;66-132;162;119;118;69;49
1;80909;80900;66-003;1149;795;784;322;462
2;80909;80900;66-003;733;543;540;175;365
3;80909;80900;66-003;1126;855;845;237;608
4;80909;80900;66-003;290;198;195;67;128
5;80909;80900;66-003;277;186;180;75;105
1;81001;81000;68-130;736;402;400;174;226
2;81001;81000;68-130;724;401;400;184;216
3;81001;81000;68-130;635;346;342;165;177
1;81002;81000;68-100;2039;1315;1298;497;801
2;81002;81000;68-100;958;666;659;232;427
3;81002;81000;68-100;1631;1093;1086;425;661
4;81002;81000;68-100;1375;941;936;327;609
5;81002;81000;68-100;1356;870;863;340;523
6;81002;81000;68-100;625;408;403;159;244
7;81002;81000;68-100;1721;1121;1108;455;653
8;81002;81000;68-100;1193;764;759;273;486
9;81002;81000;68-100;673;391;388;180;208
10;81002;81000;68-100;1997;1504;1497;519;978
11;81002;81000;68-100;1329;810;803;288;515
12;81002;81000;68-100;1186;769;759;286;473
13;81002;81000;68-100;1135;749;736;314;422
14;81002;81000;68-100;15;10;10;5;5
1;81003;81000;68-113;967;625;623;394;229
2;81003;81000;68-113;795;474;469;232;237
3;81003;81000;68-113;526;353;349;256;93
4;81003;81000;68-113;440;281;277;141;136
1;81004;81000;68-120;854;545;538;264;274
2;81004;81000;68-120;937;596;589;268;321
3;81004;81000;68-120;939;607;600;254;346
4;81004;81000;68-120;387;237;237;105;132
5;81004;81000;68-120;490;306;301;166;135
6;81004;81000;68-120;170;115;114;75;39
7;81004;81000;68-120;419;265;263;143;120
8;81004;81000;68-120;260;140;138;90;48
9;81004;81000;68-120;407;254;252;148;104
1;81005;81000;67-320;1560;867;859;425;434
2;81005;81000;67-320;1158;752;744;343;401
3;81005;81000;67-320;500;316;315;176;139
4;81005;81000;67-320;344;232;231;131;100
5;81005;81000;67-320;177;112;111;49;62
1;81006;81000;67-312;810;522;519;343;176
2;81006;81000;67-312;574;336;331;189;142
3;81006;81000;67-312;451;294;287;218;69
4;81006;81000;67-312;281;179;177;111;66
5;81006;81000;67-312;268;184;182;116;66
6;81006;81000;67-312;306;203;200;157;43
7;81006;81000;67-312;286;163;159;103;56
8;81006;81000;67-312;253;160;157;113;44
1;81007;81000;67-300;895;524;518;245;273
2;81007;81000;67-300;861;541;538;258;280
3;81007;81000;67-300;1312;863;856;361;495
4;81007;81000;67-300;1120;643;629;318;311
5;81007;81000;67-300;899;605;601;275;326
6;81007;81000;67-300;885;609;608;274;334
7;81007;81000;67-300;1084;643;636;306;330
8;81007;81000;67-300;951;617;612;291;321
9;81007;81000;67-300;380;265;262;161;101
10;81007;81000;67-300;869;502;498;280;218
11;81007;81000;67-300;745;459;457;232;225
12;81007;81000;67-320;205;122;118;60;58
13;81007;81000;67-300;218;127;125;65;60
14;81007;81000;67-300;307;194;193;96;97
15;81007;81000;67-321;339;206;199;136;63
16;81007;81000;67-300;360;257;255;116;139
17;81007;81000;67-300;439;234;228;121;107
18;81007;81000;67-320;353;225;223;133;90
19;81007;81000;67-320;686;365;362;209;153
20;81007;81000;67-312;619;357;353;218;135
21;81007;81000;67-321;988;557;553;337;216
22;81007;81000;67-300;82;10;10;8;2
1;81008;81000;68-131;1008;603;599;313;286
2;81008;81000;68-131;628;345;341;191;150
1;81009;81000;68-100;836;554;553;253;300
2;81009;81000;68-100;284;175;173;84;89
3;81009;81000;68-111;607;338;333;156;177
4;81009;81000;68-114;507;290;287;161;126
5;81009;81000;68-111;404;227;224;141;83
6;81009;81000;67-320;416;245;243;150;93
7;81009;81000;68-114;902;594;592;192;400
8;81009;81000;68-100;360;242;238;103;135
9;81009;81000;68-111;272;208;208;75;133
10;81009;81000;68-111;200;123;119;73;46
11;81009;81000;68-100;252;166;163;87;76
12;81009;81000;67-320;288;157;154;68;86
13;81009;81000;68-100;155;88;88;45;43
1;81101;81100;68-208;949;548;544;184;360
2;81101;81100;68-208;862;530;527;206;321
1;81102;81100;68-200;1592;1142;1134;438;696
2;81102;81100;68-200;1575;1042;1031;387;644
3;81102;81100;68-200;1167;793;786;274;512
4;81102;81100;68-200;1020;629;627;272;355
5;81102;81100;68-200;1485;1042;1032;385;647
6;81102;81100;68-200;1239;766;761;321;440
7;81102;81100;68-200;1427;812;804;302;502
8;81102;81100;68-200;1075;654;643;252;391
9;81102;81100;68-200;931;624;617;264;353
10;81102;81100;68-200;957;642;636;225;411
11;81102;81100;68-200;953;713;707;242;465
12;81102;81100;68-200;813;539;532;197;335
13;81102;81100;68-200;1159;798;793;269;524
14;81102;81100;68-200;1127;702;696;246;450
15;81102;81100;68-200;1319;926;922;384;538
16;81102;81100;68-200;1270;735;730;266;464
17;81102;81100;68-200;1401;875;865;353;512
18;81102;81100;68-200;1100;812;806;306;500
19;81102;81100;68-200;1440;1079;1076;357;719
20;81102;81100;68-200;1208;836;833;310;523
21;81102;81100;68-200;1158;723;720;286;434
22;81102;81100;68-200;52;52;52;26;26
23;81102;81100;68-200;44;44;42;18;24
1;81103;81100;68-343;667;390;387;178;209
2;81103;81100;68-343;542;331;327;155;172
3;81103;81100;68-343;438;240;240;111;129
4;81103;81100;68-343;461;274;271;144;127
5;81103;81100;68-343;322;192;192;77;115
1;81104;81100;68-320;1854;1113;1108;442;666
2;81104;81100;68-320;1607;890;878;346;532
3;81104;81100;68-320;300;186;186;120;66
4;81104;81100;68-320;863;478;474;233;241
5;81104;81100;68-320;401;262;259;141;118
1;81105;81100;68-213;759;473;468;200;268
2;81105;81100;68-213;655;428;426;175;251
3;81105;81100;68-213;290;180;177;103;74
4;81105;81100;68-213;398;172;172;104;68
5;81105;81100;68-213;365;213;209;127;82
1;81106;81100;68-300;1811;1007;995;443;552
2;81106;81100;68-300;880;428;425;175;250
3;81106;81100;68-300;1933;1257;1250;498;752
4;81106;81100;68-300;982;591;587;248;339
5;81106;81100;68-300;1011;692;686;251;435
6;81106;81100;68-300;1486;920;916;328;588
7;81106;81100;68-300;1458;936;927;341;586
8;81106;81100;68-300;623;386;381;209;172
9;81106;81100;68-300;1208;747;741;374;367
10;81106;81100;68-300;906;537;534;297;237
11;81106;81100;68-300;139;58;57;30;27
12;81106;81100;68-300;214;141;141;84;57
13;81106;81100;68-300;379;201;199;108;91
14;81106;81100;68-300;41;8;7;3;4
1;81107;81100;68-132;372;226;222;167;55
2;81107;81100;68-132;752;461;455;190;265
3;81107;81100;68-132;589;328;322;223;99
4;81107;81100;68-132;163;112;111;51;60
5;81107;81100;68-132;264;181;179;106;73
6;81107;81100;68-132;196;129;127;60;67
1;81108;81100;68-212;1039;665;660;268;392
2;81108;81100;68-212;320;168;167;96;71
3;81108;81100;68-210;850;457;453;249;204
4;81108;81100;68-210;860;479;478;242;236
5;81108;81100;68-210;543;378;372;171;201
6;81108;81100;68-212;605;354;352;191;161
1;81109;81100;68-219;1639;972;965;406;559
2;81109;81100;68-300;557;281;279;142;137
1;81110;81100;68-200;1047;636;633;377;256
2;81110;81100;68-200;1051;650;644;334;310
3;81110;81100;68-206;866;543;540;257;283
4;81110;81100;68-200;964;662;656;251;405
5;81110;81100;68-213;839;555;553;237;316
6;81110;81100;68-200;675;382;379;223;156
7;81110;81100;68-200;844;547;541;294;247
8;81110;81100;68-200;798;573;567;242;325
9;81110;81100;68-200;216;107;107;55;52
10;81110;81100;68-200;435;302;301;145;156
11;81110;81100;68-200;368;207;205;88;117
12;81110;81100;68-200;489;336;333;155;178
13;81110;81100;68-200;266;157;155;83;72
14;81110;81100;68-200;414;258;258;139;119
1;81201;81200;67-410;1982;1390;1382;601;781
2;81201;81200;67-410;1197;805;803;305;498
3;81201;81200;67-410;485;372;368;139;229
4;81201;81200;67-410;1085;646;639;368;271
5;81201;81200;67-410;528;313;313;183;130
6;81201;81200;67-410;752;414;405;238;167
7;81201;81200;67-410;697;376;372;257;115
8;81201;81200;67-410;441;258;257;157;100
9;81201;81200;67-410;459;302;299;187;112
10;81201;81200;67-410;384;231;230;125;105
11;81201;81200;67-410;306;181;180;100;80
12;81201;81200;67-410;434;307;307;120;187
13;81201;81200;67-410;203;129;127;79;48
14;81201;81200;67-410;499;391;391;127;264
15;81201;81200;67-410;228;153;152;82;70
1;81202;81200;67-407;959;665;657;450;207
2;81202;81200;67-407;550;307;305;201;104
3;81202;81200;67-407;195;131;129;97;32
4;81202;81200;67-407;773;487;486;332;154
5;81202;81200;67-407;315;194;192;123;69
6;81202;81200;67-407;474;274;273;205;68
7;81202;81200;67-407;212;133;133;86;47
8;81202;81200;67-407;260;168;166;116;50
1;81203;81200;67-400;923;605;602;287;315
2;81203;81200;67-400;1952;1162;1153;597;556
3;81203;81200;67-400;1948;1271;1257;634;623
4;81203;81200;67-400;1014;612;609;300;309
5;81203;81200;67-400;1903;1285;1279;569;710
6;81203;81200;67-400;1015;708;704;331;373
7;81203;81200;67-400;769;583;578;233;345
8;81203;81200;67-400;441;308;303;190;113
9;81203;81200;67-400;360;215;215;121;94
10;81203;81200;67-400;238;151;150;100;50
11;81203;81200;67-400;769;483;473;301;172
12;81203;81200;67-400;464;289;285;188;97
13;81203;81200;67-400;366;243;240;165;75
14;81203;81200;67-400;626;392;392;250;142
15;81203;81200;67-400;522;303;299;213;86
16;81203;81200;67-400;221;162;162;122;40
17;81203;81200;67-400;435;325;322;179;143
18;81203;81200;67-400;187;134;129;64;65
19;81203;81200;67-400;317;205;200;85;115
20;81203;81200;67-400;412;236;235;146;89
21;81203;81200;67-400;78;14;14;6;8
1;86101;86100;66-400;1216;883;869;402;467
2;86101;86100;66-400;1505;1129;1121;406;715
3;86101;86100;66-400;1077;772;770;339;431
4;86101;86100;66-400;1277;823;819;371;448
5;86101;86100;66-400;1066;635;629;261;368
6;86101;86100;66-400;753;403;400;213;187
7;86101;86100;66-400;1863;1200;1193;511;682
8;86101;86100;66-400;1544;961;955;452;503
9;86101;86100;66-400;1470;1136;1127;428;699
10;86101;86100;66-400;810;486;484;234;250
11;86101;86100;66-400;875;592;582;224;358
12;86101;86100;66-400;1238;731;727;308;419
13;86101;86100;66-400;1578;1069;1063;470;593
14;86101;86100;66-400;1289;905;901;371;530
15;86101;86100;66-400;1662;1121;1115;459;656
16;86101;86100;66-400;1706;1240;1233;480;753
17;86101;86100;66-400;1078;757;751;272;479
18;86101;86100;66-400;1549;1069;1056;419;637
19;86101;86100;66-400;1271;906;894;349;545
20;86101;86100;66-400;2377;1842;1831;626;1205
21;86101;86100;66-400;1565;1139;1125;425;700
22;86101;86100;66-400;1139;758;754;236;518
23;86101;86100;66-400;1343;957;949;341;608
24;86101;86100;66-400;781;545;545;195;350
25;86101;86100;66-400;524;392;391;136;255
26;86101;86100;66-400;753;504;498;187;311
27;86101;86100;66-400;647;359;358;148;210
28;86101;86100;66-400;1055;678;673;302;371
29;86101;86100;66-400;608;372;369;158;211
30;86101;86100;66-400;658;376;371;172;199
31;86101;86100;66-400;1144;703;694;321;373
32;86101;86100;66-400;928;528;524;229;295
33;86101;86100;66-400;1110;644;643;296;347
34;86101;86100;66-400;1345;848;843;332;511
35;86101;86100;66-400;1426;1050;1040;317;723
36;86101;86100;66-400;1872;1304;1295;492;803
37;86101;86100;66-400;1534;1167;1162;365;797
38;86101;86100;66-400;1597;1212;1208;406;802
39;86101;86100;66-400;496;362;357;148;209
40;86101;86100;66-400;1838;1295;1287;432;855
41;86101;86100;66-400;1426;1024;1019;415;604
42;86101;86100;66-400;1361;975;966;389;577
43;86101;86100;66-400;1574;1188;1179;361;818
44;86101;86100;66-400;1110;834;825;296;529
45;86101;86100;66-400;1690;1365;1349;434;915
46;86101;86100;66-400;1391;987;982;330;652
47;86101;86100;66-400;1246;918;907;293;614
48;86101;86100;66-400;1780;1283;1277;455;822
49;86101;86100;66-400;1582;1177;1171;478;693
50;86101;86100;66-400;1637;1268;1258;468;790
51;86101;86100;66-400;1654;1212;1205;441;764
52;86101;86100;66-400;1604;1246;1235;431;804
53;86101;86100;66-400;1121;791;784;310;474
54;86101;86100;66-400;1948;1394;1384;536;848
55;86101;86100;66-400;1890;1452;1441;521;920
56;86101;86100;66-400;1201;854;846;325;521
57;86101;86100;66-400;1467;1048;1040;413;627
58;86101;86100;66-400;912;592;588;227;361
59;86101;86100;66-400;1152;846;837;309;528
60;86101;86100;66-400;585;421;419;177;242
61;86101;86100;66-400;1294;856;853;374;479
62;86101;86100;66-400;1757;1248;1237;455;782
63;86101;86100;66-400;1429;919;914;344;570
64;86101;86100;66-400;228;91;89;46;43
65;86101;86100;66-400;237;139;135;54;81
66;86101;86100;66-400;456;277;273;49;224
67;86101;86100;66-400;218;88;86;55;31
68;86101;86100;66-400;54;27;26;12;14
1;86201;86200;65-119;1649;1105;1090;378;712
2;86201;86200;65-729;1271;915;907;300;607
3;86201;86200;65-729;2222;1612;1588;505;1083
4;86201;86200;65-790;1073;849;840;271;569
5;86201;86200;65-783;1386;1114;1106;346;760
6;86201;86200;65-783;1552;1293;1277;324;953
7;86201;86200;65-943;1222;1003;997;287;710
8;86201;86200;65-943;967;738;730;226;504
9;86201;86200;65-941;1381;1028;1022;303;719
10;86201;86200;65-941;1299;1048;1041;266;775
11;86201;86200;65-941;1369;1039;1031;295;736
12;86201;86200;65-610;1428;1047;1043;327;716
13;86201;86200;65-536;1183;890;882;246;636
14;86201;86200;65-536;1162;880;871;271;600
15;86201;86200;65-536;1137;778;772;271;501
16;86201;86200;65-401;1432;1061;1045;312;733
17;86201;86200;65-807;1027;765;761;234;527
18;86201;86200;65-561;1204;864;860;252;608
19;86201;86200;65-536;1159;837;830;332;498
20;86201;86200;65-536;1111;806;804;257;547
21;86201;86200;65-533;1341;964;958;330;628
22;86201;86200;65-533;1190;781;767;253;514
23;86201;86200;65-634;1554;1189;1184;343;841
24;86201;86200;65-552;1600;1281;1268;332;936
25;86201;86200;65-515;1137;779;774;297;477
26;86201;86200;65-515;1039;703;701;263;438
27;86201;86200;65-508;1124;802;795;283;512
28;86201;86200;65-301;1389;979;975;311;664
29;86201;86200;65-392;1755;1349;1338;421;917
30;86201;86200;65-383;1680;1390;1380;374;1006
31;86201;86200;65-383;1258;1032;1020;241;779
32;86201;86200;65-383;1236;981;973;254;719
33;86201;86200;65-547;1062;882;876;279;597
34;86201;86200;66-015;1659;1228;1216;449;767
35;86201;86200;66-015;882;678;676;264;412
36;86201;86200;66-016;1102;889;883;259;624
37;86201;86200;66-001;1266;873;863;359;504
38;86201;86200;66-002;1507;1137;1129;359;770
39;86201;86200;66-002;1106;793;791;253;538
40;86201;86200;66-004;2406;1893;1882;562;1320
41;86201;86200;66-004;1481;1239;1221;345;876
42;86201;86200;66-004;831;553;551;213;338
43;86201;86200;66-006;999;787;779;313;466
44;86201;86200;65-119;1787;1468;1456;413;1043
45;86201;86200;65-119;1358;1061;1053;336;717
46;86201;86200;65-129;1245;1004;997;341;656
47;86201;86200;65-147;2279;1753;1743;487;1256
48;86201;86200;65-147;1400;1112;1105;382;723
49;86201;86200;65-036;1196;880;873;272;601
50;86201;86200;65-735;1378;1135;1130;317;813
51;86201;86200;65-181;1691;1290;1280;393;887
52;86201;86200;65-186;1196;825;817;294;523
53;86201;86200;65-516;1178;907;894;258;636
54;86201;86200;65-547;1288;968;959;339;620
55;86201;86200;65-547;1536;1167;1160;383;777
56;86201;86200;65-548;520;435;427;102;325
57;86201;86200;65-229;955;678;670;242;428
58;86201;86200;65-256;1253;975;964;310;654
59;86201;86200;65-215;919;697;689;192;497
60;86201;86200;65-215;861;636;626;202;424
61;86201;86200;65-036;1347;950;937;306;631
62;86201;86200;65-034;1252;867;858;276;582
63;86201;86200;65-093;1071;806;795;260;535
64;86201;86200;65-093;927;585;580;232;348
65;86201;86200;65-054;1037;657;649;219;430
66;86201;86200;65-417;989;607;602;197;405
67;86201;86200;65-401;1140;644;636;194;442
68;86201;86200;65-419;1228;707;699;268;431
69;86201;86200;65-436;1386;970;960;270;690
70;86201;86200;65-436;1236;893;884;311;573
71;86201;86200;65-452;1694;1291;1280;428;852
72;86201;86200;65-012;1178;887;881;307;574
73;86201;86200;66-016;1477;1171;1161;309;852
74;86201;86200;66-016;991;777;770;244;526
75;86201;86200;65-547;1363;999;986;327;659
76;86201;86200;66-001;525;381;377;185;192
77;86201;86200;66-001;326;217;214;85;129
78;86201;86200;66-006;320;264;261;88;173
79;86201;86200;66-006;236;154;153;91;62
80;86201;86200;66-004;901;681;677;248;429
81;86201;86200;66-006;1121;845;842;310;532
82;86201;86200;65-129;969;790;785;251;534
83;86201;86200;65-326;59;35;31;17;14
84;86201;86200;65-265;124;72;71;28;43
85;86201;86200;65-046;351;218;214;83;131
86;86201;86200;65-601;264;219;213;42;171
1;100101;100100;97-400;1487;1192;1179;565;614
2;100101;100100;97-400;1232;767;757;551;206
3;100101;100100;97-400;1853;1344;1332;812;520
4;100101;100100;97-400;1427;1036;1029;668;361
5;100101;100100;97-400;1544;1105;1094;702;392
6;100101;100100;97-400;1424;1046;1029;610;419
7;100101;100100;97-400;1406;1029;1023;587;436
8;100101;100100;97-400;1406;974;966;649;317
9;100101;100100;97-400;1289;973;963;643;320
10;100101;100100;97-400;1434;1018;1011;694;317
11;100101;100100;97-400;1322;887;876;553;323
12;100101;100100;97-400;1387;1037;1022;635;387
13;100101;100100;97-400;1607;1259;1232;722;510
14;100101;100100;97-400;1636;1265;1248;892;356
15;100101;100100;97-400;1326;965;955;643;312
16;100101;100100;97-400;1335;1037;1018;698;320
17;100101;100100;97-400;1395;1074;1058;582;476
18;100101;100100;97-400;1661;1258;1241;723;518
19;100101;100100;97-400;1653;1178;1166;709;457
20;100101;100100;97-400;1517;1137;1130;758;372
21;100101;100100;97-400;2015;1548;1528;881;647
22;100101;100100;97-400;1717;1214;1204;765;439
23;100101;100100;97-400;1858;1322;1306;805;501
24;100101;100100;97-400;1665;1101;1088;718;370
25;100101;100100;97-400;1239;877;866;506;360
26;100101;100100;97-400;1310;902;890;563;327
27;100101;100100;97-400;301;100;100;64;36
28;100101;100100;97-400;66;30;29;16;13
1;100102;100100;97-400;2076;1662;1642;1103;539
2;100102;100100;97-400;1082;780;774;557;217
3;100102;100100;97-400;781;609;605;450;155
4;100102;100100;97-400;911;671;665;552;113
5;100102;100100;97-400;1330;1050;1047;748;299
6;100102;100100;97-400;1556;1195;1189;817;372
7;100102;100100;97-400;385;293;284;231;53
8;100102;100100;97-400;627;491;487;335;152
9;100102;100100;97-400;878;683;679;515;164
1;100103;100100;97-403;611;441;433;332;101
2;100103;100100;97-403;561;379;375;293;82
3;100103;100100;97-403;644;490;483;330;153
4;100103;100100;97-403;734;547;543;385;158
5;100103;100100;97-403;732;507;506;403;103
6;100103;100100;97-403;842;643;638;460;178
1;100104;100100;97-410;511;375;375;262;113
2;100104;100100;97-410;1485;1093;1078;689;389
3;100104;100100;97-410;869;701;691;466;225
4;100104;100100;97-410;1158;844;833;588;245
5;100104;100100;97-410;272;201;198;147;51
6;100104;100100;97-410;438;331;328;267;61
7;100104;100100;97-410;27;27;26;21;5
1;100105;100100;97-415;1322;924;914;671;243
2;100105;100100;97-415;1262;914;902;750;152
3;100105;100100;97-415;697;547;545;383;162
4;100105;100100;97-415;193;117;115;87;28
5;100105;100100;97-415;35;12;11;6;5
1;100106;100100;97-438;720;517;509;371;138
2;100106;100100;97-438;1015;792;784;541;243
3;100106;100100;97-438;935;668;661;472;189
4;100106;100100;97-438;404;284;282;214;68
5;100106;100100;97-438;583;431;430;345;85
6;100106;100100;97-438;215;151;148;123;25
1;100107;100100;97-420;453;342;338;279;59
2;100107;100100;97-420;894;608;595;429;166
3;100107;100100;97-420;1156;883;865;591;274
4;100107;100100;97-420;1144;845;838;558;280
5;100107;100100;97-420;1451;991;982;789;193
6;100107;100100;97-420;835;628;620;513;107
7;100107;100100;97-420;508;376;376;295;81
1;100108;100100;97-425;978;697;695;502;193
2;100108;100100;97-425;1097;789;782;618;164
3;100108;100100;97-425;1440;987;983;777;206
4;100108;100100;97-425;888;629;622;450;172
5;100108;100100;97-425;1390;994;985;705;280
6;100108;100100;97-425;1401;1024;1020;669;351
7;100108;100100;97-425;626;397;391;242;149
8;100108;100100;97-425;1237;838;829;574;255
9;100108;100100;97-425;1410;1025;1011;701;310
10;100108;100100;97-425;578;445;443;316;127
11;100108;100100;97-425;44;33;32;28;4
1;100201;100200;99-300;1174;888;880;423;457
2;100201;100200;99-300;1341;868;860;467;393
3;100201;100200;99-300;1544;1138;1127;518;609
4;100201;100200;99-300;1140;751;744;393;351
5;100201;100200;99-300;925;636;628;297;331
6;100201;100200;99-300;1266;917;912;407;505
7;100201;100200;99-300;1025;746;743;371;372
8;100201;100200;99-300;947;667;663;409;254
9;100201;100200;99-300;1303;971;957;473;484
10;100201;100200;99-300;1576;1170;1164;569;595
11;100201;100200;99-300;967;580;570;329;241
12;100201;100200;99-300;1278;950;947;538;409
13;100201;100200;99-300;873;516;511;268;243
14;100201;100200;99-300;1693;1220;1211;636;575
15;100201;100200;99-300;1512;987;977;551;426
16;100201;100200;99-300;649;418;411;210;201
17;100201;100200;99-300;1493;1082;1073;582;491
18;100201;100200;99-300;1755;1276;1269;554;715
19;100201;100200;99-300;1316;1002;999;417;582
20;100201;100200;99-300;362;207;205;135;70
21;100201;100200;99-300;1448;1000;995;514;481
22;100201;100200;99-300;1798;1308;1300;665;635
23;100201;100200;99-300;1709;1281;1271;646;625
24;100201;100200;99-300;1377;1057;1052;509;543
25;100201;100200;99-300;1024;780;773;365;408
26;100201;100200;99-300;73;20;19;14;5
27;100201;100200;99-300;62;39;38;30;8
28;100201;100200;99-300;49;26;26;18;8
29;100201;100200;99-300;134;74;71;38;33
1;100202;100200;99-311;1134;709;701;499;202
2;100202;100200;99-311;1130;725;720;561;159
3;100202;100200;99-311;483;325;325;242;83
4;100202;100200;99-311;737;498;496;405;91
5;100202;100200;99-311;507;330;325;206;119
6;100202;100200;99-311;59;12;11;4;7
7;100202;100200;99-311;76;63;56;26;30
1;100203;100200;99-352;840;591;589;451;138
2;100203;100200;99-352;203;130;129;106;23
3;100203;100200;99-352;223;156;154;138;16
4;100203;100200;99-352;207;134;132;89;43
1;100204;100200;99-340;1238;838;830;509;321
2;100204;100200;99-340;267;182;179;125;54
3;100204;100200;99-340;353;209;207;162;45
4;100204;100200;99-340;834;490;487;289;198
5;100204;100200;99-340;720;493;489;247;242
6;100204;100200;99-340;481;350;348;281;67
7;100204;100200;99-340;421;260;256;212;44
8;100204;100200;99-340;836;547;544;420;124
9;100204;100200;99-340;409;265;258;201;57
10;100204;100200;99-340;466;271;268;216;52
1;100205;100200;99-314;1100;692;688;505;183
2;100205;100200;99-314;476;322;321;244;77
3;100205;100200;99-314;843;541;531;420;111
4;100205;100200;99-314;766;561;555;358;197
1;100206;100200;99-300;800;500;498;378;120
2;100206;100200;99-300;819;604;597;308;289
3;100206;100200;99-300;417;284;281;217;64
4;100206;100200;99-300;795;557;550;370;180
5;100206;100200;99-300;1257;894;886;563;323
6;100206;100200;99-300;519;372;370;240;130
7;100206;100200;99-300;773;525;522;320;202
8;100206;100200;99-300;734;527;522;280;242
9;100206;100200;99-300;378;283;279;196;83
10;100206;100200;99-300;231;143;139;105;34
1;100207;100200;99-306;1018;690;687;533;154
2;100207;100200;99-306;655;410;407;327;80
3;100207;100200;99-306;56;25;25;18;7
1;100208;100200;99-350;983;625;615;415;200
2;100208;100200;99-350;835;515;513;341;172
3;100208;100200;99-350;419;282;279;206;73
4;100208;100200;99-350;340;204;202;162;40
1;100209;100200;99-322;1069;712;709;549;160
2;100209;100200;99-311;848;604;600;475;125
1;100210;100200;99-307;1418;958;947;675;272
2;100210;100200;99-306;572;357;355;265;90
3;100210;100200;99-307;542;376;374;281;93
4;100210;100200;99-307;430;290;290;223;67
1;100211;100200;99-319;1365;892;883;591;292
2;100211;100200;99-321;592;397;394;297;97
3;100211;100200;99-320;367;228;225;178;47
4;100211;100200;99-320;1218;777;772;441;331
5;100211;100200;99-320;964;672;667;335;332
6;100211;100200;99-320;1135;659;654;447;207
7;100211;100200;99-320;615;359;359;233;126
8;100211;100200;99-320;1054;671;663;366;297
9;100211;100200;99-320;1078;744;740;406;334
1;100301;100300;98-113;1230;946;929;591;338
2;100301;100300;98-113;324;228;226;167;59
3;100301;100300;98-113;624;453;450;312;138
4;100301;100300;98-113;393;283;280;200;80
5;100301;100300;98-113;447;296;295;195;100
6;100301;100300;98-113;428;331;327;231;96
7;100301;100300;98-113;298;188;186;111;75
8;100301;100300;98-113;182;125;124;82;42
1;100302;100300;98-100;1406;1029;1018;428;590
2;100302;100300;98-100;1397;970;962;488;474
3;100302;100300;98-100;1260;868;864;455;409
4;100302;100300;98-100;1218;978;965;444;521
5;100302;100300;98-100;1132;766;761;384;377
6;100302;100300;98-100;998;761;749;359;390
7;100302;100300;98-100;1659;1251;1240;583;657
8;100302;100300;98-100;1639;1126;1114;551;563
9;100302;100300;98-100;1730;1299;1286;538;748
10;100302;100300;98-100;509;335;333;205;128
11;100302;100300;98-100;851;595;590;333;257
12;100302;100300;98-100;763;562;554;280;274
13;100302;100300;98-100;915;699;690;368;322
14;100302;100300;98-100;1049;738;733;528;205
15;100302;100300;98-100;669;453;449;353;96
16;100302;100300;98-100;524;382;375;232;143
17;100302;100300;98-100;950;673;663;338;325
18;100302;100300;98-100;737;608;602;261;341
19;100302;100300;98-100;545;380;376;217;159
20;100302;100300;98-100;292;199;199;149;50
21;100302;100300;98-100;218;152;151;97;54
22;100302;100300;98-100;276;190;185;121;64
23;100302;100300;98-100;103;48;45;28;17
1;100303;100300;98-160;483;349;347;201;146
2;100303;100300;98-160;192;125;124;94;30
3;100303;100300;98-160;464;360;357;202;155
4;100303;100300;98-160;367;234;234;178;56
5;100303;100300;98-160;381;271;268;193;75
6;100303;100300;98-160;545;392;387;223;164
7;100303;100300;98-160;376;266;265;187;78
8;100303;100300;98-160;378;277;275;175;100
9;100303;100300;98-160;185;136;136;91;45
10;100303;100300;98-160;198;147;147;97;50
11;100303;100300;98-160;232;177;176;131;45
12;100303;100300;98-160;299;231;229;174;55
13;100303;100300;98-160;193;140;139;105;34
14;100303;100300;98-160;212;153;152;110;42
15;100303;100300;98-160;233;158;156;109;47
16;100303;100300;98-160;195;140;139;99;40
1;100304;100300;98-170;1119;781;776;636;140
2;100304;100300;98-170;704;492;487;352;135
3;100304;100300;98-170;969;691;685;472;213
4;100304;100300;98-170;696;489;485;348;137
5;100304;100300;98-170;422;302;302;243;59
6;100304;100300;98-170;526;362;359;271;88
7;100304;100300;98-170;936;703;692;444;248
8;100304;100300;98-170;288;215;211;128;83
1;100305;100300;98-105;1046;796;789;382;407
2;100305;100300;98-105;919;705;695;352;343
3;100305;100300;98-105;311;221;220;174;46
4;100305;100300;98-105;250;189;178;96;82
5;100305;100300;98-105;486;373;370;246;124
1;100401;100400;99-100;618;481;474;206;268
2;100401;100400;99-100;1251;883;874;391;483
3;100401;100400;99-100;1345;832;818;432;386
4;100401;100400;99-100;632;464;459;205;254
5;100401;100400;99-100;1272;920;914;410;504
6;100401;100400;99-100;1408;1054;1045;464;581
7;100401;100400;99-100;1253;874;869;420;449
8;100401;100400;99-100;1373;960;951;450;501
9;100401;100400;99-100;723;393;387;211;176
10;100401;100400;99-100;98;22;22;11;11
11;100401;100400;99-100;48;36;34;20;14
12;100401;100400;99-100;39;19;19;4;15
1;100402;100400;99-107;1470;970;964;703;261
2;100402;100400;99-107;1466;940;930;711;219
1;100403;100400;99-122;596;445;442;331;111
2;100403;100400;99-122;582;424;424;366;58
3;100403;100400;99-122;253;174;173;155;18
4;100403;100400;99-122;572;383;378;325;53
5;100403;100400;99-122;1304;930;926;764;162
6;100403;100400;99-122;37;36;30;15;15
1;100404;100400;99-150;676;450;443;361;82
2;100404;100400;99-150;834;557;554;422;132
3;100404;100400;99-150;336;196;192;149;43
4;100404;100400;99-150;632;401;400;320;80
5;100404;100400;99-150;318;237;234;178;56
6;100404;100400;99-150;807;581;579;374;205
7;100404;100400;99-150;829;538;536;445;91
1;100405;100400;99-100;1330;907;902;675;227
2;100405;100400;99-100;786;515;514;404;110
3;100405;100400;99-100;849;556;553;439;114
4;100405;100400;99-100;886;599;596;436;160
5;100405;100400;99-100;409;277;275;212;63
6;100405;100400;99-100;930;719;718;526;192
7;100405;100400;99-100;387;280;276;227;49
8;100405;100400;99-100;966;676;669;497;172
9;100405;100400;99-100;782;520;512;86;426
1;100406;100400;99-120;1463;1036;1017;627;390
2;100406;100400;99-120;603;442;438;332;106
3;100406;100400;99-120;943;696;694;635;59
4;100406;100400;99-120;327;222;221;171;50
5;100406;100400;99-120;336;230;226;177;49
6;100406;100400;99-120;279;198;198;124;74
7;100406;100400;99-120;307;237;236;171;65
8;100406;100400;99-120;288;194;192;169;23
1;100407;100400;99-140;471;293;293;218;75
2;100407;100400;99-140;1085;807;798;522;276
3;100407;100400;99-140;827;520;518;409;109
4;100407;100400;99-140;566;373;372;298;74
1;100408;100400;99-335;457;292;286;238;48
2;100408;100400;99-335;775;514;508;346;162
3;100408;100400;99-335;358;263;261;202;59
4;100408;100400;99-335;454;281;280;220;60
5;100408;100400;99-335;383;255;251;209;42
1;100501;100500;99-400;1163;906;901;558;343
2;100501;100500;99-400;1212;773;765;465;300
3;100501;100500;99-400;1198;886;878;494;384
4;100501;100500;99-400;1158;916;901;500;401
5;100501;100500;99-400;1120;803;794;411;383
6;100501;100500;99-400;715;472;465;232;233
7;100501;100500;99-400;801;558;556;325;231
8;100501;100500;99-400;806;517;511;258;253
9;100501;100500;99-400;902;612;604;297;307
10;100501;100500;99-400;728;503;500;256;244
11;100501;100500;99-400;744;556;550;282;268
12;100501;100500;99-400;881;666;654;317;337
13;100501;100500;99-400;840;651;644;263;381
14;100501;100500;99-400;1118;777;773;466;307
15;100501;100500;99-400;1067;776;767;421;346
16;100501;100500;99-400;1098;812;807;431;376
17;100501;100500;99-400;955;692;685;339;346
18;100501;100500;99-400;870;663;658;317;341
19;100501;100500;99-400;942;765;757;397;360
20;100501;100500;99-400;834;591;586;345;241
21;100501;100500;99-400;873;631;622;333;289
22;100501;100500;99-400;44;22;21;14;7
23;100501;100500;99-400;855;671;656;86;570
1;100502;100500;99-423;1194;838;826;511;315
2;100502;100500;99-423;630;420;417;309;108
3;100502;100500;99-423;548;387;383;295;88
4;100502;100500;99-423;609;449;449;338;111
5;100502;100500;99-423;557;365;364;290;74
6;100502;100500;99-423;534;367;366;301;65
7;100502;100500;99-423;96;33;29;18;11
8;100502;100500;99-423;42;42;40;32;8
1;100503;100500;99-413;691;490;485;420;65
2;100503;100500;99-413;955;667;665;497;168
3;100503;100500;99-413;637;440;440;353;87
1;100504;100500;99-434;976;736;728;497;231
2;100504;100500;99-434;518;363;363;274;89
3;100504;100500;99-434;689;474;470;330;140
4;100504;100500;99-434;174;123;123;102;21
5;100504;100500;99-434;286;218;216;169;47
6;100504;100500;99-434;375;266;264;229;35
7;100504;100500;99-434;359;265;264;220;44
8;100504;100500;99-434;213;133;130;104;26
1;100505;100500;99-412;1470;971;958;685;273
2;100505;100500;99-412;623;448;445;397;48
3;100505;100500;99-412;269;183;181;141;40
4;100505;100500;99-412;205;131;130;90;40
1;100506;100500;99-414;1735;1228;1212;982;230
2;100506;100500;99-414;568;394;393;317;76
3;100506;100500;99-414;568;437;432;370;62
4;100506;100500;99-414;342;268;264;235;29
1;100507;100500;99-400;1057;800;792;582;210
2;100507;100500;99-400;827;578;572;362;210
3;100507;100500;99-400;367;277;277;226;51
4;100507;100500;99-400;844;620;612;410;202
5;100507;100500;99-400;372;244;238;193;45
6;100507;100500;99-400;873;653;650;435;215
7;100507;100500;99-400;622;433;428;310;118
8;100507;100500;99-400;484;364;363;299;64
9;100507;100500;99-400;555;395;392;266;126
1;100508;100500;99-420;1108;792;784;535;249
2;100508;100500;99-420;430;283;282;244;38
3;100508;100500;99-418;629;455;453;362;91
4;100508;100500;99-420;708;486;482;364;118
5;100508;100500;99-420;436;303;302;235;67
6;100508;100500;99-420;366;258;255;204;51
7;100508;100500;99-420;494;356;354;285;69
8;100508;100500;99-418;491;347;343;254;89
9;100508;100500;99-420;352;217;217;151;66
1;100509;100500;99-416;404;318;314;254;60
2;100509;100500;99-416;1154;836;831;571;260
3;100509;100500;99-416;1282;966;959;608;351
4;100509;100500;99-416;1117;815;808;542;266
5;100509;100500;99-418;883;656;653;479;174
6;100509;100500;99-418;942;681;672;421;251
7;100509;100500;99-418;1190;880;874;571;303
8;100509;100500;99-418;336;245;242;158;84
1;100510;100500;99-440;1008;742;731;439;292
2;100510;100500;99-440;708;516;510;329;181
3;100510;100500;99-440;878;579;571;394;177
4;100510;100500;99-440;567;418;415;320;95
5;100510;100500;99-440;309;215;215;125;90
6;100510;100500;99-440;387;288;285;236;49
7;100510;100500;99-440;293;204;201;149;52
1;100602;100600;95-020;696;526;524;263;261
2;100602;100600;95-020;673;540;537;246;291
3;100602;100600;95-020;673;550;545;300;245
4;100602;100600;95-020;643;460;459;237;222
5;100602;100600;95-020;1189;928;918;461;457
6;100602;100600;95-020;349;259;256;156;100
7;100602;100600;95-020;1009;826;819;278;541
8;100602;100600;95-020;1098;877;873;336;537
9;100602;100600;95-020;752;607;604;236;368
10;100602;100600;95-020;678;548;544;191;353
11;100602;100600;95-020;1027;820;818;364;454
12;100602;100600;95-020;498;331;328;181;147
13;100602;100600;95-020;675;466;459;238;221
14;100602;100600;95-020;831;682;672;289;383
15;100602;100600;95-020;358;295;290;144;146
16;100602;100600;95-020;427;347;342;179;163
17;100602;100600;95-020;83;29;26;13;13
1;100603;100600;95-006;1081;810;805;543;262
2;100603;100600;95-006;232;185;183;132;51
3;100603;100600;95-006;1405;1075;1067;778;289
4;100603;100600;95-006;782;611;607;292;315
5;100603;100600;95-006;1280;1096;1084;429;655
6;100603;100600;95-006;716;546;536;374;162
7;100603;100600;95-006;95;23;23;6;17
1;100607;100600;95-040;1592;1125;1115;636;479
2;100607;100600;95-040;1338;1009;996;494;502
3;100607;100600;95-040;774;615;604;323;281
4;100607;100600;95-040;874;698;687;378;309
5;100607;100600;95-040;905;655;648;386;262
6;100607;100600;95-040;1019;788;782;441;341
7;100607;100600;95-040;1110;814;803;389;414
8;100607;100600;95-040;783;605;602;331;271
9;100607;100600;95-040;886;643;639;335;304
10;100607;100600;95-040;311;261;256;117;139
11;100607;100600;95-040;848;649;645;331;314
12;100607;100600;95-040;702;531;525;247;278
13;100607;100600;95-040;318;254;250;171;79
14;100607;100600;95-041;823;640;630;299;331
15;100607;100600;95-041;1503;1151;1134;517;617
16;100607;100600;95-041;716;571;566;267;299
17;100607;100600;95-040;327;233;232;136;96
18;100607;100600;95-040;469;364;361;178;183
19;100607;100600;95-040;302;224;223;158;65
20;100607;100600;95-040;468;358;355;236;119
21;100607;100600;95-040;334;249;248;178;70
22;100607;100600;95-040;415;274;273;210;63
23;100607;100600;95-040;229;165;163;124;39
24;100607;100600;95-040;438;318;315;197;118
25;100607;100600;95-040;355;266;264;163;101
26;100607;100600;95-040;32;24;24;22;2
1;100608;100600;92-701;871;756;749;255;494
2;100608;100600;92-701;907;776;768;233;535
3;100608;100600;92-701;1122;890;879;349;530
4;100608;100600;92-701;572;439;429;241;188
5;100608;100600;92-701;580;471;469;153;316
6;100608;100600;92-701;367;282;279;130;149
1;100610;100600;95-030;1774;1415;1406;734;672
2;100610;100600;95-030;965;759;752;381;371
3;100610;100600;95-030;658;557;552;288;264
4;100610;100600;95-030;843;694;689;259;430
5;100610;100600;95-030;737;573;568;320;248
6;100610;100600;95-030;714;563;562;313;249
7;100610;100600;95-030;544;428;421;236;185
8;100610;100600;95-030;254;208;206;106;100
9;100610;100600;95-030;200;169;165;96;69
10;100610;100600;95-030;1320;1051;1041;432;609
11;100610;100600;95-030;557;443;439;300;139
1;100611;100600;95-080;626;455;448;241;207
2;100611;100600;95-080;678;501;497;307;190
3;100611;100600;95-080;694;517;515;320;195
4;100611;100600;95-080;440;336;332;150;182
5;100611;100600;95-080;700;476;472;250;222
6;100611;100600;95-080;719;515;515;195;320
7;100611;100600;95-080;639;496;494;219;275
8;100611;100600;95-080;617;467;457;207;250
9;100611;100600;95-080;428;308;307;177;130
10;100611;100600;95-080;283;218;217;144;73
11;100611;100600;95-080;604;473;469;226;243
12;100611;100600;95-080;331;242;241;149;92
13;100611;100600;95-080;611;468;466;377;89
14;100611;100600;95-080;392;285;282;185;97
15;100611;100600;95-080;404;328;325;161;164
16;100611;100600;95-080;243;181;180;113;67
17;100611;100600;95-080;165;129;127;64;63
18;100611;100600;95-080;238;186;183;114;69
19;100611;100600;95-080;192;160;157;134;23
20;100611;100600;95-080;267;200;199;172;27
21;100611;100600;95-080;691;569;568;188;380
22;100611;100600;95-080;148;107;106;55;51
23;100611;100600;95-080;115;36;36;5;31
1;100701;100700;26-307;906;637;634;435;199
2;100701;100700;26-307;637;439;437;360;77
3;100701;100700;26-307;272;220;217;170;47
4;100701;100700;26-307;741;526;519;393;126
5;100701;100700;26-307;862;619;617;451;166
6;100701;100700;26-307;628;429;427;359;68
7;100701;100700;26-307;149;122;120;106;14
8;100701;100700;26-307;258;191;191;161;30
1;100702;100700;26-340;914;665;662;395;267
2;100702;100700;26-340;643;482;476;257;219
3;100702;100700;26-340;1116;830;820;569;251
4;100702;100700;26-340;391;300;298;277;21
5;100702;100700;26-340;320;229;229;185;44
6;100702;100700;26-340;541;407;404;330;74
7;100702;100700;26-340;497;386;381;344;37
8;100702;100700;26-340;240;190;187;150;37
9;100702;100700;26-340;692;502;499;431;68
10;100702;100700;26-340;263;207;206;170;36
11;100702;100700;26-340;476;348;345;285;60
12;100702;100700;26-340;403;317;315;300;15
13;100702;100700;26-340;318;250;248;225;23
14;100702;100700;26-340;237;182;180;146;34
15;100702;100700;26-340;230;163;162;152;10
16;100702;100700;26-340;365;275;275;253;22
17;100702;100700;26-340;72;51;48;36;12
1;100703;100700;26-341;1428;1050;1044;849;195
2;100703;100700;26-341;460;339;338;281;57
3;100703;100700;26-341;1078;786;785;578;207
4;100703;100700;26-341;707;505;503;436;67
1;100704;100700;26-300;580;424;422;336;86
2;100704;100700;26-300;448;370;366;305;61
3;100704;100700;26-300;935;667;663;563;100
4;100704;100700;26-300;293;244;243;212;31
5;100704;100700;26-300;814;640;639;550;89
6;100704;100700;26-300;811;648;643;480;163
7;100704;100700;26-300;450;361;357;301;56
8;100704;100700;26-300;415;293;291;252;39
9;100704;100700;26-300;749;591;589;514;75
10;100704;100700;26-300;642;510;505;407;98
11;100704;100700;26-300;1049;799;790;655;135
12;100704;100700;26-300;494;378;378;315;63
13;100704;100700;26-300;1092;802;796;520;276
14;100704;100700;26-300;1228;918;909;682;227
15;100704;100700;26-300;881;670;667;324;343
16;100704;100700;26-300;1046;812;805;499;306
17;100704;100700;26-300;1246;950;942;541;401
18;100704;100700;26-300;828;609;603;334;269
19;100704;100700;26-300;1035;837;827;464;363
20;100704;100700;26-300;986;761;756;382;374
21;100704;100700;26-300;852;609;607;307;300
22;100704;100700;26-300;756;626;617;314;303
23;100704;100700;26-300;1142;795;787;423;364
24;100704;100700;26-300;994;629;627;409;218
25;100704;100700;26-300;1024;770;761;458;303
26;100704;100700;26-300;314;226;226;187;39
27;100704;100700;26-300;277;214;213;182;31
28;100704;100700;26-300;342;279;278;206;72
29;100704;100700;26-300;341;278;273;211;62
30;100704;100700;26-300;393;328;326;295;31
31;100704;100700;26-300;252;186;184;141;43
32;100704;100700;26-300;832;620;613;310;303
33;100704;100700;26-300;809;552;537;333;204
34;100704;100700;26-300;58;24;24;22;2
1;100705;100700;26-333;830;653;645;554;91
2;100705;100700;26-333;547;437;433;320;113
3;100705;100700;26-333;294;236;236;187;49
4;100705;100700;26-333;547;416;415;378;37
5;100705;100700;26-333;1015;775;771;677;94
1;100706;100700;26-315;1127;859;852;621;231
2;100706;100700;26-315;618;497;494;408;86
3;100706;100700;26-315;514;394;389;330;59
4;100706;100700;26-315;224;175;173;148;25
1;100707;100700;26-332;429;320;319;267;52
2;100707;100700;26-332;299;225;222;171;51
3;100707;100700;26-332;504;367;365;282;83
4;100707;100700;26-332;787;606;601;459;142
5;100707;100700;26-332;815;595;593;474;119
6;100707;100700;26-332;766;602;593;521;72
7;100707;100700;26-332;643;511;507;431;76
8;100707;100700;26-332;285;232;231;181;50
9;100707;100700;26-332;439;336;331;278;53
10;100707;100700;26-332;312;216;213;182;31
11;100707;100700;26-332;462;354;349;303;46
1;100708;100700;26-330;440;325;323;209;114
2;100708;100700;26-330;551;415;408;261;147
3;100708;100700;26-330;641;472;466;378;88
4;100708;100700;26-330;347;232;232;146;86
5;100708;100700;26-330;628;436;433;349;84
6;100708;100700;26-330;482;353;348;286;62
7;100708;100700;26-330;484;346;343;273;70
8;100708;100700;26-330;318;214;211;185;26
9;100708;100700;26-330;164;104;104;89;15
10;100708;100700;26-330;199;151;151;135;16
11;100708;100700;26-330;185;133;133;118;15
12;100708;100700;26-330;90;53;53;43;10
1;100801;100800;95-050;1848;1511;1503;562;941
2;100801;100800;95-050;972;726;719;316;403
3;100801;100800;95-050;2174;1619;1596;631;965
4;100801;100800;95-050;1536;1148;1134;468;666
5;100801;100800;95-050;816;595;592;260;332
6;100801;100800;95-050;1643;1219;1204;566;638
7;100801;100800;95-050;1658;1100;1091;474;617
8;100801;100800;95-050;1529;1110;1099;490;609
9;100801;100800;95-050;593;461;458;192;266
10;100801;100800;95-050;470;377;373;139;234
11;100801;100800;95-050;1131;881;877;417;460
12;100801;100800;95-050;92;24;21;8;13
13;100801;100800;95-050;65;16;16;3;13
1;100802;100800;95-200;2464;1916;1890;872;1018
2;100802;100800;95-200;889;640;631;258;373
3;100802;100800;95-200;1707;1294;1286;481;805
4;100802;100800;95-200;2045;1579;1564;597;967
5;100802;100800;95-200;1965;1450;1438;510;928
6;100802;100800;95-200;913;698;690;282;408
7;100802;100800;95-200;2174;1457;1441;654;787
8;100802;100800;95-200;1864;1314;1295;541;754
9;100802;100800;95-200;1888;1365;1353;577;776
10;100802;100800;95-200;1901;1409;1391;555;836
11;100802;100800;95-200;1777;1265;1248;530;718
12;100802;100800;95-200;1605;1051;1035;461;574
13;100802;100800;95-200;1979;1499;1491;623;868
14;100802;100800;95-200;1941;1515;1503;609;894
15;100802;100800;95-200;2006;1530;1515;636;879
16;100802;100800;95-200;2573;1992;1967;833;1134
17;100802;100800;95-200;1677;1283;1275;575;700
18;100802;100800;95-200;843;535;529;243;286
19;100802;100800;95-200;1076;749;738;331;407
20;100802;100800;95-200;1951;1420;1403;635;768
21;100802;100800;95-200;1873;1424;1413;600;813
22;100802;100800;95-200;1762;1366;1355;578;777
23;100802;100800;95-200;2518;1873;1862;830;1032
24;100802;100800;95-200;1951;1510;1496;577;919
25;100802;100800;95-200;801;625;622;271;351
26;100802;100800;95-200;1156;801;792;350;442
27;100802;100800;95-200;305;123;123;63;60
28;100802;100800;95-200;117;50;46;24;22
29;100802;100800;95-200;68;28;26;16;10
1;100803;100800;95-081;814;587;579;324;255
2;100803;100800;95-081;950;692;687;439;248
3;100803;100800;95-081;464;372;370;211;159
4;100803;100800;95-081;863;672;668;437;231
5;100803;100800;95-081;800;640;632;299;333
1;100804;100800;95-082;1678;1293;1279;559;720
2;100804;100800;95-082;850;639;629;330;299
3;100804;100800;95-082;873;671;662;295;367
4;100804;100800;95-082;1128;792;780;421;359
5;100804;100800;95-082;520;374;371;222;149
6;100804;100800;95-082;1221;920;909;525;384
1;100805;100800;95-054;901;673;665;283;382
2;100805;100800;95-054;1280;1022;1011;409;602
3;100805;100800;95-054;1358;1047;1037;487;550
4;100805;100800;95-054;1154;927;916;363;553
5;100805;100800;95-054;796;618;613;281;332
6;100805;100800;95-054;577;442;440;224;216
1;100806;100800;95-083;1879;1425;1406;779;627
2;100806;100800;95-083;1614;1279;1261;507;754
3;100806;100800;95-083;1819;1404;1393;724;669
4;100806;100800;95-083;702;486;480;251;229
5;100806;100800;95-083;692;476;472;286;186
6;100806;100800;95-083;793;639;634;256;378
7;100806;100800;95-083;33;5;5;3;2
1;100807;100800;95-200;1581;1324;1309;665;644
2;100807;100800;95-200;1075;857;844;414;430
3;100807;100800;95-200;1455;1120;1100;540;560
4;100807;100800;95-200;1600;1289;1278;541;737
5;100807;100800;95-200;765;596;593;322;271
1;100901;100900;98-355;1865;1290;1277;844;433
2;100901;100900;98-355;600;442;439;293;146
3;100901;100900;98-355;1046;753;747;581;166
4;100901;100900;98-355;2005;1341;1324;826;498
5;100901;100900;98-355;738;558;552;446;106
6;100901;100900;98-355;1324;1009;998;509;489
7;100901;100900;98-355;1378;963;954;557;397
8;100901;100900;98-355;30;27;27;22;5
1;100902;100900;98-358;981;746;738;534;204
2;100902;100900;98-358;519;392;389;322;67
3;100902;100900;98-358;725;506;498;367;131
4;100902;100900;98-358;801;588;582;479;103
1;100903;100900;98-331;1349;963;954;686;268
2;100903;100900;98-331;629;442;436;275;161
3;100903;100900;98-331;871;572;569;402;167
4;100903;100900;98-331;670;473;470;346;124
1;100904;100900;98-330;1088;725;718;436;282
2;100904;100900;98-330;1322;887;878;499;379
3;100904;100900;98-330;1326;940;933;707;226
4;100904;100900;98-330;1640;1155;1146;587;559
5;100904;100900;98-330;1843;1316;1300;787;513
6;100904;100900;98-330;385;252;251;173;78
7;100904;100900;98-330;566;392;389;303;86
8;100904;100900;98-330;361;242;242;200;42
9;100904;100900;98-330;63;15;14;9;5
1;100905;100900;98-332;859;650;645;455;190
2;100905;100900;98-332;767;560;556;424;132
3;100905;100900;98-332;346;259;258;208;50
4;100905;100900;98-332;326;256;254;213;41
5;100905;100900;98-332;820;578;575;459;116
6;100905;100900;98-332;315;215;214;184;30
7;100905;100900;98-332;370;290;288;252;36
1;100906;100900;98-354;932;654;644;453;191
2;100906;100900;98-354;1074;741;740;565;175
3;100906;100900;98-354;923;652;645;519;126
4;100906;100900;98-354;683;491;485;387;98
1;100907;100900;98-337;864;621;618;422;196
2;100907;100900;98-337;1130;774;768;607;161
3;100907;100900;98-337;710;504;498;408;90
4;100907;100900;98-337;795;509;505;383;122
1;100908;100900;98-338;769;533;525;358;167
2;100908;100900;98-338;436;297;294;265;29
3;100908;100900;98-338;813;609;602;476;126
4;100908;100900;98-338;964;748;741;526;215
5;100908;100900;98-338;488;354;352;283;69
1;101001;101000;26-337;794;586;580;458;122
2;101001;101000;26-337;961;698;696;487;209
3;101001;101000;26-337;460;393;389;267;122
4;101001;101000;26-337;449;332;332;278;54
5;101001;101000;26-337;557;382;380;298;82
6;101001;101000;26-337;276;214;212;143;69
1;101002;101000;97-318;967;768;762;486;276
2;101002;101000;97-318;369;276;274;182;92
3;101002;101000;97-318;417;315;308;248;60
4;101002;101000;97-318;472;347;346;304;42
5;101002;101000;97-318;483;381;379;328;51
6;101002;101000;97-318;442;304;300;235;65
1;101003;101000;97-350;402;300;300;266;34
2;101003;101000;97-350;409;293;291;238;53
3;101003;101000;97-350;731;522;517;422;95
4;101003;101000;97-350;1025;748;746;520;226
5;101003;101000;97-350;661;484;481;314;167
6;101003;101000;97-350;472;318;317;251;66
7;101003;101000;97-350;626;458;456;380;76
8;101003;101000;97-350;866;555;549;461;88
9;101003;101000;97-350;362;265;265;207;58
10;101003;101000;97-350;346;240;239;200;39
11;101003;101000;97-350;602;451;444;296;148
1;101004;101000;97-306;894;673;668;562;106
2;101004;101000;97-306;683;485;482;398;84
3;101004;101000;97-306;1311;1005;998;768;230
4;101004;101000;97-306;362;279;277;214;63
5;101004;101000;97-306;890;649;643;509;134
6;101004;101000;97-306;517;370;366;253;113
1;101005;101000;97-352;651;453;447;347;100
2;101005;101000;97-352;703;480;475;418;57
3;101005;101000;97-352;824;563;559;406;153
4;101005;101000;97-352;488;355;351;290;61
1;101006;101000;97-310;721;512;506;358;148
2;101006;101000;97-310;1167;828;815;571;244
3;101006;101000;97-310;1114;759;756;518;238
4;101006;101000;97-310;801;623;617;422;195
5;101006;101000;97-310;1292;975;964;688;276
6;101006;101000;97-310;1289;936;929;785;144
7;101006;101000;97-310;1193;854;848;700;148
8;101006;101000;97-310;1502;1130;1115;664;451
9;101006;101000;97-310;588;425;420;330;90
10;101006;101000;97-310;126;46;46;25;21
1;101007;101000;97-510;553;417;415;328;87
2;101007;101000;97-510;800;553;548;336;212
3;101007;101000;97-510;691;494;491;400;91
4;101007;101000;97-510;703;530;529;423;106
1;101008;101000;97-340;1283;876;872;680;192
2;101008;101000;97-340;623;430;427;352;75
3;101008;101000;97-340;1159;860;853;694;159
4;101008;101000;97-340;1251;903;892;541;351
5;101008;101000;97-340;1470;1040;1033;781;252
6;101008;101000;97-340;1414;1039;1028;719;309
7;101008;101000;97-340;1477;1049;1038;847;191
8;101008;101000;97-340;561;417;416;314;102
9;101008;101000;97-340;95;40;36;29;7
10;101008;101000;97-340;18;18;15;12;3
1;101009;101000;97-330;1323;963;955;602;353
2;101009;101000;97-330;1439;976;970;631;339
3;101009;101000;97-330;855;526;524;433;91
4;101009;101000;97-330;491;351;346;278;68
5;101009;101000;97-330;775;567;563;385;178
6;101009;101000;97-330;921;705;699;427;272
7;101009;101000;97-330;1749;1283;1276;928;348
8;101009;101000;97-330;1215;927;917;513;404
9;101009;101000;97-330;1048;800;792;509;283
10;101009;101000;97-330;892;618;614;404;210
11;101009;101000;97-330;1513;1150;1136;726;410
12;101009;101000;97-330;453;329;326;260;66
13;101009;101000;97-330;42;31;23;17;6
1;101010;101000;97-371;1167;861;851;637;214
2;101010;101000;97-371;993;714;710;524;186
3;101010;101000;97-371;1193;809;803;688;115
4;101010;101000;97-371;545;405;405;311;94
5;101010;101000;97-371;752;531;526;445;81
6;101010;101000;97-371;734;542;539;459;80
7;101010;101000;97-371;1091;837;831;591;240
8;101010;101000;97-371;976;759;755;645;110
9;101010;101000;97-371;820;602;598;433;165
10;101010;101000;97-371;432;293;291;233;58
11;101010;101000;97-371;233;179;179;131;48
12;101010;101000;97-371;171;134;132;84;48
13;101010;101000;97-371;30;10;9;3;6
1;101011;101000;97-320;873;704;697;453;244
2;101011;101000;97-320;872;677;672;426;246
3;101011;101000;97-320;496;358;355;301;54
4;101011;101000;97-320;794;597;591;476;115
5;101011;101000;97-320;553;406;399;314;85
6;101011;101000;97-320;917;717;710;427;283
7;101011;101000;97-320;425;329;324;234;90
8;101011;101000;97-320;342;277;274;142;132
9;101011;101000;97-320;309;250;249;151;98
10;101011;101000;97-320;487;328;328;247;81
11;101011;101000;97-320;69;57;56;18;38
12;101011;101000;97-320;63;18;17;12;5
1;101101;101100;99-205;1350;982;972;619;353
2;101101;101100;99-205;518;370;365;242;123
3;101101;101100;99-205;597;418;417;243;174
4;101101;101100;99-205;388;292;289;231;58
5;101101;101100;99-205;461;341;339;212;127
1;101102;101100;99-235;1209;875;864;560;304
2;101102;101100;99-235;356;239;237;174;63
3;101102;101100;99-235;495;395;394;234;160
4;101102;101100;99-235;452;326;323;251;72
5;101102;101100;99-235;386;277;277;213;64
1;101103;101100;99-200;920;669;667;288;379
2;101103;101100;99-200;789;562;553;266;287
3;101103;101100;99-200;605;423;423;207;216
4;101103;101100;99-200;602;455;453;159;294
5;101103;101100;99-200;716;531;528;263;265
6;101103;101100;99-200;817;544;541;248;293
7;101103;101100;99-200;806;585;580;259;321
8;101103;101100;99-200;410;284;283;166;117
9;101103;101100;99-200;475;322;318;187;131
10;101103;101100;99-200;519;331;329;216;113
11;101103;101100;99-200;697;462;460;357;103
12;101103;101100;99-200;517;373;372;190;182
13;101103;101100;99-200;817;543;540;354;186
14;101103;101100;99-200;651;452;452;347;105
15;101103;101100;99-200;831;558;558;326;232
16;101103;101100;99-200;328;220;217;139;78
17;101103;101100;99-200;573;454;451;279;172
18;101103;101100;99-200;190;137;136;105;31
19;101103;101100;99-200;316;233;232;166;66
20;101103;101100;99-200;117;84;82;41;41
21;101103;101100;99-200;78;42;41;18;23
1;101104;101100;99-210;998;689;683;530;153
2;101104;101100;99-210;678;459;457;351;106
3;101104;101100;99-210;341;246;246;185;61
4;101104;101100;99-210;403;290;288;229;59
5;101104;101100;99-210;1062;765;757;396;361
6;101104;101100;99-210;1408;1062;1049;604;445
7;101104;101100;99-210;275;195;193;153;40
8;101104;101100;99-210;431;329;327;200;127
1;101105;101100;99-220;1286;850;847;549;298
2;101105;101100;99-220;402;277;276;199;77
3;101105;101100;99-220;638;419;413;304;109
4;101105;101100;99-220;393;253;251;178;73
5;101105;101100;99-220;393;280;276;224;52
6;101105;101100;99-220;442;284;282;220;62
7;101105;101100;99-220;291;182;181;141;40
8;101105;101100;99-220;605;378;370;242;128
9;101105;101100;99-220;294;173;170;135;35
10;101105;101100;99-220;56;14;13;9;4
1;101106;101100;99-232;872;608;603;389;214
2;101106;101100;99-232;551;401;397;278;119
3;101106;101100;99-232;653;464;459;316;143
4;101106;101100;99-232;611;407;406;289;117
5;101106;101100;99-232;678;435;429;302;127
6;101106;101100;99-232;460;329;329;275;54
1;101201;101200;97-500;1447;972;964;519;445
2;101201;101200;97-500;1603;1078;1066;528;538
3;101201;101200;97-500;1577;1134;1114;615;499
4;101201;101200;97-500;1497;1046;1034;536;498
5;101201;101200;97-500;1361;930;925;453;472
6;101201;101200;97-500;1842;1366;1354;616;738
7;101201;101200;97-500;1619;1182;1174;564;610
8;101201;101200;97-500;1697;1231;1218;571;647
9;101201;101200;97-500;1528;1132;1125;523;602
10;101201;101200;97-500;1112;818;810;374;436
11;101201;101200;97-500;1227;917;912;490;422
12;101201;101200;97-500;1374;1039;1025;499;526
13;101201;101200;97-500;1553;936;928;536;392
14;101201;101200;97-500;1868;1318;1308;656;652
15;101201;101200;97-500;1365;1006;994;490;504
16;101201;101200;97-500;1661;1068;1061;603;458
17;101201;101200;97-500;1590;1118;1112;539;573
18;101201;101200;97-500;1574;1131;1120;662;458
19;101201;101200;97-500;1823;1299;1289;706;583
20;101201;101200;97-500;1224;852;844;508;336
21;101201;101200;97-500;1637;1176;1165;633;532
22;101201;101200;97-500;474;317;314;187;127
23;101201;101200;97-500;51;18;18;16;2
24;101201;101200;97-500;326;115;114;67;47
1;101202;101200;97-505;1033;716;713;539;174
2;101202;101200;97-505;1178;823;817;537;280
3;101202;101200;97-505;948;720;715;373;342
4;101202;101200;97-505;196;109;109;67;42
1;101203;101200;97-540;458;271;268;198;70
2;101203;101200;97-540;618;368;366;282;84
3;101203;101200;97-540;1081;778;772;426;346
4;101203;101200;97-540;569;397;394;267;127
5;101203;101200;97-540;1017;631;620;433;187
6;101203;101200;97-540;690;466;462;251;211
7;101203;101200;97-540;222;147;146;101;45
1;101204;101200;97-545;828;582;579;378;201
2;101204;101200;97-545;988;752;737;435;302
3;101204;101200;97-545;976;684;675;431;244
4;101204;101200;97-545;341;247;245;183;62
5;101204;101200;97-545;842;615;608;464;144
6;101204;101200;97-545;240;180;179;153;26
7;101204;101200;97-545;223;133;133;83;50
1;101205;101200;97-360;857;632;629;451;178
2;101205;101200;97-360;580;478;471;310;161
3;101205;101200;97-360;239;192;190;158;32
4;101205;101200;97-360;590;386;385;331;54
5;101205;101200;97-360;647;476;470;379;91
6;101205;101200;97-360;403;279;275;206;69
7;101205;101200;97-360;493;321;319;265;54
8;101205;101200;97-360;614;450;448;318;130
1;101206;101200;97-524;1008;696;694;488;206
2;101206;101200;97-524;646;464;463;309;154
3;101206;101200;97-524;641;442;440;279;161
4;101206;101200;97-524;706;492;485;316;169
5;101206;101200;97-524;395;240;239;199;40
1;101207;101200;97-512;489;312;312;257;55
2;101207;101200;97-512;749;527;523;368;155
3;101207;101200;97-512;555;358;357;268;89
4;101207;101200;97-512;499;333;328;230;98
5;101207;101200;97-512;448;306;304;206;98
6;101207;101200;97-512;408;278;277;181;96
7;101207;101200;97-512;340;262;260;165;95
1;101208;101200;97-565;691;491;489;320;169
2;101208;101200;97-565;527;350;345;257;88
3;101208;101200;97-565;523;358;357;300;57
4;101208;101200;97-565;410;299;299;206;93
5;101208;101200;97-565;298;214;211;183;28
6;101208;101200;97-565;303;227;226;165;61
7;101208;101200;97-565;426;292;291;240;51
1;101209;101200;97-561;1338;873;869;589;280
2;101209;101200;97-561;1095;732;722;505;217
3;101209;101200;97-561;772;501;500;384;116
4;101209;101200;97-561;354;262;261;175;86
5;101209;101200;97-561;93;35;34;22;12
1;101210;101200;97-515;558;407;405;305;100
2;101210;101200;97-515;341;235;235;184;51
3;101210;101200;97-515;598;428;427;295;132
4;101210;101200;97-515;414;279;279;235;44
5;101210;101200;97-515;276;193;188;141;47
6;101210;101200;97-515;388;279;278;228;50
7;101210;101200;97-515;283;212;212;166;46
8;101210;101200;97-515;345;254;252;179;73
1;101211;101200;97-570;1289;870;865;632;233
2;101211;101200;97-570;1336;976;967;632;335
3;101211;101200;97-570;1097;750;742;628;114
4;101211;101200;97-570;724;496;491;401;90
5;101211;101200;97-570;785;550;547;324;223
6;101211;101200;97-570;81;14;11;9;2
7;101211;101200;97-570;34;8;8;5;3
1;101212;101200;97-500;522;356;353;212;141
2;101212;101200;97-500;587;440;435;316;119
3;101212;101200;97-500;662;434;428;286;142
4;101212;101200;97-500;861;607;597;342;255
5;101212;101200;97-500;617;436;433;264;169
6;101212;101200;97-500;516;344;343;224;119
7;101212;101200;97-500;433;312;309;174;135
1;101213;101200;97-525;666;474;468;373;95
2;101213;101200;97-525;299;212;212;181;31
3;101213;101200;97-525;446;275;273;213;60
4;101213;101200;97-525;748;492;488;329;159
5;101213;101200;97-525;601;400;395;328;67
6;101213;101200;97-525;473;303;301;195;106
7;101213;101200;97-525;242;173;171;146;25
1;101214;101200;97-532;1155;784;777;507;270
2;101214;101200;97-532;509;349;346;272;74
3;101214;101200;97-532;841;579;577;416;161
4;101214;101200;97-532;993;652;648;534;114
5;101214;101200;97-532;285;206;205;153;52
6;101214;101200;97-532;235;159;158;145;13
1;101301;101300;96-200;1603;1070;1067;684;383
2;101301;101300;96-200;1875;1448;1428;703;725
3;101301;101300;96-200;1580;1086;1072;615;457
4;101301;101300;96-200;1594;1227;1208;646;562
5;101301;101300;96-200;1535;1125;1120;592;528
6;101301;101300;96-200;841;666;654;363;291
7;101301;101300;96-200;1495;1118;1107;663;444
8;101301;101300;96-200;1783;1380;1366;781;585
9;101301;101300;96-200;27;8;7;4;3
1;101302;101300;96-200;981;717;711;500;211
2;101302;101300;96-230;1104;760;750;466;284
3;101302;101300;96-230;1001;627;620;486;134
4;101302;101300;96-230;1226;820;815;643;172
5;101302;101300;96-230;330;231;228;197;31
6;101302;101300;96-230;655;438;438;297;141
7;101302;101300;96-230;1239;823;809;536;273
8;101302;101300;96-230;452;332;331;269;62
9;101302;101300;96-230;301;194;193;165;28
10;101302;101300;96-230;457;329;326;233;93
11;101302;101300;96-230;355;247;245;187;58
12;101302;101300;96-230;454;324;321;247;74
1;101303;101300;96-214;1384;1011;1000;818;182
2;101303;101300;96-214;672;455;451;378;73
3;101303;101300;96-214;382;275;275;255;20
4;101303;101300;96-214;290;224;223;183;40
5;101303;101300;96-214;325;244;241;209;32
1;101304;101300;96-200;1424;992;989;747;242
2;101304;101300;96-200;1728;1203;1192;850;342
3;101304;101300;96-200;940;646;639;490;149
4;101304;101300;96-200;1335;967;956;750;206
5;101304;101300;96-200;941;708;701;512;189
6;101304;101300;96-200;406;291;289;240;49
1;101305;101300;96-232;1239;927;919;752;167
2;101305;101300;96-232;190;153;152;109;43
1;101306;101300;96-206;1691;1114;1105;886;219
2;101306;101300;96-208;1340;921;916;743;173
3;101306;101300;96-208;772;561;560;475;85
4;101306;101300;96-206;271;179;178;164;14
1;101401;101400;98-200;1246;927;919;395;524
2;101401;101400;98-200;857;554;549;306;243
3;101401;101400;98-200;1265;878;871;394;477
4;101401;101400;98-200;1243;970;956;519;437
5;101401;101400;98-200;1607;1189;1179;539;640
6;101401;101400;98-200;1550;1148;1141;529;612
7;101401;101400;98-200;1833;1391;1380;627;753
8;101401;101400;98-200;1689;1256;1238;631;607
9;101401;101400;98-200;1321;990;984;484;500
10;101401;101400;98-200;1329;1067;1061;414;647
11;101401;101400;98-200;1451;1097;1089;546;543
12;101401;101400;98-200;1452;1088;1078;537;541
13;101401;101400;98-200;1076;858;851;368;483
14;101401;101400;98-200;640;482;478;322;156
15;101401;101400;98-200;824;598;596;249;347
16;101401;101400;98-200;1416;1171;1160;380;780
17;101401;101400;98-200;1682;1316;1299;618;681
18;101401;101400;98-200;1286;835;827;479;348
19;101401;101400;98-200;1410;969;958;491;467
20;101401;101400;98-200;831;555;551;292;259
21;101401;101400;98-200;812;598;595;426;169
22;101401;101400;98-200;1003;660;656;383;273
23;101401;101400;98-200;1389;1040;1029;637;392
24;101401;101400;98-200;460;166;162;103;59
25;101401;101400;98-200;158;64;60;41;19
26;101401;101400;98-200;612;521;515;72;443
27;101401;101400;98-200;78;69;69;20;49
1;101402;101400;98-235;1460;999;992;604;388
2;101402;101400;98-235;714;503;500;419;81
3;101402;101400;98-235;1462;1000;993;758;235
4;101402;101400;98-235;1063;718;711;550;161
5;101402;101400;98-235;650;461;458;348;110
6;101402;101400;98-235;641;465;461;359;102
7;101402;101400;98-235;758;492;487;373;114
8;101402;101400;98-235;835;518;508;391;117
9;101402;101400;98-235;635;459;451;297;154
10;101402;101400;98-235;1380;956;939;695;244
11;101402;101400;98-235;830;522;520;391;129
12;101402;101400;98-235;382;254;252;211;41
1;101403;101400;98-277;1376;963;954;792;162
2;101403;101400;98-277;427;308;306;260;46
3;101403;101400;98-277;987;680;674;554;120
4;101403;101400;98-277;542;352;348;307;41
1;101404;101400;98-275;1205;855;848;519;329
2;101404;101400;98-275;1120;736;726;453;273
3;101404;101400;98-275;955;647;640;410;230
4;101404;101400;98-275;872;604;599;489;110
5;101404;101400;98-275;714;490;487;357;130
1;101405;101400;98-260;734;536;531;296;235
2;101405;101400;98-260;558;381;380;307;73
3;101405;101400;98-260;651;410;408;305;103
4;101405;101400;98-260;336;220;217;160;57
5;101405;101400;98-260;495;294;290;231;59
6;101405;101400;98-260;414;282;281;179;102
7;101405;101400;98-260;445;330;329;214;115
8;101405;101400;98-260;336;232;230;188;42
9;101405;101400;98-260;220;160;158;135;23
1;101406;101400;98-215;1312;881;875;625;250
2;101406;101400;98-215;818;540;533;441;92
3;101406;101400;98-215;495;288;287;239;48
4;101406;101400;98-215;585;389;382;283;99
5;101406;101400;98-215;259;167;166;147;19
6;101406;101400;98-215;296;202;201;169;32
7;101406;101400;98-215;288;185;184;166;18
1;101407;101400;98-273;396;301;301;204;97
2;101407;101400;98-273;584;390;386;292;94
3;101407;101400;98-273;329;225;222;200;22
4;101407;101400;98-273;506;355;349;307;42
5;101407;101400;98-273;338;232;231;184;47
1;101408;101400;98-200;954;690;687;494;193
2;101408;101400;98-200;1635;1201;1194;848;346
3;101408;101400;98-200;1367;1015;1007;656;351
4;101408;101400;98-200;1119;805;796;542;254
5;101408;101400;98-200;1074;796;795;596;199
6;101408;101400;98-200;1351;1017;1008;592;416
7;101408;101400;98-200;713;546;543;339;204
8;101408;101400;98-200;58;15;15;7;8
1;101409;101400;98-290;995;678;671;401;270
2;101409;101400;98-290;1262;902;886;543;343
3;101409;101400;98-290;701;467;464;340;124
4;101409;101400;98-290;614;431;430;350;80
5;101409;101400;98-290;1041;665;657;548;109
6;101409;101400;98-290;722;490;486;335;151
7;101409;101400;98-290;607;399;397;298;99
8;101409;101400;98-290;638;435;433;320;113
9;101409;101400;98-290;1368;964;955;653;302
10;101409;101400;98-290;769;552;546;414;132
11;101409;101400;98-290;622;426;425;336;89
12;101409;101400;98-290;359;106;103;73;30
1;101410;101400;98-285;1623;1161;1152;813;339
2;101410;101400;98-285;1112;739;729;527;202
3;101410;101400;98-285;1266;844;838;637;201
4;101410;101400;98-285;606;477;475;391;84
1;101411;101400;98-270;1448;968;950;607;343
2;101411;101400;98-270;1127;766;754;517;237
3;101411;101400;98-270;349;235;235;187;48
4;101411;101400;98-270;751;503;500;400;100
5;101411;101400;98-270;382;267;264;232;32
6;101411;101400;98-270;765;518;514;392;122
7;101411;101400;98-270;610;418;415;347;68
8;101411;101400;98-270;29;13;11;6;5
1;101501;101500;99-417;1041;793;786;499;287
2;101501;101500;99-417;454;325;325;207;118
3;101501;101500;99-417;412;278;277;213;64
4;101501;101500;99-417;459;320;320;249;71
5;101501;101500;99-417;721;514;506;309;197
1;101502;101500;96-130;639;512;508;434;74
2;101502;101500;96-130;1516;1164;1150;902;248
3;101502;101500;96-130;478;380;379;324;55
4;101502;101500;96-130;1677;1327;1319;1183;136
1;101503;101500;96-126;1406;1046;1034;833;201
2;101503;101500;96-126;583;453;452;360;92
1;101504;101500;96-111;659;465;463;304;159
2;101504;101500;96-111;515;365;363;268;95
3;101504;101500;96-111;404;276;276;174;102
4;101504;101500;96-111;218;156;154;115;39
5;101504;101500;96-111;468;350;348;245;103
1;101505;101500;96-127;1559;1204;1193;837;356
2;101505;101500;96-127;497;372;371;323;48
3;101505;101500;96-127;431;311;311;267;44
1;101506;101500;96-124;1621;1239;1225;869;356
2;101506;101500;96-124;831;601;594;394;200
3;101506;101500;96-124;714;539;533;415;118
4;101506;101500;96-124;524;352;352;268;84
5;101506;101500;99-420;526;401;401;324;77
6;101506;101500;96-124;486;345;344;262;82
1;101507;101500;96-115;786;541;534;385;149
2;101507;101500;96-115;641;460;456;356;100
3;101507;101500;96-115;675;509;501;365;136
4;101507;101500;96-115;611;467;463;301;162
1;101508;101500;96-116;646;490;487;346;141
2;101508;101500;96-100;850;622;614;372;242
3;101508;101500;96-100;845;607;595;333;262
4;101508;101500;96-100;672;480;478;366;112
5;101508;101500;96-100;602;422;421;274;147
6;101508;101500;96-116;423;310;309;257;52
7;101508;101500;96-100;576;450;445;323;122
8;101508;101500;96-100;732;543;532;342;190
9;101508;101500;96-100;535;405;399;266;133
1;101509;101500;96-128;715;548;543;458;85
2;101509;101500;96-128;715;544;541;406;135
3;101509;101500;96-128;255;207;207;177;30
4;101509;101500;96-128;237;170;167;131;36
1;101601;101600;97-200;1844;1329;1315;650;665
2;101601;101600;97-200;1850;1241;1237;750;487
3;101601;101600;97-200;1805;1293;1285;616;669
4;101601;101600;97-200;1775;1165;1158;670;488
5;101601;101600;97-200;1956;1341;1324;685;639
6;101601;101600;97-200;1791;1262;1253;644;609
7;101601;101600;97-200;1791;1228;1222;729;493
8;101601;101600;97-200;1776;1248;1234;605;629
9;101601;101600;97-200;1967;1458;1443;668;775
10;101601;101600;97-200;2161;1627;1614;908;706
11;101601;101600;97-200;1696;1033;1028;613;415
12;101601;101600;97-200;2187;1462;1447;730;717
13;101601;101600;97-200;1778;1405;1397;679;718
14;101601;101600;97-200;1532;1159;1146;528;618
15;101601;101600;97-200;1751;1208;1198;579;619
16;101601;101600;97-200;1797;1331;1316;649;667
17;101601;101600;97-200;1877;1337;1323;659;664
18;101601;101600;97-200;1916;1459;1450;699;751
19;101601;101600;97-200;1671;1274;1264;595;669
20;101601;101600;97-200;1971;1546;1533;671;862
21;101601;101600;97-200;1729;1279;1275;580;695
22;101601;101600;97-200;2075;1490;1473;953;520
23;101601;101600;97-200;2176;1727;1717;888;829
24;101601;101600;97-200;178;99;95;62;33
25;101601;101600;97-200;69;23;21;12;9
26;101601;101600;97-200;67;33;33;20;13
27;101601;101600;97-200;102;40;38;27;11
28;101601;101600;97-200;21;14;14;9;5
29;101601;101600;97-200;47;7;7;2;5
1;101602;101600;97-319;716;535;525;355;170
2;101602;101600;97-319;1016;776;773;616;157
3;101602;101600;97-319;655;480;476;382;94
4;101602;101600;97-319;197;163;162;135;27
1;101603;101600;97-212;740;518;514;323;191
2;101603;101600;97-212;502;375;375;324;51
3;101603;101600;97-212;401;284;283;229;54
1;101604;101600;97-216;1010;755;749;573;176
2;101604;101600;97-216;1039;742;737;620;117
3;101604;101600;97-216;848;606;604;493;111
4;101604;101600;97-216;964;701;696;538;158
1;101605;101600;97-215;1244;937;930;498;432
2;101605;101600;97-215;624;457;451;287;164
3;101605;101600;97-215;677;499;496;397;99
4;101605;101600;97-215;610;432;430;184;246
1;101606;101600;97-217;611;468;465;356;109
2;101606;101600;97-217;377;285;282;241;41
3;101606;101600;97-217;776;538;537;383;154
4;101606;101600;97-217;487;356;356;322;34
5;101606;101600;97-217;353;253;249;204;45
6;101606;101600;97-217;358;292;292;160;132
7;101606;101600;97-217;1122;843;831;675;156
8;101606;101600;97-217;363;274;274;217;57
9;101606;101600;97-217;332;261;259;212;47
10;101606;101600;97-217;532;401;398;308;90
1;101607;101600;97-221;1630;1281;1265;790;475
2;101607;101600;97-221;637;501;495;378;117
3;101607;101600;97-221;689;472;470;332;138
4;101607;101600;97-221;915;670;663;412;251
5;101607;101600;97-221;511;370;368;222;146
6;101607;101600;97-221;418;333;330;212;118
1;101608;101600;97-220;1075;806;803;696;107
2;101608;101600;97-220;857;601;600;542;58
3;101608;101600;97-220;990;713;706;513;193
4;101608;101600;97-220;732;546;540;406;134
1;101609;101600;97-200;1016;746;735;537;198
2;101609;101600;97-200;1318;988;977;612;365
3;101609;101600;97-200;452;338;336;247;89
4;101609;101600;97-213;937;755;752;453;299
5;101609;101600;97-213;986;756;751;473;278
6;101609;101600;97-213;501;399;398;285;113
7;101609;101600;97-200;531;382;379;282;97
8;101609;101600;97-200;897;672;667;316;351
9;101609;101600;97-200;625;472;467;367;100
10;101609;101600;97-200;233;194;191;115;76
11;101609;101600;97-200;654;487;484;344;140
12;101609;101600;97-200;296;236;235;146;89
13;101609;101600;97-200;322;274;274;169;105
1;101610;101600;97-225;930;724;720;420;300
2;101610;101600;97-225;359;268;266;165;101
3;101610;101600;97-225;721;551;540;426;114
4;101610;101600;97-225;888;628;624;439;185
5;101610;101600;97-225;777;539;536;330;206
6;101610;101600;97-225;678;515;511;322;189
7;101610;101600;97-225;286;198;196;111;85
8;101610;101600;97-225;394;298;295;188;107
9;101610;101600;97-225;306;237;234;175;59
10;101610;101600;97-225;424;318;313;212;101
1;101611;101600;97-226;423;330;327;235;92
2;101611;101600;97-226;776;561;559;452;107
3;101611;101600;97-226;496;403;397;358;39
4;101611;101600;97-226;438;296;295;243;52
5;101611;101600;97-226;380;275;273;221;52
1;101701;101700;98-350;569;365;360;223;137
2;101701;101700;98-350;246;167;166;114;52
3;101701;101700;98-350;598;414;409;247;162
4;101701;101700;98-350;148;87;87;54;33
5;101701;101700;98-350;642;429;426;321;105
6;101701;101700;98-350;566;398;398;296;102
7;101701;101700;98-350;1014;666;656;505;151
8;101701;101700;98-350;325;228;227;140;87
1;101702;101700;98-310;1185;829;820;529;291
2;101702;101700;98-310;466;312;311;228;83
3;101702;101700;98-310;704;486;483;305;178
4;101702;101700;98-310;366;256;252;185;67
5;101702;101700;98-310;428;318;314;219;95
6;101702;101700;98-310;249;189;188;132;56
1;101703;101700;98-313;908;650;641;345;296
2;101703;101700;98-313;663;477;474;337;137
3;101703;101700;98-313;653;474;472;308;164
4;101703;101700;98-313;170;121;121;106;15
5;101703;101700;98-313;242;171;170;129;41
6;101703;101700;98-313;315;234;228;169;59
1;101704;101700;98-345;1167;755;746;472;274
2;101704;101700;98-345;392;278;273;220;53
3;101704;101700;98-345;726;485;477;316;161
4;101704;101700;98-345;734;509;503;377;126
5;101704;101700;98-345;738;504;502;318;184
6;101704;101700;98-345;269;215;214;168;46
1;101705;101700;98-320;658;481;475;336;139
2;101705;101700;98-320;423;275;275;220;55
3;101705;101700;98-320;427;308;304;230;74
4;101705;101700;98-320;530;395;389;328;61
5;101705;101700;98-320;515;361;360;286;74
6;101705;101700;98-320;1046;809;800;497;303
1;101706;101700;98-311;833;564;559;379;180
2;101706;101700;98-311;592;391;390;311;79
3;101706;101700;98-311;361;233;232;189;43
4;101706;101700;98-311;707;487;480;302;178
5;101706;101700;98-311;548;387;387;265;122
6;101706;101700;98-311;301;225;221;149;72
7;101706;101700;98-311;76;49;45;31;14
1;101707;101700;98-335;380;268;265;222;43
2;101707;101700;98-335;806;587;581;452;129
3;101707;101700;98-335;517;374;369;290;79
4;101707;101700;98-335;310;194;194;128;66
5;101707;101700;98-335;453;326;323;208;115
6;101707;101700;98-335;1111;800;795;543;252
7;101707;101700;98-335;410;285;282;205;77
8;101707;101700;98-335;642;449;446;352;94
9;101707;101700;98-335;319;244;243;182;61
10;101707;101700;98-335;75;46;45;39;6
1;101708;101700;98-346;1241;885;874;551;323
2;101708;101700;98-346;464;325;323;247;76
3;101708;101700;98-346;538;327;325;234;91
4;101708;101700;98-346;221;139;138;92;46
1;101709;101700;98-300;1288;928;918;387;531
2;101709;101700;98-300;1232;895;884;364;520
3;101709;101700;98-300;920;631;622;252;370
4;101709;101700;98-300;1071;783;773;312;461
5;101709;101700;98-300;1076;721;714;323;391
6;101709;101700;98-300;1505;1096;1089;491;598
7;101709;101700;98-300;979;679;675;270;405
8;101709;101700;98-300;1186;831;823;414;409
9;101709;101700;98-300;926;613;607;272;335
10;101709;101700;98-300;985;726;723;320;403
11;101709;101700;98-300;861;635;630;254;376
12;101709;101700;98-300;1046;787;781;346;435
13;101709;101700;98-300;918;633;630;288;342
14;101709;101700;98-300;876;643;635;287;348
15;101709;101700;98-300;887;611;606;283;323
16;101709;101700;98-300;1119;851;843;428;415
17;101709;101700;98-300;643;476;474;379;95
18;101709;101700;98-300;664;455;451;276;175
19;101709;101700;98-300;1041;698;696;469;227
20;101709;101700;98-300;524;338;338;249;89
21;101709;101700;98-300;1357;928;921;564;357
22;101709;101700;98-300;846;591;585;294;291
23;101709;101700;98-300;394;293;290;193;97
24;101709;101700;98-300;163;119;116;78;38
25;101709;101700;98-300;352;228;225;154;71
26;101709;101700;98-300;77;46;46;28;18
27;101709;101700;98-300;38;17;16;11;5
1;101710;101700;98-324;1421;947;941;582;359
2;101710;101700;98-324;860;572;567;361;206
3;101710;101700;98-324;431;304;300;145;155
4;101710;101700;98-324;804;570;563;389;174
5;101710;101700;98-324;461;301;301;214;87
6;101710;101700;98-324;570;370;370;249;121
7;101710;101700;98-324;355;250;248;184;64
8;101710;101700;98-324;233;186;185;110;75
1;101801;101800;98-430;1188;805;799;475;324
2;101801;101800;98-430;499;328;321;211;110
3;101801;101800;98-430;633;363;357;237;120
4;101801;101800;98-430;678;423;416;327;89
1;101802;101800;98-410;1372;907;902;610;292
2;101802;101800;98-410;926;551;543;359;184
3;101802;101800;98-410;436;284;284;223;61
4;101802;101800;98-410;337;267;265;184;81
1;101803;101800;98-405;1272;835;826;498;328
2;101803;101800;98-405;674;483;479;336;143
3;101803;101800;98-405;622;412;410;292;118
4;101803;101800;98-405;1075;681;676;515;161
5;101803;101800;98-405;374;236;235;154;81
6;101803;101800;98-405;255;173;173;115;58
7;101803;101800;98-405;283;187;186;114;72
8;101803;101800;98-405;186;130;130;91;39
1;101804;101800;98-360;694;489;486;278;208
2;101804;101800;98-360;617;406;400;292;108
3;101804;101800;98-360;419;288;287;212;75
4;101804;101800;98-360;414;266;263;196;67
5;101804;101800;98-360;802;551;544;433;111
6;101804;101800;98-360;461;326;322;208;114
1;101805;101800;98-432;890;579;570;348;222
2;101805;101800;98-432;768;511;509;336;173
3;101805;101800;98-432;812;541;525;365;160
4;101805;101800;98-432;389;253;251;182;69
5;101805;101800;98-432;256;162;161;113;48
1;101806;101800;98-420;1333;921;913;567;346
2;101806;101800;98-420;670;465;464;313;151
3;101806;101800;98-420;735;498;494;320;174
4;101806;101800;98-420;711;485;482;351;131
5;101806;101800;98-420;578;374;373;231;142
1;101807;101800;98-400;1012;729;720;376;344
2;101807;101800;98-400;1421;1019;1008;512;496
3;101807;101800;98-400;974;657;649;302;347
4;101807;101800;98-400;1124;769;762;358;404
5;101807;101800;98-400;1214;886;878;389;489
6;101807;101800;98-400;501;376;372;148;224
7;101807;101800;98-400;777;524;519;363;156
8;101807;101800;98-400;898;606;598;364;234
9;101807;101800;98-400;906;617;614;358;256
10;101807;101800;98-400;442;311;307;214;93
11;101807;101800;98-400;583;404;398;201;197
12;101807;101800;98-400;865;578;576;375;201
13;101807;101800;98-400;15;15;15;11;4
1;101901;101900;98-220;1257;742;738;395;343
2;101901;101900;98-220;1190;819;815;453;362
3;101901;101900;98-220;1118;807;801;356;445
4;101901;101900;98-220;1510;1103;1100;500;600
5;101901;101900;98-220;1560;1117;1099;518;581
6;101901;101900;98-220;1410;1039;1032;561;471
7;101901;101900;98-220;1355;1000;990;466;524
8;101901;101900;98-220;1438;1015;1003;572;431
9;101901;101900;98-220;1338;833;828;460;368
10;101901;101900;98-220;1328;968;956;495;461
11;101901;101900;98-220;1359;982;973;465;508
12;101901;101900;98-220;1375;993;987;505;482
13;101901;101900;98-220;1371;918;916;489;427
14;101901;101900;98-220;1307;947;942;468;474
15;101901;101900;98-220;1381;996;983;516;467
16;101901;101900;98-220;1465;1106;1095;525;570
17;101901;101900;98-220;1287;973;969;530;439
18;101901;101900;98-220;1275;897;885;445;440
19;101901;101900;98-220;1826;1399;1387;674;713
20;101901;101900;98-220;1488;1064;1055;635;420
21;101901;101900;98-220;1408;1053;1046;589;457
22;101901;101900;98-220;69;28;28;19;9
23;101901;101900;98-220;63;29;29;15;14
1;101902;101900;98-240;1421;1002;995;610;385
2;101902;101900;98-240;785;553;548;385;163
3;101902;101900;98-240;773;541;535;373;162
4;101902;101900;98-240;558;391;389;295;94
5;101902;101900;98-240;464;341;340;257;83
6;101902;101900;98-240;314;231;229;175;54
7;101902;101900;98-240;1184;872;864;556;308
8;101902;101900;98-240;25;12;11;10;1
1;101903;101900;98-161;1561;1130;1121;679;442
2;101903;101900;98-161;824;581;574;323;251
3;101903;101900;98-161;677;455;451;298;153
4;101903;101900;98-161;639;459;453;336;117
5;101903;101900;98-161;460;333;328;217;111
1;101904;101900;98-220;936;710;709;437;272
2;101904;101900;98-220;1563;1138;1127;654;473
3;101904;101900;98-220;1341;938;928;598;330
4;101904;101900;98-220;884;595;591;404;187
5;101904;101900;98-220;2288;1685;1661;974;687
6;101904;101900;98-220;1288;976;958;613;345
7;101904;101900;98-220;1034;707;702;484;218
1;102001;102000;95-015;1572;1113;1100;546;554
2;102001;102000;95-015;1183;814;808;362;446
3;102001;102000;95-015;1351;924;913;419;494
4;102001;102000;95-015;1440;943;935;485;450
5;102001;102000;95-015;1411;978;967;449;518
6;102001;102000;95-015;789;543;538;246;292
7;102001;102000;95-015;1150;834;824;380;444
8;102001;102000;95-015;735;509;505;233;272
9;102001;102000;95-015;741;552;548;221;327
10;102001;102000;95-015;39;32;31;16;15
11;102001;102000;95-015;56;27;25;11;14
12;102001;102000;95-015;12;1;1;1;0
1;102002;102000;95-035;935;682;677;404;273
2;102002;102000;95-035;1054;775;768;378;390
3;102002;102000;95-035;879;568;560;303;257
4;102002;102000;95-035;918;675;665;308;357
5;102002;102000;95-035;946;725;721;374;347
6;102002;102000;95-035;895;652;651;318;333
7;102002;102000;95-035;876;599;589;258;331
8;102002;102000;95-035;839;535;529;279;250
9;102002;102000;95-035;816;546;544;283;261
10;102002;102000;95-035;871;664;658;314;344
11;102002;102000;95-035;887;576;570;280;290
12;102002;102000;95-035;823;527;523;280;243
13;102002;102000;95-035;861;556;551;307;244
14;102002;102000;95-035;931;688;684;402;282
15;102002;102000;95-035;1117;817;802;486;316
16;102002;102000;95-035;75;39;37;28;9
1;102003;102000;95-100;1679;1310;1290;544;746
2;102003;102000;95-100;1559;1159;1150;482;668
3;102003;102000;95-100;1534;1208;1203;491;712
4;102003;102000;95-100;1528;1182;1173;485;688
5;102003;102000;95-100;1571;1203;1196;489;707
6;102003;102000;95-100;1501;1084;1077;457;620
7;102003;102000;95-100;1755;1399;1386;549;837
8;102003;102000;95-100;889;622;617;288;329
9;102003;102000;95-100;887;623;615;254;361
10;102003;102000;95-100;860;567;561;257;304
11;102003;102000;95-100;904;702;692;263;429
12;102003;102000;95-100;912;670;661;306;355
13;102003;102000;95-100;857;574;568;261;307
14;102003;102000;95-100;1021;685;677;272;405
15;102003;102000;95-100;753;526;521;266;255
16;102003;102000;95-100;877;618;610;240;370
17;102003;102000;95-100;905;648;644;277;367
18;102003;102000;95-100;824;507;506;260;246
19;102003;102000;95-100;950;656;653;277;376
20;102003;102000;95-100;741;444;442;204;238
21;102003;102000;95-100;974;569;561;300;261
22;102003;102000;95-100;1604;1252;1239;452;787
23;102003;102000;95-100;742;555;552;207;345
24;102003;102000;95-100;973;704;697;248;449
25;102003;102000;95-100;773;612;607;234;373
26;102003;102000;95-100;919;629;623;281;342
27;102003;102000;95-100;728;516;510;222;288
28;102003;102000;95-100;1431;1078;1070;496;574
29;102003;102000;95-100;1614;1275;1259;572;687
30;102003;102000;95-100;1293;1018;996;506;490
31;102003;102000;95-100;1069;770;764;412;352
32;102003;102000;95-100;921;701;695;372;323
33;102003;102000;95-100;1054;775;772;383;389
34;102003;102000;95-100;961;709;699;336;363
35;102003;102000;95-100;1480;1118;1106;493;613
36;102003;102000;95-100;1176;973;967;329;638
37;102003;102000;95-100;360;169;168;75;93
38;102003;102000;95-100;11;7;7;1;6
39;102003;102000;95-100;169;56;54;23;31
40;102003;102000;95-100;58;33;32;23;9
41;102003;102000;95-100;36;10;10;7;3
42;102003;102000;95-100;10;6;6;3;3
1;102004;102000;95-070;2434;1818;1798;747;1051
2;102004;102000;95-070;2405;1933;1912;754;1158
3;102004;102000;95-070;2498;1833;1817;771;1046
4;102004;102000;95-070;2689;2002;1987;851;1136
5;102004;102000;95-070;2449;1765;1754;838;916
6;102004;102000;95-070;1863;1314;1301;617;684
7;102004;102000;95-070;2045;1638;1617;616;1001
8;102004;102000;95-070;2174;1828;1806;468;1338
9;102004;102000;95-070;2218;1874;1864;556;1308
10;102004;102000;95-070;1692;1287;1264;646;618
11;102004;102000;95-070;952;801;792;284;508
12;102004;102000;95-070;994;776;763;312;451
13;102004;102000;95-070;451;378;375;116;259
14;102004;102000;95-070;260;188;187;71;116
15;102004;102000;95-070;184;157;155;67;88
16;102004;102000;95-070;213;154;153;71;82
17;102004;102000;95-070;46;31;27;20;7
1;102005;102000;95-015;823;646;641;591;50
2;102005;102000;95-015;772;518;511;367;144
3;102005;102000;95-015;684;458;449;269;180
4;102005;102000;95-015;288;188;187;140;47
5;102005;102000;95-015;675;431;425;290;135
6;102005;102000;95-015;477;337;333;212;121
1;102006;102000;95-035;850;568;564;392;172
2;102006;102000;95-035;850;679;672;469;203
3;102006;102000;95-039;1165;996;989;327;662
4;102006;102000;95-035;907;676;670;477;193
5;102006;102000;95-035;1074;788;778;588;190
6;102006;102000;95-035;679;493;487;341;146
7;102006;102000;95-035;359;291;290;218;72
1;102007;102000;95-045;775;549;546;336;210
2;102007;102000;95-045;566;412;406;239;167
3;102007;102000;95-045;338;252;250;169;81
4;102007;102000;95-043;361;258;257;180;77
5;102007;102000;95-043;460;342;337;163;174
6;102007;102000;95-045;172;116;115;88;27
7;102007;102000;95-045;763;553;544;328;216
8;102007;102000;95-045;547;413;411;176;235
9;102007;102000;95-073;316;263;262;180;82
1;102008;102000;95-010;1406;986;975;480;495
2;102008;102000;95-010;1207;942;937;397;540
3;102008;102000;95-010;680;529;525;285;240
4;102008;102000;95-011;974;731;722;387;335
5;102008;102000;95-011;679;492;492;351;141
6;102008;102000;95-010;492;386;384;167;217
7;102008;102000;95-010;719;560;551;222;329
8;102008;102000;95-010;795;628;616;299;317
9;102008;102000;95-010;507;380;378;206;172
10;102008;102000;95-010;803;640;635;313;322
11;102008;102000;95-011;190;126;126;70;56
12;102008;102000;95-011;183;139;139;71;68
13;102008;102000;95-010;311;232;229;119;110
14;102008;102000;95-010;396;296;294;127;167
15;102008;102000;95-010;322;248;247;136;111
16;102008;102000;95-011;180;119;119;78;41
17;102008;102000;95-010;282;237;233;106;127
1;102009;102000;95-073;1233;937;932;309;623
2;102009;102000;95-100;1753;1287;1271;599;672
3;102009;102000;95-100;1147;918;911;311;600
4;102009;102000;95-100;1010;764;753;358;395
5;102009;102000;95-002;2203;1826;1812;610;1202
6;102009;102000;95-002;820;654;652;334;318
7;102009;102000;95-001;1412;1102;1088;578;510
8;102009;102000;95-001;940;700;694;429;265
9;102009;102000;95-001;1270;978;973;779;194
10;102009;102000;95-073;743;609;606;219;387
1;102101;102100;95-060;1627;1087;1078;642;436
2;102101;102100;95-060;1244;927;922;528;394
3;102101;102100;95-060;1135;818;813;438;375
4;102101;102100;95-060;1107;830;826;436;390
5;102101;102100;95-060;1554;1184;1176;559;617
6;102101;102100;95-060;1195;930;915;495;420
7;102101;102100;95-060;1266;849;837;494;343
8;102101;102100;95-060;83;29;28;17;11
9;102101;102100;95-060;93;58;58;36;22
1;102102;102100;95-060;247;195;189;115;74
2;102102;102100;95-060;531;412;408;223;185
3;102102;102100;95-060;931;669;667;413;254
4;102102;102100;95-060;663;519;514;343;171
5;102102;102100;95-060;494;405;400;252;148
6;102102;102100;95-060;744;578;569;307;262
7;102102;102100;95-060;285;203;200;111;89
8;102102;102100;95-060;257;168;165;122;43
9;102102;102100;95-060;192;158;155;93;62
10;102102;102100;95-060;353;270;266;170;96
1;102103;102100;95-061;503;339;337;188;149
2;102103;102100;95-061;444;298;296;219;77
3;102103;102100;95-061;416;296;296;206;90
4;102103;102100;95-061;512;352;350;264;86
5;102103;102100;95-061;400;285;283;200;83
6;102103;102100;95-061;283;207;203;119;84
7;102103;102100;95-061;397;278;275;139;136
8;102103;102100;95-061;400;287;286;208;78
9;102103;102100;95-061;189;146;146;112;34
1;102104;102100;95-047;339;219;218;145;73
2;102104;102100;95-047;320;253;253;176;77
3;102104;102100;95-047;334;253;248;165;83
4;102104;102100;95-047;291;195;194;172;22
5;102104;102100;95-047;162;121;119;82;37
6;102104;102100;95-047;254;199;196;131;65
7;102104;102100;95-047;233;175;172;140;32
8;102104;102100;95-047;436;313;313;275;38
9;102104;102100;95-047;130;94;94;82;12
10;102104;102100;95-047;59;36;34;24;10
1;102105;102100;95-063;251;173;172;148;24
2;102105;102100;95-063;463;349;345;271;74
3;102105;102100;95-063;711;499;494;342;152
4;102105;102100;95-063;688;499;493;298;195
5;102105;102100;95-063;453;347;341;174;167
6;102105;102100;95-063;505;395;392;256;136
7;102105;102100;95-063;568;386;385;264;121
1;106101;106100;91-174;1315;1110;1096;245;851
2;106101;106100;91-156;2719;2205;2189;723;1466
3;106101;106100;91-204;746;484;481;201;280
4;106101;106100;91-220;803;632;629;250;379
5;106101;106100;91-211;2194;1782;1769;578;1191
6;106101;106100;91-134;2342;1904;1896;626;1270
7;106101;106100;91-211;1941;1481;1475;530;945
8;106101;106100;91-213;2570;1942;1919;627;1292
9;106101;106100;91-134;1294;1015;1005;312;693
10;106101;106100;91-213;1851;1327;1309;455;854
11;106101;106100;91-144;2472;1929;1909;623;1286
12;106101;106100;91-140;1542;1101;1092;430;662
13;106101;106100;91-134;904;670;658;227;431
14;106101;106100;91-128;1762;1311;1298;496;802
15;106101;106100;91-103;2359;1718;1702;623;1079
16;106101;106100;91-103;1062;778;775;273;502
17;106101;106100;91-103;1381;1051;1039;360;679
18;106101;106100;91-104;1621;1232;1221;432;789
19;106101;106100;91-025;2225;1576;1559;584;975
20;106101;106100;91-025;1811;1326;1314;484;830
21;106101;106100;91-032;2500;2002;1986;661;1325
22;106101;106100;91-363;2604;1962;1933;675;1258
23;106101;106100;91-363;2316;1887;1864;520;1344
24;106101;106100;91-358;2493;1994;1971;671;1300
25;106101;106100;91-358;1430;1149;1147;300;847
26;106101;106100;91-356;2798;2327;2303;668;1635
27;106101;106100;91-496;2355;1915;1896;634;1262
28;106101;106100;91-496;1584;1272;1264;432;832
29;106101;106100;91-496;2261;1840;1829;579;1250
30;106101;106100;91-496;1532;1226;1213;446;767
31;106101;106100;91-496;1348;1088;1074;416;658
32;106101;106100;91-496;2455;2034;2021;606;1415
33;106101;106100;91-037;2678;2019;2008;682;1326
34;106101;106100;91-041;1846;1355;1337;456;881
35;106101;106100;91-335;1596;1100;1089;400;689
36;106101;106100;91-008;640;543;537;199;338
37;106101;106100;91-008;920;666;662;240;422
38;106101;106100;91-013;2062;1516;1500;526;974
39;106101;106100;91-016;1281;916;911;321;590
40;106101;106100;91-050;1889;1270;1253;488;765
41;106101;106100;91-050;1355;802;796;352;444
42;106101;106100;91-008;826;628;621;172;449
43;106101;106100;91-308;1311;919;909;353;556
44;106101;106100;91-308;1986;1438;1432;453;979
45;106101;106100;91-349;2332;1782;1763;572;1191
46;106101;106100;91-322;1533;1205;1194;394;800
47;106101;106100;91-322;2246;1734;1717;557;1160
48;106101;106100;91-304;1669;1308;1299;404;895
49;106101;106100;91-469;1559;1224;1213;401;812
50;106101;106100;91-464;2201;1734;1721;549;1172
51;106101;106100;91-464;1458;1144;1137;359;778
52;106101;106100;91-470;1654;1172;1160;415;745
53;106101;106100;91-431;1120;805;798;256;542
54;106101;106100;91-430;2058;1397;1385;534;851
55;106101;106100;91-855;2214;1697;1684;655;1029
56;106101;106100;91-845;1547;1188;1178;372;806
57;106101;106100;91-845;1570;1190;1180;359;821
58;106101;106100;91-850;2626;2006;1979;653;1326
59;106101;106100;91-431;1197;750;742;305;437
60;106101;106100;91-838;1758;1264;1248;439;809
61;106101;106100;91-818;2445;1541;1522;579;943
62;106101;106100;91-836;2145;1546;1531;544;987
63;106101;106100;91-762;1213;907;899;316;583
64;106101;106100;91-762;1719;1371;1352;440;912
65;106101;106100;91-743;485;371;365;122;243
66;106101;106100;91-744;1694;1236;1217;396;821
67;106101;106100;91-762;2832;2162;2132;697;1435
68;106101;106100;91-725;2190;1657;1635;514;1121
69;106101;106100;91-725;1052;780;776;287;489
70;106101;106100;91-520;470;361;357;147;210
71;106101;106100;91-511;844;710;707;218;489
72;106101;106100;91-527;1127;843;834;406;428
73;106101;106100;91-485;1506;1230;1222;376;846
74;106101;106100;91-480;1524;1243;1233;399;834
75;106101;106100;91-866;962;762;750;282;468
76;106101;106100;91-867;1640;1275;1261;486;775
77;106101;106100;91-503;1704;1413;1400;482;918
78;106101;106100;91-527;1751;1474;1458;437;1021
79;106101;106100;93-188;1897;1138;1125;450;675
80;106101;106100;93-590;1099;680;676;272;404
81;106101;106100;93-126;1867;1181;1162;439;723
82;106101;106100;93-126;1316;922;907;311;596
83;106101;106100;93-130;1816;1199;1192;461;731
84;106101;106100;93-188;1562;967;951;377;574
85;106101;106100;93-138;1568;1175;1161;404;757
86;106101;106100;93-590;1759;1228;1215;433;782
87;106101;106100;93-165;2055;1622;1608;525;1083
88;106101;106100;93-165;1604;1225;1212;451;761
89;106101;106100;93-144;2154;1458;1446;607;839
90;106101;106100;93-144;2031;1474;1463;591;872
91;106101;106100;93-161;1460;1074;1061;382;679
92;106101;106100;93-154;2203;1638;1624;519;1105
93;106101;106100;93-259;1574;1182;1170;490;680
94;106101;106100;93-236;1539;1081;1078;427;651
95;106101;106100;93-236;1390;1001;990;360;630
96;106101;106100;93-267;1180;830;820;344;476
97;106101;106100;93-267;1731;1257;1244;453;791
98;106101;106100;93-203;1542;1207;1199;485;714
99;106101;106100;93-262;1736;1260;1252;406;846
100;106101;106100;93-262;1811;1279;1272;538;734
101;106101;106100;93-248;1189;902;891;333;558
102;106101;106100;93-248;1677;1218;1206;497;709
103;106101;106100;93-279;2287;1672;1657;588;1069
104;106101;106100;93-213;2007;1504;1496;587;909
105;106101;106100;93-224;1754;1318;1304;485;819
106;106101;106100;93-224;1259;919;906;334;572
107;106101;106100;93-645;861;677;665;278;387
108;106101;106100;93-323;1598;1256;1247;486;761
109;106101;106100;93-321;2605;2087;2069;781;1288
110;106101;106100;93-321;2805;2100;2081;770;1311
111;106101;106100;93-323;2766;2189;2170;797;1373
112;106101;106100;93-303;2220;1683;1668;616;1052
113;106101;106100;93-379;2414;1786;1769;735;1034
114;106101;106100;93-379;2003;1599;1583;562;1021
115;106101;106100;93-319;1518;1149;1138;425;713
116;106101;106100;93-319;2081;1693;1677;549;1128
117;106101;106100;93-356;1263;1024;1022;359;663
118;106101;106100;93-345;2573;2146;2130;580;1550
119;106101;106100;93-460;893;671;666;313;353
120;106101;106100;93-490;1003;757;749;263;486
121;106101;106100;93-491;2083;1617;1599;587;1012
122;106101;106100;93-479;1590;1310;1298;455;843
123;106101;106100;93-479;1462;1209;1198;406;792
124;106101;106100;93-502;1088;844;835;293;542
125;106101;106100;93-552;2161;1607;1591;557;1034
126;106101;106100;93-558;2727;2009;1986;736;1250
127;106101;106100;93-502;761;434;430;192;238
128;106101;106100;93-535;1634;1230;1214;443;771
129;106101;106100;93-535;1403;989;978;385;593
130;106101;106100;93-533;956;701;690;261;429
131;106101;106100;93-533;1924;1283;1271;483;788
132;106101;106100;93-510;1286;940;926;368;558
133;106101;106100;93-025;1141;863;853;309;544
134;106101;106100;93-009;2162;1567;1553;602;951
135;106101;106100;93-009;1801;1209;1187;459;728
136;106101;106100;93-510;1519;1158;1143;401;742
137;106101;106100;93-436;2103;1612;1598;589;1009
138;106101;106100;93-429;1675;1255;1241;496;745
139;106101;106100;93-423;1297;881;871;335;536
140;106101;106100;94-459;1855;1457;1440;448;992
141;106101;106100;93-429;1531;1180;1171;337;834
142;106101;106100;93-642;782;628;622;256;366
143;106101;106100;93-645;2367;1878;1858;944;914
144;106101;106100;94-304;1796;1444;1429;432;997
145;106101;106100;94-203;1077;862;857;229;628
146;106101;106100;94-203;1226;956;941;300;641
147;106101;106100;91-078;2616;1952;1929;684;1245
148;106101;106100;91-087;2144;1674;1657;555;1102
149;106101;106100;91-078;1259;961;953;367;586
150;106101;106100;91-078;1237;920;911;367;544
151;106101;106100;90-734;1823;1125;1112;399;713
152;106101;106100;90-755;2261;1546;1531;493;1038
153;106101;106100;90-734;2258;1385;1365;508;857
154;106101;106100;90-559;1802;1298;1282;479;803
155;106101;106100;90-745;1634;1092;1078;401;677
156;106101;106100;90-734;2209;1457;1444;513;931
157;106101;106100;90-513;725;457;450;53;397
158;106101;106100;90-513;1076;666;661;269;392
159;106101;106100;90-734;1077;720;716;265;451
160;106101;106100;90-745;1244;819;811;312;499
161;106101;106100;90-528;1565;1104;1097;342;755
162;106101;106100;90-542;2185;1658;1632;549;1083
163;106101;106100;90-559;1217;803;794;274;520
164;106101;106100;90-561;2643;2084;2060;591;1469
165;106101;106100;90-509;1618;1095;1087;375;712
166;106101;106100;94-050;2408;2083;2064;520;1544
167;106101;106100;94-102;1341;1061;1053;354;699
168;106101;106100;94-050;1416;1123;1114;313;801
169;106101;106100;94-050;1383;1130;1121;368;753
170;106101;106100;94-054;1462;1109;1096;349;747
171;106101;106100;94-054;1846;1434;1418;410;1008
172;106101;106100;94-054;1663;1307;1297;414;883
173;106101;106100;94-054;1632;1249;1240;372;868
174;106101;106100;94-054;1409;1128;1117;349;768
175;106101;106100;94-056;1697;1331;1321;439;882
176;106101;106100;94-050;1351;1307;1284;416;868
177;106101;106100;94-050;1628;1270;1259;429;830
178;106101;106100;94-017;1748;1376;1361;469;892
179;106101;106100;94-029;2537;1961;1944;655;1289
180;106101;106100;94-029;1409;1039;1030;335;695
181;106101;106100;94-035;2670;2090;2064;670;1394
182;106101;106100;94-043;2478;1945;1928;652;1276
183;106101;106100;94-003;1472;1162;1147;375;772
184;106101;106100;94-003;1935;1546;1535;463;1072
185;106101;106100;94-107;1332;1013;1002;356;646
186;106101;106100;94-107;1580;1208;1200;370;830
187;106101;106100;94-056;1627;1255;1244;408;836
188;106101;106100;94-107;1630;1332;1322;406;916
189;106101;106100;94-043;1132;893;888;268;620
190;106101;106100;94-058;1249;993;989;306;683
191;106101;106100;94-058;1676;1330;1317;448;869
192;106101;106100;94-042;2733;2137;2118;684;1434
193;106101;106100;94-052;2695;2274;2258;584;1674
194;106101;106100;94-119;1702;1434;1416;375;1041
195;106101;106100;93-469;610;454;448;190;258
196;106101;106100;94-231;3115;2654;2621;694;1927
197;106101;106100;94-231;2882;2386;2363;772;1591
198;106101;106100;91-129;2635;2150;2141;704;1437
199;106101;106100;93-005;1549;1161;1155;361;794
200;106101;106100;90-301;1202;821;815;278;537
201;106101;106100;90-303;2208;1871;1853;445;1408
202;106101;106100;90-302;959;587;582;230;352
203;106101;106100;90-301;1267;998;988;271;717
204;106101;106100;90-301;862;616;611;166;445
205;106101;106100;90-301;715;501;492;167;325
206;106101;106100;90-514;1372;1005;995;301;694
207;106101;106100;90-009;2524;1879;1856;553;1303
208;106101;106100;90-012;252;137;137;50;87
209;106101;106100;90-012;936;679;675;266;409
210;106101;106100;90-111;657;438;436;158;278
211;106101;106100;90-111;1871;1199;1184;467;717
212;106101;106100;90-252;2026;1204;1188;523;665
213;106101;106100;90-135;722;489;484;161;323
214;106101;106100;90-721;1366;856;845;310;535
215;106101;106100;90-707;1644;994;984;384;600
216;106101;106100;91-416;1987;1212;1199;468;731
217;106101;106100;90-202;862;541;530;207;323
218;106101;106100;90-207;1220;742;737;267;470
219;106101;106100;90-252;2107;1463;1446;505;941
220;106101;106100;91-409;1152;780;770;295;475
221;106101;106100;90-212;819;644;642;181;461
222;106101;106100;90-229;1124;849;843;267;576
223;106101;106100;90-228;1178;812;805;256;549
224;106101;106100;91-402;1890;1475;1453;430;1023
225;106101;106100;90-132;1637;1256;1243;346;897
226;106101;106100;90-147;1357;1114;1100;274;826
227;106101;106100;90-147;1058;882;872;210;662
228;106101;106100;91-404;2247;1782;1774;562;1212
229;106101;106100;92-538;2100;1638;1628;515;1113
230;106101;106100;92-538;1722;1318;1301;462;839
231;106101;106100;92-538;1816;1510;1494;538;956
232;106101;106100;92-504;2406;1803;1778;594;1184
233;106101;106100;92-504;2513;2005;1994;615;1379
234;106101;106100;92-508;2250;1788;1770;596;1174
235;106101;106100;92-508;1704;1348;1333;470;863
236;106101;106100;92-511;1598;1256;1240;398;842
237;106101;106100;92-511;1396;1137;1123;385;738
238;106101;106100;92-512;2254;1796;1782;586;1196
239;106101;106100;92-512;2013;1576;1556;561;995
240;106101;106100;92-306;1576;1228;1214;423;791
241;106101;106100;92-306;1859;1456;1447;558;889
242;106101;106100;92-334;1600;1312;1301;427;874
243;106101;106100;92-334;1465;1180;1170;363;807
244;106101;106100;92-610;1154;933;925;327;598
245;106101;106100;92-402;2663;2052;2042;783;1259
246;106101;106100;92-402;2446;1950;1922;650;1272
247;106101;106100;92-413;2198;1711;1692;555;1137
248;106101;106100;92-413;2420;1920;1903;677;1226
249;106101;106100;92-433;1834;1518;1506;554;952
250;106101;106100;92-433;2206;1836;1809;498;1311
251;106101;106100;92-433;2598;2027;2010;610;1400
252;106101;106100;91-610;2152;1736;1705;569;1136
253;106101;106100;92-735;1979;1584;1560;630;930
254;106101;106100;92-207;1251;932;915;351;564
255;106101;106100;92-207;2098;1491;1475;550;925
256;106101;106100;92-329;2412;1743;1725;536;1189
257;106101;106100;90-338;2052;1350;1342;539;803
258;106101;106100;90-038;1672;1256;1246;416;830
259;106101;106100;90-038;1057;635;628;264;364
260;106101;106100;90-038;1183;791;782;272;510
261;106101;106100;90-338;1643;1093;1079;428;651
262;106101;106100;90-031;1817;1310;1296;492;804
263;106101;106100;90-338;1376;847;836;306;530
264;106101;106100;92-720;2017;1669;1648;591;1057
265;106101;106100;92-720;1985;1677;1659;547;1112
266;106101;106100;92-644;1437;1106;1088;456;632
267;106101;106100;92-610;1527;1166;1161;466;695
268;106101;106100;02-610;1849;1468;1451;671;780
269;106101;106100;93-100;1452;995;984;359;625
270;106101;106100;93-118;1319;1104;1094;305;789
271;106101;106100;93-281;1310;1000;990;349;641
272;106101;106100;93-219;2555;1909;1887;689;1198
273;106101;106100;93-291;1961;1488;1474;490;984
274;106101;106100;93-221;1454;1048;1041;373;668
275;106101;106100;93-221;1049;814;809;311;498
276;106101;106100;93-221;1151;988;977;237;740
277;106101;106100;93-217;1350;1061;1045;374;671
278;106101;106100;93-217;1194;895;885;338;547
279;106101;106100;92-108;2206;1924;1911;605;1306
280;106101;106100;92-116;2011;1588;1565;562;1003
281;106101;106100;92-116;1390;989;978;362;616
282;106101;106100;92-101;1485;1147;1138;420;718
283;106101;106100;92-221;1854;1332;1324;425;899
284;106101;106100;91-229;353;164;163;53;110
285;106101;106100;91-520;202;141;137;55;82
286;106101;106100;91-347;254;134;132;55;77
287;106101;106100;91-480;60;17;17;5;12
288;106101;106100;91-425;123;71;66;25;41
289;106101;106100;91-836;126;68;64;23;41
290;106101;106100;91-503;76;41;39;17;22
291;106101;106100;91-480;42;29;29;22;7
292;106101;106100;91-142;76;45;41;30;11
293;106101;106100;91-338;48;23;23;8;15
294;106101;106100;91-729;579;509;505;64;441
295;106101;106100;93-338;102;102;100;37;63
296;106101;106100;93-490;219;158;157;52;105
297;106101;106100;93-438;47;44;43;23;20
298;106101;106100;93-357;49;49;49;23;26
299;106101;106100;93-278;86;36;36;15;21
300;106101;106100;93-345;64;33;33;19;14
301;106101;106100;93-423;77;51;47;35;12
302;106101;106100;93-357;75;55;52;41;11
303;106101;106100;93-161;185;165;163;23;140
304;106101;106100;93-465;76;21;20;1;19
305;106101;106100;90-549;239;164;162;75;87
306;106101;106100;90-647;83;73;73;34;39
307;106101;106100;90-531;100;48;48;20;28
308;106101;106100;94-029;135;53;53;29;24
309;106101;106100;90-640;88;38;38;15;23
310;106101;106100;94-017;104;67;66;30;36
311;106101;106100;90-153;173;102;101;46;55
312;106101;106100;92-338;494;194;173;86;87
313;106101;106100;92-115;134;34;31;14;17
314;106101;106100;92-216;131;68;65;23;42
315;106101;106100;92-213;318;243;240;86;154
316;106101;106100;93-113;138;73;72;33;39
317;106101;106100;91-612;572;384;382;59;323
318;106101;106100;93-510;147;103;100;52;48
319;106101;106100;93-590;132;125;123;48;75
320;106101;106100;91-404;109;108;107;20;87
321;106101;106100;91-404;130;126;125;41;84
322;106101;106100;90-447;20;19;18;0;18
323;106101;106100;93-423;52;17;16;9;7
1;106201;106200;97-300;1052;821;816;448;368
2;106201;106200;97-300;1168;903;892;518;374
3;106201;106200;97-300;945;666;658;357;301
4;106201;106200;97-300;1194;733;726;385;341
5;106201;106200;97-300;1053;647;643;388;255
6;106201;106200;97-300;1169;802;794;394;400
7;106201;106200;97-300;1895;1278;1271;683;588
8;106201;106200;97-300;798;479;471;295;176
9;106201;106200;97-300;707;363;361;211;150
10;106201;106200;97-300;1006;730;724;371;353
11;106201;106200;97-300;1462;1020;1005;503;502
12;106201;106200;97-300;1763;1187;1175;567;608
13;106201;106200;97-300;1622;1037;1029;582;447
14;106201;106200;97-300;1036;772;760;398;362
15;106201;106200;97-300;1842;1425;1416;675;741
16;106201;106200;97-300;1476;1105;1098;596;502
17;106201;106200;97-300;1096;729;720;372;348
18;106201;106200;97-300;652;450;446;248;198
19;106201;106200;97-300;1321;1012;998;531;467
20;106201;106200;97-300;1584;1204;1192;588;604
21;106201;106200;97-300;1544;1080;1072;509;563
22;106201;106200;97-300;1592;1203;1196;563;633
23;106201;106200;97-300;1358;969;962;453;509
24;106201;106200;97-300;1698;1335;1313;592;721
25;106201;106200;97-300;1467;1116;1104;502;602
26;106201;106200;97-300;1618;1252;1237;521;716
27;106201;106200;97-300;1511;1122;1115;582;533
28;106201;106200;97-300;1779;1354;1338;635;703
29;106201;106200;97-300;1263;908;905;462;443
30;106201;106200;97-300;1630;1226;1211;594;617
31;106201;106200;97-300;1303;996;989;471;518
32;106201;106200;97-300;1371;885;878;471;407
33;106201;106200;97-300;1924;1447;1435;688;747
34;106201;106200;97-300;1531;1163;1154;524;630
35;106201;106200;97-300;1636;1135;1126;602;524
36;106201;106200;97-300;1910;1419;1401;774;627
37;106201;106200;97-300;769;590;577;313;264
38;106201;106200;97-300;144;110;109;72;37
39;106201;106200;97-300;8;8;7;5;2
40;106201;106200;97-300;566;452;441;53;388
41;106201;106200;97-300;96;40;36;24;12
1;106301;106300;96-100;1109;823;811;399;412
2;106301;106300;96-100;1096;845;832;322;510
3;106301;106300;96-100;1496;1176;1164;556;608
4;106301;106300;96-100;1779;1417;1398;625;773
5;106301;106300;96-100;1383;1068;1052;488;564
6;106301;106300;96-100;1585;1221;1213;563;650
7;106301;106300;96-100;748;620;613;241;372
8;106301;106300;96-100;1630;1200;1187;603;584
9;106301;106300;96-100;1571;1234;1224;563;661
10;106301;106300;96-100;1612;1186;1178;681;497
11;106301;106300;96-100;1172;972;954;384;570
12;106301;106300;96-100;1285;913;904;468;436
13;106301;106300;96-100;958;745;737;314;423
14;106301;106300;96-100;1607;1053;1040;548;492
15;106301;106300;96-100;1325;1035;1020;453;567
16;106301;106300;96-100;1194;905;894;389;505
17;106301;106300;96-100;1074;794;789;363;426
18;106301;106300;96-100;1070;745;735;353;382
19;106301;106300;96-100;1712;1293;1281;593;688
20;106301;106300;96-100;1086;832;828;351;477
21;106301;106300;96-100;1081;866;854;371;483
22;106301;106300;96-100;1268;939;927;537;390
23;106301;106300;96-100;1106;861;850;425;425
24;106301;106300;96-100;1103;858;848;437;411
25;106301;106300;96-100;966;710;699;382;317
26;106301;106300;96-100;1043;793;784;452;332
27;106301;106300;96-100;1100;847;842;461;381
28;106301;106300;96-100;65;65;64;39;25
29;106301;106300;96-100;61;33;31;23;8
1;120101;120100;32-700;1267;875;868;494;374
2;120101;120100;32-700;1638;1213;1199;670;529
3;120101;120100;32-700;1437;1031;1024;530;494
4;120101;120100;32-700;1073;865;857;461;396
5;120101;120100;32-700;1095;778;768;461;307
6;120101;120100;32-700;1398;1102;1093;621;472
7;120101;120100;32-700;1712;1278;1268;750;518
8;120101;120100;32-700;1823;1289;1281;665;616
9;120101;120100;32-700;1715;1272;1254;612;642
10;120101;120100;32-700;1480;1144;1135;551;584
11;120101;120100;32-700;1609;1215;1204;670;534
12;120101;120100;32-700;2010;1484;1468;828;640
13;120101;120100;32-700;1066;784;774;420;354
14;120101;120100;32-700;1352;1008;999;526;473
15;120101;120100;32-700;1072;805;802;447;355
16;120101;120100;32-700;64;28;27;15;12
17;120101;120100;32-700;118;46;43;30;13
18;120101;120100;32-700;75;12;12;8;4
1;120102;120100;32-700;1618;1177;1168;798;370
2;120102;120100;32-700;663;505;499;299;200
3;120102;120100;32-744;1606;1188;1178;869;309
4;120102;120100;32-744;679;525;523;373;150
5;120102;120100;32-744;384;283;282;198;84
6;120102;120100;32-700;1316;929;918;751;167
7;120102;120100;32-711;751;528;527;407;120
8;120102;120100;32-711;456;306;305;237;68
9;120102;120100;32-711;702;524;520;379;141
10;120102;120100;32-744;888;631;625;412;213
11;120102;120100;32-700;1006;729;721;555;166
12;120102;120100;32-700;415;320;320;218;102
13;120102;120100;32-700;728;545;544;406;138
14;120102;120100;32-708;772;580;576;444;132
15;120102;120100;32-700;679;445;437;366;71
16;120102;120100;32-015;1145;854;851;530;321
17;120102;120100;32-742;348;247;244;170;74
18;120102;120100;32-711;385;283;282;221;61
19;120102;120100;32-711;322;226;224;190;34
20;120102;120100;32-744;720;553;544;371;173
1;120103;120100;32-709;1004;745;739;581;158
2;120103;120100;32-709;1123;844;841;694;147
3;120103;120100;32-709;651;471;465;403;62
4;120103;120100;32-708;1290;931;924;777;147
5;120103;120100;32-708;849;591;586;420;166
6;120103;120100;32-709;145;36;35;14;21
1;120104;120100;32-724;245;146;143;116;27
2;120104;120100;32-724;841;619;610;477;133
3;120104;120100;32-724;801;597;594;473;121
4;120104;120100;32-724;607;498;490;380;110
5;120104;120100;32-725;1697;1220;1216;1100;116
1;120105;120100;32-740;1868;1395;1375;936;439
2;120105;120100;32-740;1148;822;811;623;188
3;120105;120100;32-742;1147;818;810;618;192
4;120105;120100;32-741;574;409;406;324;82
5;120105;120100;32-740;875;622;612;482;130
6;120105;120100;32-740;404;319;317;280;37
7;120105;120100;32-741;437;306;300;234;66
1;120106;120100;32-722;1614;1291;1286;1163;123
2;120106;120100;32-720;2063;1626;1616;1071;545
3;120106;120100;32-720;467;373;369;296;73
4;120106;120100;32-722;776;626;626;564;62
5;120106;120100;32-720;2347;1863;1850;1448;402
6;120106;120100;32-720;1019;773;772;624;148
7;120106;120100;32-720;373;263;262;205;57
8;120106;120100;32-720;2094;1551;1537;1134;403
9;120106;120100;32-720;532;443;437;67;370
1;120107;120100;32-765;2220;1659;1641;1210;431
2;120107;120100;32-712;577;369;366;288;78
3;120107;120100;32-712;235;167;165;140;25
4;120107;120100;32-765;805;578;577;459;118
5;120107;120100;32-700;1229;921;914;677;237
6;120107;120100;32-765;1033;737;736;613;123
7;120107;120100;32-712;309;214;211;175;36
8;120107;120100;32-712;719;496;491;393;98
9;120107;120100;32-765;1034;737;730;583;147
10;120107;120100;32-712;312;212;210;168;42
11;120107;120100;32-765;259;169;167;134;33
1;120108;120100;32-732;885;701;698;582;116
2;120108;120100;32-732;682;530;525;413;112
3;120108;120100;32-733;633;510;508;432;76
4;120108;120100;32-733;829;654;652;535;117
5;120108;120100;32-733;1229;934;924;746;178
1;120109;120100;32-731;1283;979;970;834;136
2;120109;120100;32-731;640;527;524;456;68
3;120109;120100;32-731;1372;1099;1093;880;213
4;120109;120100;32-731;558;473;468;437;31
5;120109;120100;32-731;252;200;199;178;21
1;120201;120200;32-824;1197;757;751;591;160
2;120201;120200;32-825;2053;1302;1296;1090;206
3;120201;120200;32-825;725;427;425;345;80
4;120201;120200;32-823;475;331;329;223;106
5;120201;120200;32-823;1448;978;970;739;231
6;120201;120200;32-825;354;244;244;215;29
7;120201;120200;32-825;74;36;31;14;17
1;120202;120200;32-800;1005;598;594;354;240
2;120202;120200;32-800;1136;753;746;430;316
3;120202;120200;32-800;1052;732;729;391;338
4;120202;120200;32-800;895;616;609;323;286
5;120202;120200;32-800;1354;997;990;568;422
6;120202;120200;32-800;1016;739;735;368;367
7;120202;120200;32-800;1395;1005;996;557;439
8;120202;120200;32-800;1195;890;884;527;357
9;120202;120200;32-800;1460;1088;1084;619;465
10;120202;120200;32-800;1576;1166;1151;659;492
11;120202;120200;32-800;2517;1784;1770;1210;560
12;120202;120200;32-800;1038;717;710;575;135
13;120202;120200;32-851;1264;871;863;614;249
14;120202;120200;32-851;2430;1646;1637;1176;461
15;120202;120200;32-800;1498;973;966;646;320
16;120202;120200;32-800;1616;1099;1089;882;207
17;120202;120200;32-800;2228;1489;1481;1094;387
18;120202;120200;32-823;1001;726;719;555;164
19;120202;120200;32-823;721;517;514;372;142
20;120202;120200;32-828;366;233;232;158;74
21;120202;120200;32-800;108;78;78;63;15
22;120202;120200;32-800;76;20;20;17;3
1;120203;120200;32-860;1731;1254;1246;876;370
2;120203;120200;32-860;458;341;339;299;40
3;120203;120200;32-860;1001;686;683;532;151
4;120203;120200;32-859;1030;741;734;579;155
5;120203;120200;32-863;1335;943;933;758;175
6;120203;120200;32-863;811;554;550;433;117
7;120203;120200;32-860;572;449;444;355;89
8;120203;120200;32-860;354;229;227;177;50
9;120203;120200;32-860;49;15;12;12;0
1;120204;120200;32-852;1411;1002;993;725;268
2;120204;120200;32-854;906;603;600;426;174
3;120204;120200;32-854;717;519;508;394;114
4;120204;120200;32-853;1025;729;723;491;232
5;120204;120200;32-852;1511;1055;1045;782;263
6;120204;120200;32-828;1082;780;777;561;216
7;120204;120200;32-828;668;473;470;350;120
8;120204;120200;32-853;490;329;323;249;74
9;120204;120200;32-854;436;305;301;256;45
10;120204;120200;32-852;1451;1032;1020;768;252
11;120204;120200;32-852;379;276;276;186;90
12;120204;120200;32-854;473;348;346;281;65
13;120204;120200;32-828;353;266;262;189;73
14;120204;120200;32-854;23;23;23;21;2
1;120205;120200;32-864;1948;1439;1434;1200;234
2;120205;120200;32-865;1235;836;828;708;120
3;120205;120200;32-864;865;612;608;535;73
4;120205;120200;32-864;801;558;554;456;98
5;120205;120200;32-864;773;525;522;432;90
6;120205;120200;32-865;418;294;289;244;45
7;120205;120200;32-864;71;19;19;10;9
8;120205;120200;32-864;22;8;7;4;3
1;120206;120200;32-861;1277;968;963;798;165
2;120206;120200;32-861;931;720;718;553;165
3;120206;120200;32-862;1437;1098;1091;925;166
4;120206;120200;32-862;1310;1005;995;888;107
1;120207;120200;32-820;386;236;235;182;53
2;120207;120200;32-820;751;447;442;365;77
3;120207;120200;32-822;606;402;398;307;91
4;120207;120200;32-820;1438;871;858;653;205
5;120207;120200;32-821;593;369;365;268;97
6;120207;120200;32-821;433;271;270;180;90
7;120207;120200;32-813;697;502;501;399;102
8;120207;120200;32-821;311;214;214;173;41
9;120207;120200;32-820;540;347;342;267;75
10;120207;120200;32-822;467;318;317;259;58
11;120207;120200;32-822;373;226;225;191;34
12;120207;120200;32-821;184;112;110;84;26
13;120207;120200;32-821;312;192;191;167;24
1;120301;120300;32-566;1245;937;930;456;474
2;120301;120300;32-566;1239;928;922;484;438
3;120301;120300;32-566;791;521;514;338;176
4;120301;120300;32-566;969;695;686;418;268
5;120301;120300;32-566;1380;953;945;581;364
6;120301;120300;32-566;778;552;548;347;201
7;120301;120300;32-566;989;650;648;381;267
8;120301;120300;32-566;1478;1051;1042;550;492
9;120301;120300;32-566;376;296;292;122;170
10;120301;120300;32-566;245;197;197;157;40
11;120301;120300;32-566;168;115;114;84;30
1;120302;120300;32-551;1190;839;827;455;372
2;120302;120300;32-551;604;437;432;275;157
3;120302;120300;32-551;1112;793;784;554;230
4;120302;120300;32-551;667;510;507;319;188
5;120302;120300;32-551;634;455;453;277;176
6;120302;120300;32-551;582;419;412;183;229
7;120302;120300;32-555;440;289;286;140;146
8;120302;120300;32-555;927;651;641;312;329
9;120302;120300;32-555;903;571;565;278;287
1;120303;120300;32-500;844;540;539;216;323
2;120303;120300;32-500;674;486;482;182;300
3;120303;120300;32-500;1163;736;733;341;392
4;120303;120300;32-500;964;708;698;257;441
5;120303;120300;32-500;954;673;665;236;429
6;120303;120300;32-500;1274;988;978;350;628
7;120303;120300;32-500;1210;899;897;364;533
8;120303;120300;32-500;903;565;560;247;313
9;120303;120300;32-500;935;668;664;250;414
10;120303;120300;32-500;1241;823;819;370;449
11;120303;120300;32-500;1294;890;881;370;511
12;120303;120300;32-500;1304;928;925;375;550
13;120303;120300;32-500;1238;863;850;332;518
14;120303;120300;32-500;658;440;436;155;281
15;120303;120300;32-500;1079;830;823;325;498
16;120303;120300;32-500;1459;1034;1029;424;605
17;120303;120300;32-500;1050;750;746;341;405
18;120303;120300;32-500;1426;1022;1012;398;614
19;120303;120300;32-500;1279;924;917;367;550
20;120303;120300;32-500;1396;1003;999;435;564
21;120303;120300;32-500;495;295;292;151;141
22;120303;120300;32-500;1180;881;876;360;516
23;120303;120300;32-500;1240;834;831;422;409
24;120303;120300;32-500;1347;957;950;489;461
25;120303;120300;32-500;1416;1003;996;466;530
26;120303;120300;32-552;1370;951;943;500;443
27;120303;120300;32-552;1185;787;783;427;356
28;120303;120300;32-500;1241;831;826;461;365
29;120303;120300;32-500;1129;860;853;369;484
30;120303;120300;32-500;156;156;154;78;76
31;120303;120300;32-552;70;26;26;12;14
32;120303;120300;32-500;96;63;62;58;4
1;120304;120300;32-590;632;443;434;283;151
2;120304;120300;32-590;811;515;512;288;224
3;120304;120300;32-590;823;593;586;344;242
4;120304;120300;32-590;1139;820;812;478;334
5;120304;120300;32-590;1654;1083;1075;546;529
6;120304;120300;32-590;786;495;491;303;188
7;120304;120300;32-590;560;406;405;188;217
8;120304;120300;32-590;1057;761;757;372;385
9;120304;120300;32-590;896;662;657;327;330
10;120304;120300;32-590;1081;829;818;440;378
11;120304;120300;32-590;1296;960;947;434;513
12;120304;120300;32-590;1555;1136;1128;599;529
13;120304;120300;32-593;1466;1083;1080;673;407
14;120304;120300;32-593;1390;948;938;657;281
15;120304;120300;32-590;1177;869;867;597;270
1;120305;120300;32-540;839;601;593;250;343
2;120305;120300;32-540;834;609;607;250;357
3;120305;120300;32-540;1309;879;867;394;473
4;120305;120300;32-540;821;580;577;225;352
5;120305;120300;32-540;1051;791;784;334;450
6;120305;120300;32-540;934;607;600;289;311
7;120305;120300;32-540;1071;699;688;311;377
8;120305;120300;32-540;874;623;613;291;322
9;120305;120300;32-540;564;319;315;175;140
10;120305;120300;32-541;939;612;605;293;312
11;120305;120300;32-540;1380;971;957;438;519
12;120305;120300;32-540;1122;791;785;323;462
13;120305;120300;32-540;1139;716;708;400;308
14;120305;120300;32-540;900;638;632;293;339
15;120305;120300;32-540;466;332;330;199;131
16;120305;120300;32-543;715;511;506;252;254
17;120305;120300;32-543;677;470;469;272;197
18;120305;120300;32-543;1534;1135;1129;495;634
19;120305;120300;32-545;1026;731;721;363;358
20;120305;120300;32-545;1039;727;722;367;355
21;120305;120300;32-545;1116;862;857;399;458
22;120305;120300;32-540;1105;814;809;400;409
23;120305;120300;32-540;969;707;699;330;369
24;120305;120300;32-540;691;548;543;227;316
25;120305;120300;32-540;1515;1002;995;506;489
26;120305;120300;32-540;127;95;93;33;60
1;120401;120400;33-220;1284;669;663;508;155
2;120401;120400;33-220;506;278;278;236;42
3;120401;120400;33-220;257;129;127;111;16
1;120402;120400;33-200;1247;822;820;539;281
2;120402;120400;33-200;1226;838;830;576;254
3;120402;120400;33-200;1743;1146;1137;763;374
4;120402;120400;33-200;735;459;455;299;156
5;120402;120400;33-200;1922;1304;1300;914;386
6;120402;120400;33-200;1285;869;864;551;313
7;120402;120400;33-200;809;560;557;423;134
8;120402;120400;33-200;436;320;318;288;30
9;120402;120400;33-206;533;367;363;313;50
10;120402;120400;33-205;479;292;291;266;25
11;120402;120400;33-205;1052;619;615;536;79
12;120402;120400;33-202;975;632;630;546;84
13;120402;120400;33-202;340;241;239;218;21
14;120402;120400;33-200;715;499;495;433;62
15;120402;120400;33-200;425;333;330;307;23
16;120402;120400;33-200;915;585;584;526;58
17;120402;120400;33-200;547;377;370;324;46
18;120402;120400;33-240;297;223;222;195;27
19;120402;120400;33-200;33;17;16;13;3
20;120402;120400;33-200;109;72;70;50;20
1;120403;120400;33-260;558;325;325;247;78
2;120403;120400;33-260;261;159;159;122;37
3;120403;120400;33-260;288;169;168;145;23
4;120403;120400;33-260;571;305;304;229;75
5;120403;120400;33-260;276;167;167;145;22
6;120403;120400;33-260;200;114;114;99;15
7;120403;120400;33-260;268;150;146;127;19
1;120404;120400;33-221;1240;745;737;576;161
2;120404;120400;33-221;522;299;297;212;85
3;120404;120400;33-221;486;310;306;277;29
4;120404;120400;33-221;312;195;193;154;39
5;120404;120400;33-221;65;28;26;20;6
1;120405;120400;33-210;1350;885;881;695;186
2;120405;120400;33-264;602;378;374;329;45
3;120405;120400;33-210;431;291;288;225;63
4;120405;120400;33-263;506;321;319;273;46
5;120405;120400;33-210;525;328;326;257;69
6;120405;120400;33-264;391;245;244;218;26
7;120405;120400;33-210;520;344;341;299;42
8;120405;120400;33-200;600;449;445;360;85
9;120405;120400;33-210;598;355;353;303;50
10;120405;120400;33-210;354;201;199;180;19
1;120406;120400;33-207;1040;660;647;571;76
2;120406;120400;33-207;1582;1128;1125;1000;125
3;120406;120400;33-207;498;323;322;286;36
4;120406;120400;33-207;230;151;148;135;13
5;120406;120400;33-206;1430;999;990;842;148
6;120406;120400;33-207;376;243;242;205;37
7;120406;120400;33-206;472;308;305;282;23
1;120407;120400;33-230;1474;907;897;728;169
2;120407;120400;33-230;724;436;434;395;39
3;120407;120400;33-230;598;406;401;330;71
4;120407;120400;33-230;503;308;307;270;37
5;120407;120400;33-230;637;384;378;293;85
6;120407;120400;33-202;447;274;272;242;30
7;120407;120400;33-230;777;499;497;423;74
8;120407;120400;33-230;1574;1016;1009;664;345
9;120407;120400;33-230;2147;1367;1352;897;455
10;120407;120400;33-230;343;218;216;173;43
11;120407;120400;33-230;395;228;226;205;21
1;120501;120500;38-300;549;381;375;225;150
2;120501;120500;38-300;590;370;366;216;150
3;120501;120500;38-300;1639;1123;1112;718;394
4;120501;120500;38-300;919;629;624;357;267
5;120501;120500;38-300;783;540;538;309;229
6;120501;120500;38-300;860;645;641;380;261
7;120501;120500;38-300;955;648;642;367;275
8;120501;120500;38-300;812;541;532;311;221
9;120501;120500;38-300;889;559;557;322;235
10;120501;120500;38-300;1112;755;748;420;328
11;120501;120500;38-300;1036;676;668;353;315
12;120501;120500;38-300;531;353;350;174;176
13;120501;120500;38-300;1042;662;659;366;293
14;120501;120500;38-300;1705;1107;1096;538;558
15;120501;120500;38-300;1056;749;747;374;373
16;120501;120500;38-300;932;675;673;327;346
17;120501;120500;38-300;990;682;675;350;325
18;120501;120500;38-300;1571;1113;1106;540;566
19;120501;120500;38-300;1067;762;754;407;347
20;120501;120500;38-300;106;38;36;26;10
21;120501;120500;38-300;77;39;36;20;16
22;120501;120500;38-300;317;84;83;64;19
1;120502;120500;38-340;1698;1118;1102;684;418
2;120502;120500;38-340;1689;1174;1163;763;400
3;120502;120500;38-340;1223;790;783;651;132
4;120502;120500;38-340;505;360;360;295;65
5;120502;120500;38-340;343;211;210;181;29
6;120502;120500;38-340;744;539;536;404;132
7;120502;120500;38-306;2420;1648;1639;1221;418
8;120502;120500;38-323;603;382;378;336;42
9;120502;120500;38-323;1002;684;681;590;91
10;120502;120500;38-323;459;314;313;270;43
11;120502;120500;38-323;339;220;218;194;24
12;120502;120500;38-340;1445;954;950;769;181
1;120503;120500;38-350;2273;1644;1636;1249;387
2;120503;120500;38-350;971;661;653;562;91
3;120503;120500;38-350;794;616;611;548;63
4;120503;120500;38-324;1197;789;784;673;111
5;120503;120500;38-324;419;273;273;234;39
6;120503;120500;38-350;677;502;500;449;51
7;120503;120500;38-350;800;594;593;485;108
1;120504;120500;38-311;138;79;78;52;26
2;120504;120500;38-300;1135;826;821;711;110
3;120504;120500;38-303;1589;1173;1163;828;335
4;120504;120500;38-333;646;473;472;292;180
5;120504;120500;38-303;1885;1296;1289;849;440
6;120504;120500;38-333;458;311;309;214;95
7;120504;120500;38-300;1604;1135;1125;770;355
8;120504;120500;38-300;1299;933;930;721;209
9;120504;120500;38-311;1131;758;751;569;182
10;120504;120500;38-311;1198;860;851;696;155
11;120504;120500;38-333;1820;1209;1200;819;381
1;120505;120500;38-305;568;386;382;337;45
2;120505;120500;38-305;1635;1110;1107;869;238
3;120505;120500;38-304;187;106;106;84;22
4;120505;120500;38-304;1347;917;913;657;256
5;120505;120500;38-305;1164;791;782;632;150
6;120505;120500;38-304;129;87;86;77;9
7;120505;120500;38-305;121;92;92;88;4
1;120506;120500;38-324;546;383;382;325;57
2;120506;120500;38-322;787;541;535;437;98
3;120506;120500;38-322;798;520;516;362;154
4;120506;120500;38-322;828;561;558;409;149
5;120506;120500;38-322;721;492;488;375;113
6;120506;120500;38-331;1006;747;743;639;104
7;120506;120500;38-331;558;379;377;331;46
8;120506;120500;38-331;303;204;203;176;27
9;120506;120500;38-322;754;533;527;384;143
1;120507;120500;38-321;1259;908;901;737;164
2;120507;120500;38-321;1352;941;935;773;162
3;120507;120500;38-321;1142;775;772;693;79
1;120508;120500;38-312;213;147;147;116;31
2;120508;120500;38-312;606;415;411;263;148
3;120508;120500;38-312;1373;1028;1023;891;132
4;120508;120500;38-312;745;556;554;478;76
5;120508;120500;38-312;1101;813;806;660;146
6;120508;120500;38-312;49;35;34;32;2
1;120509;120500;38-307;518;357;354;243;111
2;120509;120500;38-307;1247;887;881;581;300
3;120509;120500;38-307;615;390;387;243;144
4;120509;120500;38-307;417;266;265;176;89
5;120509;120500;38-307;272;188;188;97;91
6;120509;120500;38-307;166;92;90;48;42
7;120509;120500;38-307;179;138;138;94;44
8;120509;120500;38-307;331;199;197;106;91
9;120509;120500;38-307;176;125;125;87;38
10;120509;120500;38-307;21;12;11;6;5
1;120510;120500;38-315;1172;717;707;338;369
2;120510;120500;38-315;665;480;475;394;81
3;120510;120500;38-315;378;302;300;231;69
4;120510;120500;38-316;1013;771;768;340;428
5;120510;120500;38-315;270;168;167;86;81
6;120510;120500;38-315;384;248;245;172;73
7;120510;120500;38-315;208;134;134;78;56
8;120510;120500;38-315;372;275;274;186;88
9;120510;120500;38-316;430;265;265;158;107
10;120510;120500;38-315;312;197;195;105;90
11;120510;120500;38-315;173;119;119;85;34
12;120510;120500;38-315;187;138;136;124;12
1;120601;120600;32-070;1625;1212;1210;654;556
2;120601;120600;32-070;297;219;216;159;57
3;120601;120600;32-070;580;434;434;296;138
4;120601;120600;32-070;671;497;493;302;191
5;120601;120600;32-071;1228;777;770;515;255
6;120601;120600;32-071;939;651;648;473;175
7;120601;120600;32-061;2237;1626;1609;927;682
8;120601;120600;32-060;621;445;443;365;78
9;120601;120600;32-061;1071;810;808;513;295
10;120601;120600;32-070;1363;1036;1026;589;437
11;120601;120600;32-070;645;501;499;251;248
12;120601;120600;32-061;411;320;317;236;81
1;120602;120600;32-125;926;609;605;424;181
2;120602;120600;32-125;403;278;275;197;78
3;120602;120600;32-125;790;587;582;417;165
4;120602;120600;32-125;949;692;689;492;197
5;120602;120600;32-125;943;639;635;465;170
6;120602;120600;32-125;523;354;351;288;63
7;120602;120600;32-125;492;325;324;260;64
8;120602;120600;32-125;350;270;270;222;48
9;120602;120600;32-125;717;460;455;328;127
1;120603;120600;32-095;1010;704;702;517;185
2;120603;120600;32-095;655;460;453;347;106
3;120603;120600;32-095;678;490;487;354;133
4;120603;120600;32-095;403;294;292;208;84
5;120603;120600;32-095;811;670;663;370;293
6;120603;120600;32-095;1044;800;793;546;247
7;120603;120600;32-095;272;210;208;156;52
8;120603;120600;32-095;478;383;380;283;97
9;120603;120600;32-095;367;281;274;162;112
10;120603;120600;32-095;554;423;420;295;125
11;120603;120600;32-095;516;420;418;261;157
12;120603;120600;32-095;353;227;227;170;57
13;120603;120600;32-095;286;232;227;144;83
1;120604;120600;32-048;669;506;499;290;209
2;120604;120600;32-048;2046;1606;1590;970;620
3;120604;120600;32-048;458;322;317;218;99
4;120604;120600;32-048;431;331;329;171;158
5;120604;120600;32-048;1081;838;828;608;220
6;120604;120600;32-049;1829;1380;1363;1085;278
7;120604;120600;32-049;872;624;617;493;124
8;120604;120600;32-049;1170;843;836;658;178
1;120605;120600;32-010;498;373;370;234;136
2;120605;120600;32-010;823;620;616;390;226
3;120605;120600;32-010;1102;848;844;428;416
4;120605;120600;32-010;1510;1194;1181;583;598
5;120605;120600;32-010;487;345;342;268;74
6;120605;120600;32-010;942;760;755;401;354
7;120605;120600;32-010;475;364;364;306;58
8;120605;120600;32-010;397;308;300;170;130
9;120605;120600;32-010;996;747;738;387;351
10;120605;120600;32-010;1142;845;839;539;300
11;120605;120600;32-010;859;682;674;368;306
12;120605;120600;32-010;856;680;675;305;370
13;120605;120600;32-010;531;398;396;219;177
14;120605;120600;32-010;408;276;274;197;77
15;120605;120600;32-010;164;127;126;84;42
16;120605;120600;32-010;580;436;435;261;174
17;120605;120600;32-010;629;505;502;310;192
18;120605;120600;32-010;391;263;263;200;63
19;120605;120600;32-010;288;215;215;132;83
20;120605;120600;32-010;351;285;285;177;108
1;120606;120600;32-065;1002;726;718;324;394
2;120606;120600;32-065;917;723;715;356;359
3;120606;120600;32-065;754;581;573;278;295
4;120606;120600;32-065;837;559;554;294;260
5;120606;120600;32-065;808;614;610;243;367
6;120606;120600;32-065;999;756;746;329;417
7;120606;120600;32-065;1318;971;956;449;507
8;120606;120600;32-065;877;655;646;384;262
9;120606;120600;32-065;819;618;612;401;211
10;120606;120600;32-065;726;527;525;362;163
11;120606;120600;32-065;843;660;651;353;298
12;120606;120600;32-065;1472;1050;1038;485;553
13;120606;120600;32-065;806;542;540;376;164
14;120606;120600;32-065;1125;781;771;422;349
15;120606;120600;32-065;1028;779;772;390;382
16;120606;120600;32-067;573;385;379;201;178
17;120606;120600;32-067;860;610;604;344;260
18;120606;120600;32-067;1045;767;758;480;278
19;120606;120600;32-067;1002;753;739;348;391
20;120606;120600;32-067;991;771;764;346;418
21;120606;120600;32-065;961;677;673;402;271
22;120606;120600;32-065;1134;739;732;447;285
23;120606;120600;32-065;918;641;635;391;244
24;120606;120600;32-067;836;555;550;352;198
25;120606;120600;32-067;202;154;154;97;57
26;120606;120600;32-065;752;563;557;367;190
27;120606;120600;32-067;1033;761;755;346;409
28;120606;120600;32-065;61;35;33;21;12
29;120606;120600;32-065;175;136;133;89;44
1;120607;120600;32-060;1486;1097;1090;761;329
2;120607;120600;32-060;1731;1261;1248;798;450
3;120607;120600;32-060;728;508;506;317;189
4;120607;120600;32-060;736;539;536;340;196
5;120607;120600;32-060;1629;1185;1182;878;304
6;120607;120600;32-060;932;675;671;485;186
7;120607;120600;32-084;1108;887;878;593;285
8;120607;120600;32-084;562;430;427;280;147
9;120607;120600;32-084;801;573;564;355;209
10;120607;120600;32-060;1438;1147;1140;576;564
11;120607;120600;32-060;997;782;771;446;325
12;120607;120600;32-060;1428;1127;1116;635;481
13;120607;120600;32-060;326;239;237;127;110
1;120608;120600;32-091;1748;1514;1503;563;940
2;120608;120600;32-091;1350;1086;1076;490;586
3;120608;120600;32-091;1215;933;923;503;420
4;120608;120600;32-091;1240;962;952;505;447
5;120608;120600;32-091;1323;1002;992;563;429
6;120608;120600;32-091;867;722;719;335;384
7;120608;120600;32-091;395;314;309;142;167
8;120608;120600;32-091;678;533;532;268;264
9;120608;120600;32-091;411;338;336;176;160
1;120609;120600;32-031;678;539;537;298;239
2;120609;120600;32-031;1081;851;846;465;381
3;120609;120600;32-031;1635;1331;1320;707;613
4;120609;120600;32-031;884;681;675;439;236
5;120609;120600;30-444;2268;1828;1809;734;1075
6;120609;120600;32-031;1453;1142;1129;582;547
7;120609;120600;32-031;1193;922;906;533;373
8;120609;120600;32-031;1279;1018;1013;452;561
9;120609;120600;32-031;211;172;171;134;37
10;120609;120600;30-698;911;738;733;413;320
11;120609;120600;32-031;38;26;25;16;9
1;120610;120600;32-043;887;644;639;407;232
2;120610;120600;32-043;981;743;733;450;283
3;120610;120600;32-046;585;430;425;262;163
4;120610;120600;32-077;766;596;590;342;248
5;120610;120600;32-046;172;115;114;82;32
6;120610;120600;32-043;614;508;504;327;177
7;120610;120600;32-043;1129;844;835;543;292
8;120610;120600;32-046;337;256;255;159;96
9;120610;120600;32-046;223;151;151;103;48
10;120610;120600;32-046;446;313;312;209;103
11;120610;120600;32-046;332;275;274;202;72
12;120610;120600;32-046;221;151;151;105;46
13;120610;120600;32-077;343;270;269;168;101
14;120610;120600;32-043;1136;840;833;520;313
15;120610;120600;32-045;170;127;126;66;60
1;120611;120600;32-050;1965;1455;1444;794;650
2;120611;120600;32-050;1136;859;851;437;414
3;120611;120600;32-050;1853;1407;1389;693;696
4;120611;120600;32-050;1461;962;953;431;522
5;120611;120600;32-050;1638;1238;1231;543;688
6;120611;120600;32-050;1135;870;864;408;456
7;120611;120600;32-050;1726;1189;1176;588;588
8;120611;120600;32-050;1353;957;947;510;437
9;120611;120600;32-050;1528;1084;1067;605;462
10;120611;120600;32-050;1109;820;813;436;377
11;120611;120600;32-050;1065;785;780;393;387
12;120611;120600;32-050;2108;1671;1654;721;933
13;120611;120600;32-052;1281;972;960;564;396
14;120611;120600;32-053;1881;1379;1368;930;438
15;120611;120600;32-051;1234;896;888;608;280
16;120611;120600;32-051;839;582;573;335;238
17;120611;120600;32-051;915;670;664;426;238
18;120611;120600;32-051;768;601;595;357;238
19;120611;120600;32-051;536;398;394;275;119
20;120611;120600;32-052;1307;955;947;587;360
21;120611;120600;32-050;1125;846;842;518;324
22;120611;120600;32-050;762;533;530;318;212
23;120611;120600;32-052;1475;1101;1093;643;450
24;120611;120600;32-051;744;555;551;365;186
25;120611;120600;32-052;358;261;261;203;58
26;120611;120600;32-051;542;391;391;200;191
27;120611;120600;32-052;483;379;375;230;145
28;120611;120600;32-052;311;229;227;169;58
29;120611;120600;32-052;497;416;409;231;178
1;120612;120600;32-090;1341;989;980;604;376
2;120612;120600;32-090;1314;990;985;667;318
3;120612;120600;32-090;707;518;514;348;166
4;120612;120600;32-090;1054;768;763;511;252
5;120612;120600;32-090;169;118;118;94;24
6;120612;120600;32-090;916;658;647;467;180
7;120612;120600;32-090;562;396;392;300;92
8;120612;120600;32-090;387;281;280;207;73
9;120612;120600;32-090;323;220;217;178;39
10;120612;120600;32-090;594;437;435;293;142
11;120612;120600;32-090;190;137;135;99;36
12;120612;120600;32-090;377;247;245;196;49
13;120612;120600;32-090;190;141;140;110;30
14;120612;120600;32-090;425;308;304;217;87
15;120612;120600;32-090;240;176;172;141;31
16;120612;120600;32-090;214;155;155;98;57
17;120612;120600;32-090;152;93;92;77;15
18;120612;120600;32-090;665;514;509;360;149
19;120612;120600;32-090;310;251;251;158;93
20;120612;120600;32-090;349;257;257;214;43
1;120613;120600;32-045;921;690;686;502;184
2;120613;120600;32-045;886;706;698;589;109
3;120613;120600;32-045;798;633;624;541;83
4;120613;120600;32-045;499;370;369;251;118
5;120613;120600;32-045;1300;1025;1022;779;243
1;120614;120600;32-040;1894;1505;1476;851;625
2;120614;120600;32-040;1895;1443;1424;748;676
3;120614;120600;32-040;1446;1035;1027;614;413
4;120614;120600;32-040;1335;1026;1017;662;355
5;120614;120600;32-040;636;481;475;302;173
6;120614;120600;32-040;1134;834;830;526;304
1;120615;120600;32-089;489;375;373;201;172
2;120615;120600;32-089;1123;896;888;496;392
3;120615;120600;32-089;857;666;650;394;256
4;120615;120600;32-089;233;177;177;108;69
5;120615;120600;32-085;2235;1866;1841;740;1101
6;120615;120600;32-085;1040;868;861;341;520
7;120615;120600;32-085;1342;1081;1070;401;669
8;120615;120600;32-085;1737;1492;1477;608;869
9;120615;120600;32-089;536;431;425;228;197
10;120615;120600;32-089;410;309;306;185;121
11;120615;120600;32-089;1279;1050;1044;583;461
12;120615;120600;32-085;470;369;364;171;193
13;120615;120600;32-085;103;47;45;18;27
14;120615;120600;32-085;23;23;23;13;10
1;120616;120600;32-084;561;445;439;217;222
2;120616;120600;32-083;1213;958;947;466;481
3;120616;120600;32-080;1405;1146;1138;576;562
4;120616;120600;32-064;563;455;450;264;186
5;120616;120600;32-082;1999;1643;1621;634;987
6;120616;120600;32-082;776;643;628;304;324
7;120616;120600;32-084;905;711;706;436;270
8;120616;120600;32-082;784;604;600;261;339
9;120616;120600;32-084;364;270;268;146;122
10;120616;120600;32-083;383;310;309;143;166
11;120616;120600;32-082;806;645;642;323;319
12;120616;120600;32-064;433;364;359;151;208
13;120616;120600;32-064;679;563;557;290;267
14;120616;120600;32-064;525;395;391;244;147
15;120616;120600;32-064;1631;1320;1302;670;632
16;120616;120600;32-064;698;556;550;282;268
17;120616;120600;30-199;2104;1712;1698;718;980
18;120616;120600;32-083;590;488;477;241;236
19;120616;120600;32-082;587;475;469;234;235
20;120616;120600;32-080;1920;1495;1481;529;952
21;120616;120600;32-080;943;764;756;273;483
22;120616;120600;32-080;1611;1254;1235;493;742
23;120616;120600;32-064;289;220;218;132;86
24;120616;120600;32-064;223;189;184;106;78
25;120616;120600;32-082;76;49;48;21;27
26;120616;120600;32-082;79;31;29;23;6
1;120617;120600;32-086;302;228;226;136;90
2;120617;120600;32-087;840;725;718;262;456
3;120617;120600;32-087;963;774;765;320;445
4;120617;120600;32-087;1151;1000;990;351;639
5;120617;120600;32-087;993;805;798;313;485
6;120617;120600;32-087;820;732;724;194;530
7;120617;120600;32-087;1013;863;852;372;480
8;120617;120600;32-087;972;846;836;256;580
9;120617;120600;32-087;527;455;451;165;286
10;120617;120600;32-088;446;352;347;180;167
11;120617;120600;32-087;1130;920;909;471;438
12;120617;120600;32-088;774;568;558;282;276
13;120617;120600;32-086;814;678;670;313;357
14;120617;120600;32-088;505;404;398;197;201
15;120617;120600;32-086;589;469;466;258;208
16;120617;120600;32-087;332;276;276;156;120
17;120617;120600;32-088;357;295;292;146;146
18;120617;120600;32-088;602;499;495;248;247
19;120617;120600;32-087;739;535;529;296;233
20;120617;120600;32-087;845;635;623;251;372
21;120617;120600;32-087;1179;946;940;401;539
22;120617;120600;32-087;892;791;774;232;542
23;120617;120600;32-087;985;757;745;364;381
24;120617;120600;32-087;945;764;753;332;421
25;120617;120600;32-086;96;41;39;28;11
26;120617;120600;32-088;63;25;23;7;16
1;120701;120700;34-600;693;490;485;291;194
2;120701;120700;34-600;756;594;587;437;150
3;120701;120700;34-600;549;409;404;267;137
4;120701;120700;34-600;829;606;601;443;158
5;120701;120700;34-600;781;614;604;466;138
6;120701;120700;34-600;660;459;452;276;176
7;120701;120700;34-600;1430;1067;1057;765;292
8;120701;120700;34-600;1369;1057;1046;723;323
9;120701;120700;34-600;1399;1118;1109;742;367
10;120701;120700;34-600;775;591;585;389;196
11;120701;120700;34-600;584;398;392;246;146
12;120701;120700;34-600;781;514;506;319;187
13;120701;120700;34-600;52;35;35;33;2
14;120701;120700;34-600;130;90;89;64;25
15;120701;120700;34-600;98;78;77;47;30
1;120702;120700;34-730;1064;786;779;497;282
2;120702;120700;34-730;1475;996;986;627;359
3;120702;120700;34-730;1594;1123;1115;769;346
4;120702;120700;34-730;1815;1306;1292;923;369
1;120703;120700;34-642;1260;882;879;665;214
2;120703;120700;34-642;1181;819;814;598;216
3;120703;120700;34-642;751;530;524;391;133
4;120703;120700;34-643;935;685;676;552;124
5;120703;120700;34-625;1092;724;720;565;155
6;120703;120700;34-625;438;328;327;289;38
7;120703;120700;34-643;496;348;348;307;41
8;120703;120700;34-643;505;387;383;341;42
9;120703;120700;34-625;394;272;271;170;101
10;120703;120700;34-643;469;311;308;272;36
1;120704;120700;34-620;808;558;550;447;103
2;120704;120700;34-620;542;372;368;274;94
3;120704;120700;34-623;464;325;323;242;81
4;120704;120700;34-620;750;590;587;534;53
5;120704;120700;34-617;972;712;705;612;93
6;120704;120700;34-620;368;255;253;216;37
7;120704;120700;34-623;230;172;170;164;6
8;120704;120700;34-620;703;476;471;372;99
9;120704;120700;34-620;411;296;296;272;24
10;120704;120700;34-620;310;224;222;205;17
11;120704;120700;34-620;228;152;152;103;49
12;120704;120700;34-623;560;403;397;292;105
13;120704;120700;34-623;25;17;17;15;2
14;120704;120700;34-623;69;39;36;32;4
1;120705;120700;34-608;1638;1183;1177;1007;170
2;120705;120700;34-608;879;651;649;563;86
3;120705;120700;34-608;455;360;357;328;29
4;120705;120700;34-608;778;563;559;485;74
5;120705;120700;34-608;560;388;385;324;61
1;120706;120700;34-602;1304;1056;1053;871;182
2;120706;120700;34-602;626;483;483;438;45
3;120706;120700;34-603;836;647;643;567;76
4;120706;120700;34-603;683;547;542;504;38
5;120706;120700;34-602;413;358;358;308;50
6;120706;120700;34-603;522;434;432;394;38
7;120706;120700;34-602;1265;1032;1025;917;108
8;120706;120700;34-603;394;326;325;322;3
1;120707;120700;34-652;1226;936;927;786;141
2;120707;120700;34-600;2023;1534;1521;1276;245
3;120707;120700;34-600;467;346;341;293;48
4;120707;120700;34-600;935;704;700;595;105
5;120707;120700;34-600;473;351;348;298;50
6;120707;120700;34-600;2065;1594;1577;1267;310
7;120707;120700;34-654;1606;1188;1177;959;218
8;120707;120700;34-654;1848;1381;1370;1023;347
9;120707;120700;34-654;763;595;590;495;95
10;120707;120700;34-600;1066;778;772;661;111
11;120707;120700;34-600;657;511;507;445;62
12;120707;120700;34-600;993;748;737;645;92
13;120707;120700;34-652;574;432;430;361;69
14;120707;120700;34-600;627;490;490;433;57
15;120707;120700;34-600;1157;914;907;820;87
16;120707;120700;34-652;285;218;217;199;18
17;120707;120700;34-654;723;545;543;484;59
18;120707;120700;34-600;552;411;409;368;41
19;120707;120700;34-600;636;508;496;360;136
20;120707;120700;34-652;349;296;296;255;41
1;120708;120700;34-606;459;337;337;309;28
2;120708;120700;34-606;1680;1315;1308;1101;207
3;120708;120700;34-606;740;514;512;434;78
4;120708;120700;34-604;1873;1413;1401;1143;258
5;120708;120700;34-606;783;566;565;477;88
6;120708;120700;34-604;791;621;617;532;85
7;120708;120700;34-606;617;465;461;419;42
8;120708;120700;34-606;421;301;297;257;40
1;120709;120700;34-730;255;184;181;147;34
2;120709;120700;34-741;1343;951;947;766;181
3;120709;120700;34-741;915;646;642;555;87
4;120709;120700;34-734;1340;1005;995;793;202
5;120709;120700;34-734;1395;1096;1091;947;144
6;120709;120700;34-736;1599;1150;1148;1051;97
7;120709;120700;34-733;950;703;701;653;48
8;120709;120700;34-730;1058;716;715;629;86
9;120709;120700;34-733;921;656;654;563;91
10;120709;120700;34-733;1058;808;804;720;84
11;120709;120700;34-730;1198;834;829;687;142
12;120709;120700;34-730;842;574;568;416;152
13;120709;120700;34-741;76;76;71;53;18
14;120709;120700;34-730;52;47;43;36;7
1;120710;120700;34-735;1630;1119;1116;1044;72
2;120710;120700;34-735;990;607;601;466;135
3;120710;120700;34-735;1816;1226;1218;963;255
4;120710;120700;34-735;957;658;656;578;78
1;120711;120700;34-615;1392;1048;1042;917;125
2;120711;120700;34-615;543;399;397;370;27
3;120711;120700;34-615;1169;895;891;791;100
4;120711;120700;34-615;519;400;398;359;39
5;120711;120700;34-615;1422;1067;1060;894;166
1;120712;120700;34-650;838;678;673;622;51
2;120712;120700;34-650;1149;843;839;615;224
3;120712;120700;34-650;878;661;656;508;148
4;120712;120700;34-650;995;755;753;646;107
5;120712;120700;34-650;540;406;406;348;58
6;120712;120700;34-650;304;257;256;241;15
1;120713;120700;34-607;727;533;528;425;103
2;120713;120700;34-607;716;520;518;412;106
1;120801;120800;32-250;825;576;572;334;238
2;120801;120800;32-250;736;451;447;247;200
3;120801;120800;32-250;765;526;520;417;103
4;120801;120800;32-250;334;215;212;176;36
5;120801;120800;32-250;653;447;441;343;98
6;120801;120800;32-250;741;502;498;376;122
7;120801;120800;32-250;325;219;218;181;37
8;120801;120800;32-250;269;186;183;111;72
9;120801;120800;32-250;407;312;310;243;67
10;120801;120800;32-250;309;207;205;130;75
11;120801;120800;32-250;332;221;219;177;42
12;120801;120800;32-250;27;11;11;10;1
1;120802;120800;32-075;924;680;671;510;161
2;120802;120800;32-075;349;259;259;207;52
3;120802;120800;32-075;855;575;573;403;170
4;120802;120800;32-075;433;306;302;214;88
5;120802;120800;32-075;396;286;283;226;57
6;120802;120800;32-075;537;350;348;219;129
7;120802;120800;32-075;403;260;260;193;67
8;120802;120800;32-075;249;176;175;110;65
9;120802;120800;32-075;291;192;191;154;37
10;120802;120800;32-075;284;207;206;152;54
1;120803;120800;32-241;512;324;323;261;62
2;120803;120800;32-241;308;203;202;156;46
3;120803;120800;32-241;385;229;226;176;50
4;120803;120800;32-241;490;329;329;247;82
5;120803;120800;32-241;822;568;565;449;116
6;120803;120800;32-241;419;284;282;212;70
7;120803;120800;32-241;306;184;183;147;36
8;120803;120800;32-241;227;154;154;128;26
9;120803;120800;32-241;202;149;148;137;11
1;120804;120800;32-210;573;368;363;285;78
2;120804;120800;32-210;654;485;475;317;158
3;120804;120800;32-210;404;293;289;208;81
4;120804;120800;32-210;363;265;262;197;65
5;120804;120800;32-210;213;159;158;115;43
6;120804;120800;32-210;226;155;155;124;31
7;120804;120800;32-210;246;182;182;156;26
8;120804;120800;32-210;182;125;125;101;24
9;120804;120800;32-210;296;214;214;162;52
10;120804;120800;32-210;253;179;178;145;33
11;120804;120800;32-210;124;91;88;73;15
12;120804;120800;32-210;200;156;155;113;42
13;120804;120800;32-210;175;136;134;110;24
14;120804;120800;32-210;51;32;31;27;4
1;120805;120800;32-200;1110;822;814;457;357
2;120805;120800;32-200;761;537;534;262;272
3;120805;120800;32-200;754;552;549;295;254
4;120805;120800;32-200;1074;776;769;455;314
5;120805;120800;32-200;921;675;671;361;310
6;120805;120800;32-200;1029;692;685;412;273
7;120805;120800;32-200;1291;988;976;504;472
8;120805;120800;32-200;689;522;518;243;275
9;120805;120800;32-200;729;549;544;294;250
10;120805;120800;32-200;221;143;141;102;39
11;120805;120800;32-200;224;157;155;109;46
12;120805;120800;32-200;633;441;438;339;99
13;120805;120800;32-200;232;148;147;104;43
14;120805;120800;32-200;274;194;192;137;55
15;120805;120800;32-200;406;290;288;227;61
16;120805;120800;32-200;289;200;200;125;75
17;120805;120800;32-200;808;582;581;404;177
18;120805;120800;32-200;622;409;401;317;84
19;120805;120800;32-200;408;294;293;228;65
20;120805;120800;32-200;279;193;188;147;41
21;120805;120800;32-200;261;182;180;141;39
22;120805;120800;32-200;153;107;107;83;24
23;120805;120800;32-200;319;227;226;167;59
24;120805;120800;32-200;275;196;194;148;46
25;120805;120800;32-200;263;167;167;104;63
26;120805;120800;32-200;208;137;136;106;30
27;120805;120800;32-200;217;139;139;99;40
28;120805;120800;32-200;110;61;60;43;17
29;120805;120800;32-200;30;30;29;20;9
30;120805;120800;32-200;48;14;14;9;5
31;120805;120800;32-200;46;28;27;20;7
1;120806;120800;32-222;703;471;463;350;113
2;120806;120800;32-222;259;166;165;128;37
3;120806;120800;32-222;514;330;330;270;60
4;120806;120800;32-222;320;218;217;154;63
5;120806;120800;32-222;154;105;105;94;11
1;120807;120800;32-218;715;458;455;340;115
2;120807;120800;32-218;514;339;336;266;70
3;120807;120800;32-218;610;441;438;286;152
4;120807;120800;32-218;238;150;149;118;31
5;120807;120800;32-218;205;144;143;109;34
6;120807;120800;32-218;193;141;141;102;39
7;120807;120800;32-218;177;106;105;89;16
8;120807;120800;32-218;166;125;125;90;35
1;120901;120900;32-410;1502;1085;1079;672;407
2;120901;120900;32-410;1481;1122;1107;708;399
3;120901;120900;32-410;1052;805;798;420;378
4;120901;120900;32-410;1167;836;831;557;274
5;120901;120900;32-410;926;694;684;525;159
6;120901;120900;32-410;534;425;420;339;81
7;120901;120900;32-410;385;295;291;201;90
8;120901;120900;32-410;394;310;305;228;77
9;120901;120900;32-410;545;431;424;286;138
10;120901;120900;32-410;492;342;340;257;83
11;120901;120900;32-410;452;351;350;254;96
12;120901;120900;32-410;375;286;286;204;82
13;120901;120900;32-410;312;247;246;175;71
14;120901;120900;32-410;734;561;555;409;146
15;120901;120900;32-410;532;416;412;316;96
16;120901;120900;32-410;832;601;595;393;202
1;120902;120900;32-433;1427;1064;1057;832;225
2;120902;120900;32-433;1370;987;978;836;142
3;120902;120900;32-433;1762;1374;1362;1197;165
4;120902;120900;32-433;708;522;519;408;111
5;120902;120900;32-434;2161;1576;1562;1234;328
6;120902;120900;32-433;26;9;9;7;2
1;120903;120900;32-400;1993;1564;1554;764;790
2;120903;120900;32-400;1810;1389;1372;729;643
3;120903;120900;32-400;1405;1091;1088;694;394
4;120903;120900;32-400;903;685;678;310;368
5;120903;120900;32-400;1174;921;908;451;457
6;120903;120900;32-400;1318;1047;1036;452;584
7;120903;120900;32-400;2070;1638;1621;929;692
8;120903;120900;32-400;1095;831;824;429;395
9;120903;120900;32-400;1643;1157;1143;603;540
10;120903;120900;32-444;884;691;687;431;256
11;120903;120900;32-400;1039;803;797;676;121
12;120903;120900;32-400;1276;909;897;638;259
13;120903;120900;32-400;2503;1952;1935;1334;601
14;120903;120900;32-400;1334;983;973;656;317
15;120903;120900;32-444;2446;1860;1851;1212;639
16;120903;120900;32-445;2114;1685;1666;1199;467
17;120903;120900;32-400;917;662;659;466;193
18;120903;120900;32-445;1085;866;853;622;231
19;120903;120900;32-400;997;769;757;575;182
20;120903;120900;32-400;1546;1159;1152;738;414
21;120903;120900;32-425;886;621;617;446;171
22;120903;120900;32-425;1819;1421;1407;991;416
23;120903;120900;32-425;726;562;558;411;147
24;120903;120900;32-425;837;630;622;452;170
25;120903;120900;32-400;240;193;192;169;23
26;120903;120900;32-400;100;50;50;35;15
27;120903;120900;32-425;51;36;35;21;14
28;120903;120900;32-444;20;20;19;11;8
29;120903;120900;32-444;25;25;25;10;15
30;120903;120900;32-444;77;28;28;18;10
31;120903;120900;32-400;85;23;23;7;16
1;120904;120900;32-432;1444;1169;1152;904;248
2;120904;120900;32-432;1138;867;855;613;242
3;120904;120900;32-432;1150;879;873;692;181
4;120904;120900;32-431;1043;765;758;604;154
5;120904;120900;32-431;1407;1082;1080;775;305
6;120904;120900;32-438;1838;1351;1341;1047;294
7;120904;120900;32-432;341;257;256;219;37
8;120904;120900;32-432;51;33;30;22;8
1;120905;120900;32-415;881;604;602;371;231
2;120905;120900;32-415;688;480;477;358;119
3;120905;120900;32-414;800;567;564;449;115
4;120905;120900;32-415;657;460;459;341;118
5;120905;120900;32-415;247;183;182;143;39
6;120905;120900;32-415;320;234;233;178;55
7;120905;120900;32-415;203;155;155;116;39
8;120905;120900;32-415;422;299;298;259;39
9;120905;120900;32-415;197;145;143;110;33
10;120905;120900;32-415;363;290;288;246;42
11;120905;120900;32-415;195;129;128;110;18
1;120906;120900;32-447;1239;923;917;576;341
2;120906;120900;32-447;1446;1108;1099;683;416
3;120906;120900;32-447;1229;946;938;570;368
4;120906;120900;32-406;1740;1308;1293;981;312
5;120906;120900;32-406;974;738;733;551;182
6;120906;120900;32-447;512;443;438;300;138
1;120907;120900;32-440;638;426;425;245;180
2;120907;120900;32-440;1711;1293;1275;839;436
3;120907;120900;32-440;1282;947;932;649;283
4;120907;120900;32-440;1439;1045;1042;841;201
5;120907;120900;32-440;1360;974;966;804;162
6;120907;120900;32-440;1044;709;707;503;204
7;120907;120900;32-440;1745;1339;1331;910;421
8;120907;120900;32-440;742;558;553;400;153
9;120907;120900;32-442;1646;1249;1237;764;473
1;120908;120900;32-435;1949;1529;1517;1247;270
2;120908;120900;32-437;1292;925;918;761;157
3;120908;120900;32-436;1615;1251;1247;1019;228
4;120908;120900;32-436;848;637;633;546;87
5;120908;120900;32-436;358;266;262;215;47
6;120908;120900;32-437;514;402;399;343;56
1;120909;120900;32-412;368;272;269;178;91
2;120909;120900;32-412;377;312;309;285;24
3;120909;120900;32-412;1278;1031;1017;865;152
4;120909;120900;32-412;401;299;298;249;49
5;120909;120900;32-412;1026;798;789;667;122
6;120909;120900;32-412;513;402;396;337;59
7;120909;120900;32-412;1770;1312;1302;1051;251
1;121001;121000;33-330;1169;904;899;783;116
2;121001;121000;33-330;1264;903;896;651;245
3;121001;121000;33-330;898;650;643;305;338
4;121001;121000;33-330;1037;800;788;648;140
1;121002;121000;33-395;1233;964;957;651;306
2;121002;121000;33-395;742;555;552;439;113
3;121002;121000;33-395;460;332;329;281;48
4;121002;121000;33-393;1233;916;901;730;171
5;121002;121000;33-394;803;562;559;444;115
6;121002;121000;33-394;936;702;695;579;116
7;121002;121000;33-311;483;377;377;337;40
8;121002;121000;33-300;1007;775;767;642;125
9;121002;121000;33-326;1148;886;882;748;134
10;121002;121000;33-300;1148;862;856;712;144
11;121002;121000;33-394;712;547;544;467;77
12;121002;121000;33-395;744;578;574;400;174
13;121002;121000;33-311;694;513;510;414;96
14;121002;121000;33-300;475;360;359;307;52
15;121002;121000;33-395;575;457;454;388;66
16;121002;121000;33-300;412;346;345;273;72
17;121002;121000;33-395;723;547;543;374;169
18;121002;121000;33-311;1032;787;782;623;159
19;121002;121000;33-300;115;94;94;85;9
20;121002;121000;33-393;387;289;289;227;62
21;121002;121000;33-395;1604;1242;1230;791;439
22;121002;121000;33-395;1024;822;817;599;218
23;121002;121000;33-395;1327;1018;1015;931;84
24;121002;121000;33-393;401;310;306;247;59
25;121002;121000;33-311;981;773;767;585;182
26;121002;121000;33-326;620;457;452;387;65
27;121002;121000;33-311;325;253;252;204;48
28;121002;121000;33-394;47;35;35;33;2
29;121002;121000;33-394;34;8;8;8;0
1;121003;121000;33-316;1514;1115;1115;864;251
2;121003;121000;33-316;896;586;581;455;126
3;121003;121000;33-318;1013;736;733;621;112
4;121003;121000;33-318;995;695;694;611;83
5;121003;121000;33-318;497;376;374;304;70
6;121003;121000;33-318;687;492;488;307;181
7;121003;121000;33-318;495;372;369;310;59
8;121003;121000;33-318;314;231;227;192;35
9;121003;121000;33-318;529;389;385;344;41
10;121003;121000;33-318;62;34;32;24;8
1;121004;121000;33-330;2048;1538;1528;1269;259
2;121004;121000;33-332;1026;784;780;714;66
3;121004;121000;33-333;1171;922;920;808;112
4;121004;121000;33-332;1191;861;853;776;77
5;121004;121000;33-331;831;677;673;614;59
6;121004;121000;33-330;1750;1395;1390;1317;73
7;121004;121000;33-325;1142;914;904;822;82
8;121004;121000;33-331;809;637;629;547;82
9;121004;121000;33-333;1487;1176;1166;914;252
10;121004;121000;33-333;939;762;755;664;91
11;121004;121000;33-330;1572;1234;1227;1092;135
12;121004;121000;33-325;769;580;578;515;63
13;121004;121000;33-331;1929;1446;1437;1070;367
14;121004;121000;33-332;388;313;311;295;16
15;121004;121000;33-331;484;363;360;289;71
16;121004;121000;33-325;756;623;622;565;57
17;121004;121000;33-325;212;166;165;145;20
1;121005;121000;33-334;1277;1004;995;787;208
2;121005;121000;33-334;1511;1184;1179;960;219
3;121005;121000;33-334;709;545;537;458;79
4;121005;121000;33-300;579;449;444;357;87
5;121005;121000;33-334;941;763;755;662;93
6;121005;121000;33-334;549;443;441;356;85
7;121005;121000;33-334;609;507;505;445;60
8;121005;121000;33-334;1418;1093;1089;907;182
1;121006;121000;33-322;1856;1459;1450;1225;225
2;121006;121000;33-326;821;632;631;540;91
3;121006;121000;33-322;895;665;664;575;89
4;121006;121000;33-322;772;555;554;487;67
5;121006;121000;33-323;192;133;133;108;25
6;121006;121000;33-323;1383;1048;1045;952;93
7;121006;121000;33-322;1103;852;848;732;116
8;121006;121000;33-322;407;296;290;261;29
9;121006;121000;33-326;981;733;726;626;100
10;121006;121000;33-322;535;417;414;364;50
11;121006;121000;33-322;375;312;311;263;48
12;121006;121000;33-322;437;349;343;311;32
13;121006;121000;33-326;603;465;463;421;42
14;121006;121000;33-322;397;315;313;273;40
1;121007;121000;33-380;909;657;649;403;246
2;121007;121000;33-380;1257;827;818;445;373
3;121007;121000;33-380;1720;1168;1164;597;567
4;121007;121000;33-380;938;631;625;388;237
5;121007;121000;33-380;1230;1042;1035;513;522
6;121007;121000;33-380;1420;1257;1248;561;687
7;121007;121000;33-380;1183;879;875;463;412
8;121007;121000;33-380;1240;1035;1021;479;542
9;121007;121000;33-383;550;354;354;292;62
10;121007;121000;33-383;597;365;363;257;106
11;121007;121000;33-383;1013;723;718;477;241
12;121007;121000;33-383;436;268;266;197;69
13;121007;121000;33-383;304;178;177;137;40
14;121007;121000;33-380;619;438;437;310;127
15;121007;121000;33-380;428;298;297;234;63
16;121007;121000;33-380;309;200;199;155;44
17;121007;121000;33-380;238;177;176;148;28
18;121007;121000;33-380;47;24;24;20;4
1;121008;121000;33-336;450;335;332;302;30
2;121008;121000;33-336;634;484;478;430;48
3;121008;121000;33-336;1402;1042;1038;818;220
4;121008;121000;33-336;945;673;667;585;82
5;121008;121000;33-336;490;369;367;332;35
6;121008;121000;33-336;174;126;124;103;21
7;121008;121000;33-336;165;128;126;103;23
8;121008;121000;33-336;137;95;95;92;3
1;121009;121000;33-390;869;653;649;504;145
2;121009;121000;33-390;469;326;326;254;72
3;121009;121000;33-389;1596;1154;1149;978;171
4;121009;121000;33-389;1065;753;745;665;80
5;121009;121000;33-390;1406;1049;1042;797;245
6;121009;121000;33-390;1620;1194;1185;1075;110
7;121009;121000;33-390;562;420;420;329;91
8;121009;121000;33-389;459;343;337;310;27
9;121009;121000;33-390;614;481;474;433;41
10;121009;121000;33-390;399;337;335;307;28
11;121009;121000;33-390;1487;1128;1111;833;278
12;121009;121000;33-389;812;609;603;495;108
13;121009;121000;33-390;793;581;576;509;67
1;121010;121000;33-314;1205;920;909;785;124
2;121010;121000;33-314;996;798;794;715;79
3;121010;121000;33-312;1799;1461;1456;1203;253
4;121010;121000;33-312;838;642;639;576;63
5;121010;121000;33-314;765;546;544;466;78
6;121010;121000;33-314;390;322;322;282;40
7;121010;121000;33-314;448;344;342;302;40
8;121010;121000;33-312;501;415;411;306;105
9;121010;121000;33-314;358;298;298;257;41
10;121010;121000;33-312;475;371;371;343;28
11;121010;121000;33-312;238;186;186;181;5
12;121010;121000;33-314;261;205;205;189;16
1;121011;121000;33-370;1360;1017;1008;632;376
2;121011;121000;33-370;413;330;328;158;170
3;121011;121000;33-370;1422;1025;1013;551;462
4;121011;121000;33-370;770;500;496;366;130
5;121011;121000;33-370;369;253;250;202;48
6;121011;121000;33-370;568;420;418;361;57
7;121011;121000;33-370;796;515;512;370;142
8;121011;121000;33-370;732;534;533;408;125
9;121011;121000;33-370;772;562;556;339;217
10;121011;121000;33-370;377;229;228;186;42
11;121011;121000;33-370;1277;896;889;642;247
12;121011;121000;33-370;183;108;107;78;29
13;121011;121000;33-370;185;130;130;113;17
14;121011;121000;33-370;59;49;45;28;17
1;121012;121000;33-335;919;675;671;483;188
2;121012;121000;33-335;1005;760;758;642;116
3;121012;121000;33-335;861;657;652;581;71
4;121012;121000;33-335;432;322;321;289;32
5;121012;121000;33-335;433;329;327;304;23
6;121012;121000;33-335;376;287;286;270;16
7;121012;121000;33-335;1194;895;893;708;185
8;121012;121000;33-335;1124;841;834;694;140
1;121013;121000;33-350;1997;1416;1407;959;448
2;121013;121000;33-350;1543;1039;1032;746;286
3;121013;121000;33-350;924;592;584;456;128
4;121013;121000;33-350;328;234;232;183;49
5;121013;121000;33-350;468;290;289;258;31
6;121013;121000;33-350;1411;940;931;835;96
7;121013;121000;33-350;598;427;421;350;71
8;121013;121000;33-350;283;193;192;154;38
9;121013;121000;33-350;389;274;273;221;52
1;121014;121000;33-386;1934;1548;1532;1254;278
2;121014;121000;33-386;342;266;264;242;22
3;121014;121000;33-386;674;488;484;433;51
4;121014;121000;33-386;1159;849;837;750;87
5;121014;121000;33-386;438;331;329;296;33
6;121014;121000;33-386;261;202;198;173;25
7;121014;121000;33-386;643;476;472;425;47
8;121014;121000;33-386;197;170;170;146;24
9;121014;121000;33-386;908;687;680;594;86
10;121014;121000;33-386;526;448;445;416;29
11;121014;121000;33-386;1489;1164;1157;946;211
12;121014;121000;33-386;520;389;389;297;92
13;121014;121000;33-386;681;526;522;449;73
1;121015;121000;33-343;1525;1100;1094;823;271
2;121015;121000;33-343;1229;887;878;746;132
1;121016;121000;33-340;780;619;618;430;188
2;121016;121000;33-340;1848;1293;1281;871;410
3;121016;121000;33-340;1210;879;873;584;289
4;121016;121000;33-340;2141;1610;1597;1136;461
5;121016;121000;33-340;670;482;478;394;84
6;121016;121000;33-388;1645;1295;1289;1077;212
7;121016;121000;33-388;876;670;663;597;66
8;121016;121000;33-342;2041;1459;1446;1127;319
9;121016;121000;33-342;1553;1124;1114;941;173
10;121016;121000;33-340;1296;1012;1006;849;157
11;121016;121000;33-340;1067;852;840;669;171
12;121016;121000;33-340;491;354;352;322;30
13;121016;121000;33-342;276;203;203;191;12
14;121016;121000;33-340;525;410;408;334;74
15;121016;121000;33-388;551;419;412;355;57
16;121016;121000;33-342;571;435;428;306;122
1;121101;121100;34-400;1357;946;943;581;362
2;121101;121100;34-400;1192;843;836;582;254
3;121101;121100;34-400;1173;758;751;499;252
4;121101;121100;34-400;1043;680;676;397;279
5;121101;121100;34-400;1301;905;899;479;420
6;121101;121100;34-400;1516;1095;1089;565;524
7;121101;121100;34-400;1371;975;971;588;383
8;121101;121100;34-400;1080;752;747;461;286
9;121101;121100;34-400;1271;832;822;469;353
10;121101;121100;34-400;1329;965;957;484;473
11;121101;121100;34-400;1397;957;946;539;407
12;121101;121100;34-400;1041;702;700;434;266
13;121101;121100;34-400;1014;605;602;323;279
14;121101;121100;34-400;940;600;598;324;274
15;121101;121100;34-400;1072;689;681;365;316
16;121101;121100;34-400;955;622;620;341;279
17;121101;121100;34-400;948;645;634;312;322
18;121101;121100;34-400;691;502;494;256;238
19;121101;121100;34-400;1142;751;744;423;321
20;121101;121100;34-400;1072;715;710;409;301
21;121101;121100;34-400;1638;1147;1135;509;626
22;121101;121100;34-400;391;137;137;96;41
1;121102;121100;34-460;535;386;381;226;155
2;121102;121100;34-460;724;490;483;319;164
3;121102;121100;34-460;1243;796;790;485;305
4;121102;121100;34-460;1235;954;935;426;509
5;121102;121100;34-460;1063;727;725;358;367
6;121102;121100;34-460;1488;1025;1017;591;426
1;121103;121100;34-470;785;428;422;252;170
2;121103;121100;34-470;906;473;472;336;136
3;121103;121100;34-470;1135;548;544;382;162
4;121103;121100;34-470;425;203;202;157;45
5;121103;121100;34-408;688;401;399;347;52
6;121103;121100;34-408;394;194;193;176;17
7;121103;121100;34-408;730;378;374;315;59
8;121103;121100;34-408;564;384;384;349;35
9;121103;121100;34-472;649;414;411;373;38
10;121103;121100;34-472;879;515;512;446;66
11;121103;121100;34-472;881;550;547;488;59
12;121103;121100;34-470;759;360;357;307;50
13;121103;121100;34-470;317;185;183;158;25
14;121103;121100;34-513;1015;615;610;453;157
15;121103;121100;34-407;774;432;429;339;90
16;121103;121100;34-407;827;447;447;387;60
17;121103;121100;34-407;728;437;434;383;51
18;121103;121100;34-407;865;543;539;477;62
19;121103;121100;34-407;872;506;505;452;53
20;121103;121100;34-407;575;326;325;292;33
21;121103;121100;34-407;717;462;457;363;94
22;121103;121100;34-407;638;387;387;349;38
23;121103;121100;34-407;620;296;294;242;52
1;121104;121100;34-436;478;309;306;219;87
2;121104;121100;34-436;1443;854;842;588;254
3;121104;121100;34-440;466;303;301;232;69
4;121104;121100;34-440;1535;1054;1050;716;334
5;121104;121100;34-440;350;274;272;149;123
6;121104;121100;34-443;952;665;663;489;174
7;121104;121100;34-443;922;674;669;381;288
8;121104;121100;34-436;27;15;14;8;6
1;121105;121100;34-481;896;548;545;450;95
2;121105;121100;34-480;2029;1456;1452;1241;211
3;121105;121100;34-480;1248;867;860;659;201
4;121105;121100;34-482;1754;1265;1260;1134;126
5;121105;121100;34-480;818;599;594;508;86
6;121105;121100;34-722;1835;1322;1316;1203;113
7;121105;121100;34-484;1407;980;971;883;88
8;121105;121100;34-484;1129;789;788;671;117
9;121105;121100;34-480;783;571;565;520;45
10;121105;121100;34-482;887;615;614;581;33
11;121105;121100;34-484;1119;827;822;725;97
1;121106;121100;34-450;939;664;656;396;260
2;121106;121100;34-450;1415;1012;1003;553;450
3;121106;121100;34-450;781;546;536;390;146
4;121106;121100;34-450;1194;812;807;615;192
5;121106;121100;34-450;194;135;135;115;20
6;121106;121100;34-450;842;583;576;482;94
1;121107;121100;34-483;514;360;357;301;56
2;121107;121100;34-483;1032;733;729;661;68
3;121107;121100;34-483;1318;863;860;729;131
4;121107;121100;34-483;830;577;569;506;63
5;121107;121100;34-483;744;495;492;422;70
1;121108;121100;34-435;1275;757;747;574;173
2;121108;121100;34-435;283;202;198;153;45
3;121108;121100;34-441;256;190;189;118;71
4;121108;121100;34-441;1439;871;862;624;238
5;121108;121100;34-441;1004;609;605;474;131
6;121108;121100;34-442;1234;773;769;608;161
7;121108;121100;34-442;756;455;454;379;75
8;121108;121100;34-442;358;257;255;225;30
9;121108;121100;34-442;631;365;362;318;44
1;121109;121100;34-434;652;433;429;345;84
2;121109;121100;34-434;519;383;380;273;107
3;121109;121100;34-432;1328;962;953;574;379
4;121109;121100;34-431;1009;602;598;427;171
5;121109;121100;34-431;1876;1265;1263;920;343
6;121109;121100;34-400;1310;796;791;629;162
7;121109;121100;34-433;1150;706;700;541;159
8;121109;121100;34-433;1035;643;641;423;218
9;121109;121100;34-433;426;313;312;242;70
10;121109;121100;34-404;1189;799;791;639;152
11;121109;121100;34-404;866;579;579;464;115
12;121109;121100;34-404;514;293;291;244;47
13;121109;121100;34-404;742;499;494;409;85
14;121109;121100;34-471;537;323;321;294;27
15;121109;121100;34-471;399;198;198;181;17
16;121109;121100;34-471;1911;1198;1192;895;297
17;121109;121100;34-471;736;417;413;350;63
18;121109;121100;34-404;600;335;335;260;75
19;121109;121100;34-434;399;265;263;195;68
20;121109;121100;34-434;493;326;324;257;67
21;121109;121100;34-404;456;296;295;254;41
1;121110;121100;34-453;1676;1189;1178;989;189
2;121110;121100;34-452;1785;1281;1269;1084;185
3;121110;121100;34-452;618;486;486;447;39
4;121110;121100;34-451;2343;1667;1655;1375;280
1;121111;121100;34-721;1247;846;841;630;211
2;121111;121100;34-721;2030;1328;1316;958;358
3;121111;121100;34-723;332;214;214;176;38
4;121111;121100;34-721;1278;852;843;619;224
5;121111;121100;34-721;592;408;406;357;49
6;121111;121100;34-721;440;302;301;274;27
7;121111;121100;34-721;199;132;130;119;11
8;121111;121100;34-713;2048;1366;1361;1071;290
9;121111;121100;34-713;1304;904;901;717;184
10;121111;121100;34-723;1419;877;872;720;152
11;121111;121100;34-721;32;20;20;18;2
1;121112;121100;34-700;798;542;537;354;183
2;121112;121100;34-700;1280;907;902;703;199
3;121112;121100;34-700;886;607;602;435;167
4;121112;121100;34-700;1208;854;842;550;292
5;121112;121100;34-700;1157;821;817;452;365
6;121112;121100;34-700;1245;912;898;498;400
7;121112;121100;34-700;1695;1300;1290;746;544
8;121112;121100;34-700;1533;1113;1104;681;423
9;121112;121100;34-720;1135;753;741;582;159
10;121112;121100;34-700;888;613;608;481;127
11;121112;121100;34-700;1170;808;802;683;119
12;121112;121100;34-700;26;14;14;11;3
13;121112;121100;34-700;44;26;25;17;8
14;121112;121100;34-700;26;7;6;4;2
15;121112;121100;34-700;97;97;96;65;31
1;121113;121100;34-745;732;469;466;408;58
2;121113;121100;34-745;668;460;456;359;97
3;121113;121100;34-745;699;492;489;381;108
4;121113;121100;34-745;682;453;450;378;72
5;121113;121100;34-745;638;466;464;386;78
1;121114;121100;34-424;917;513;512;412;100
2;121114;121100;34-424;816;515;511;463;48
3;121114;121100;34-424;420;255;252;207;45
4;121114;121100;34-424;792;473;471;396;75
5;121114;121100;34-424;703;443;440;391;49
6;121114;121100;34-424;820;518;511;494;17
7;121114;121100;34-424;1311;783;779;587;192
8;121114;121100;34-424;1311;767;760;609;151
9;121114;121100;34-424;1173;679;675;501;174
10;121114;121100;34-424;59;34;31;24;7
1;121201;121200;32-332;287;199;196;108;88
2;121201;121200;32-332;396;265;264;157;107
3;121201;121200;32-332;1005;710;703;318;385
4;121201;121200;32-332;448;325;324;134;190
5;121201;121200;32-332;790;491;487;248;239
6;121201;121200;32-332;1471;1003;991;486;505
7;121201;121200;32-332;1295;929;913;469;444
8;121201;121200;32-332;526;392;391;150;241
9;121201;121200;32-332;1144;788;780;411;369
10;121201;121200;32-332;94;29;29;10;19
1;121203;121200;32-329;2031;1400;1387;622;765
2;121203;121200;32-329;1102;765;756;410;346
3;121203;121200;32-329;1154;780;776;411;365
4;121203;121200;32-329;1029;697;687;412;275
5;121203;121200;32-329;610;426;421;224;197
6;121203;121200;32-329;118;53;51;39;12
1;121204;121200;32-310;1016;722;716;306;410
2;121204;121200;32-310;1387;1013;1001;432;569
3;121204;121200;32-310;1349;1007;999;509;490
4;121204;121200;32-310;700;509;504;261;243
5;121204;121200;32-310;954;698;698;387;311
6;121204;121200;32-310;1192;877;868;576;292
7;121204;121200;32-310;239;194;191;116;75
8;121204;121200;32-310;909;657;653;319;334
9;121204;121200;32-310;415;340;339;217;122
10;121204;121200;32-310;415;296;295;196;99
11;121204;121200;32-310;779;596;594;328;266
12;121204;121200;32-310;222;157;155;84;71
13;121204;121200;32-310;269;208;205;99;106
14;121204;121200;32-310;236;185;182;78;104
15;121204;121200;32-310;1271;936;925;376;549
16;121204;121200;32-310;138;98;95;56;39
1;121205;121200;32-300;828;608;602;262;340
2;121205;121200;32-300;1467;950;942;483;459
3;121205;121200;32-300;774;577;572;276;296
4;121205;121200;32-300;1419;1104;1095;516;579
5;121205;121200;32-300;1340;1011;1005;475;530
6;121205;121200;32-300;2187;1765;1749;882;867
7;121205;121200;32-300;1990;1450;1439;743;696
8;121205;121200;32-300;1688;1251;1242;687;555
9;121205;121200;32-300;1213;915;895;414;481
10;121205;121200;32-300;1505;1068;1058;496;562
11;121205;121200;32-300;1470;1090;1085;516;569
12;121205;121200;32-300;1285;974;963;462;501
13;121205;121200;32-300;1565;1164;1160;573;587
14;121205;121200;32-300;1449;1046;1034;508;526
15;121205;121200;32-300;1308;912;910;479;431
16;121205;121200;32-300;1487;1108;1098;566;532
17;121205;121200;32-300;1389;1096;1088;415;673
18;121205;121200;32-300;559;436;430;200;230
19;121205;121200;32-300;597;434;433;321;112
20;121205;121200;32-300;450;369;368;221;147
21;121205;121200;32-300;416;311;310;237;73
22;121205;121200;32-300;751;566;561;314;247
23;121205;121200;32-300;954;723;715;423;292
24;121205;121200;32-300;1476;1121;1110;717;393
25;121205;121200;32-300;508;368;365;272;93
26;121205;121200;32-300;780;595;589;486;103
27;121205;121200;32-300;922;728;718;434;284
28;121205;121200;32-327;983;763;754;491;263
29;121205;121200;32-300;446;299;293;207;86
30;121205;121200;32-300;1114;868;861;698;163
31;121205;121200;32-327;502;370;367;268;99
32;121205;121200;32-300;94;51;46;36;10
33;121205;121200;32-300;98;40;40;21;19
34;121205;121200;32-300;128;28;28;16;12
1;121206;121200;32-353;1037;760;753;593;160
2;121206;121200;32-353;633;467;466;415;51
3;121206;121200;32-353;481;338;336;260;76
4;121206;121200;32-353;949;747;742;554;188
5;121206;121200;32-353;603;476;473;296;177
6;121206;121200;32-353;341;257;254;222;32
7;121206;121200;32-353;454;314;311;253;58
8;121206;121200;32-353;313;246;246;192;54
9;121206;121200;32-353;224;160;159;124;35
10;121206;121200;32-353;243;172;172;115;57
11;121206;121200;32-353;248;195;193;163;30
1;121207;121200;32-340;675;509;502;362;140
2;121207;121200;32-340;540;419;418;273;145
3;121207;121200;32-340;577;410;407;329;78
4;121207;121200;32-310;447;309;306;231;75
5;121207;121200;32-340;999;725;719;502;217
6;121207;121200;32-340;928;645;641;512;129
7;121207;121200;32-340;703;543;541;452;89
8;121207;121200;32-340;850;628;620;425;195
9;121207;121200;32-340;530;373;371;293;78
10;121207;121200;32-340;466;342;340;245;95
11;121207;121200;32-340;573;419;416;343;73
12;121207;121200;32-340;549;367;364;240;124
13;121207;121200;32-340;1043;756;747;505;242
14;121207;121200;32-340;1364;1007;1000;584;416
15;121207;121200;32-340;845;579;573;320;253
16;121207;121200;32-340;940;680;673;385;288
17;121207;121200;32-340;810;566;563;326;237
18;121207;121200;32-340;628;439;434;216;218
19;121207;121200;32-340;751;545;543;249;294
20;121207;121200;32-340;800;551;546;279;267
21;121207;121200;32-310;334;247;244;174;70
22;121207;121200;32-340;217;165;165;141;24
23;121207;121200;32-340;300;222;220;167;53
24;121207;121200;32-340;262;185;185;140;45
25;121207;121200;32-340;370;271;270;163;107
26;121207;121200;32-340;190;130;128;107;21
27;121207;121200;32-340;401;295;291;191;100
1;121301;121300;32-600;1898;1309;1292;679;613
2;121301;121300;32-600;2156;1547;1535;697;838
3;121301;121300;32-600;673;483;477;238;239
4;121301;121300;32-600;581;415;408;154;254
5;121301;121300;32-600;1066;747;741;337;404
6;121301;121300;32-600;1077;721;719;374;345
7;121301;121300;32-600;1720;1292;1280;564;716
8;121301;121300;32-600;725;501;495;260;235
9;121301;121300;32-600;788;621;616;306;310
10;121301;121300;32-600;1166;777;771;393;378
11;121301;121300;32-600;448;336;328;148;180
12;121301;121300;32-600;992;745;737;314;423
13;121301;121300;32-600;1345;1010;1001;478;523
14;121301;121300;32-600;1007;719;711;412;299
15;121301;121300;32-600;1167;777;766;344;422
16;121301;121300;32-600;1191;863;855;352;503
17;121301;121300;32-600;1044;726;722;340;382
18;121301;121300;32-600;1552;1150;1138;423;715
19;121301;121300;32-600;1310;908;900;402;498
20;121301;121300;32-600;533;369;366;135;231
21;121301;121300;32-600;1009;734;729;302;427
22;121301;121300;32-600;1347;1030;1015;510;505
23;121301;121300;32-600;1994;1481;1467;623;844
24;121301;121300;32-600;229;123;122;56;66
25;121301;121300;32-600;66;21;21;16;5
1;121302;121300;32-620;1591;1079;1064;565;499
2;121302;121300;32-620;1165;801;795;423;372
3;121302;121300;32-620;1054;851;843;368;475
4;121302;121300;32-620;1648;1272;1264;744;520
5;121302;121300;32-620;1801;1306;1299;717;582
6;121302;121300;32-620;748;569;562;347;215
7;121302;121300;32-626;1558;1148;1139;609;530
8;121302;121300;32-626;1100;886;881;424;457
9;121302;121300;32-626;1172;881;871;492;379
10;121302;121300;32-625;882;627;622;363;259
11;121302;121300;32-625;647;473;464;294;170
12;121302;121300;32-626;628;471;465;355;110
13;121302;121300;32-625;345;279;274;173;101
14;121302;121300;32-626;1129;856;851;478;373
1;121303;121300;32-660;1247;877;867;439;428
2;121303;121300;32-660;1301;812;799;470;329
3;121303;121300;32-660;596;407;401;239;162
4;121303;121300;32-660;614;459;457;237;220
5;121303;121300;32-660;1235;946;935;443;492
6;121303;121300;32-661;1369;990;983;539;444
7;121303;121300;32-660;1463;1074;1060;605;455
8;121303;121300;32-661;1468;1068;1061;672;389
9;121303;121300;32-661;40;18;18;14;4
1;121304;121300;32-650;1524;1097;1091;527;564
2;121304;121300;32-650;1418;1013;1011;497;514
3;121304;121300;32-650;884;605;593;267;326
4;121304;121300;32-650;1073;744;736;375;361
5;121304;121300;32-650;906;652;643;319;324
6;121304;121300;32-650;1168;859;850;407;443
7;121304;121300;32-650;1145;771;765;443;322
8;121304;121300;32-650;1236;953;944;448;496
9;121304;121300;32-650;1154;893;879;373;506
10;121304;121300;32-650;854;594;583;266;317
11;121304;121300;32-650;1944;1446;1434;792;642
12;121304;121300;32-651;1419;1030;1016;631;385
13;121304;121300;32-652;1266;944;939;669;270
14;121304;121300;32-652;1212;871;855;605;250
15;121304;121300;32-652;1251;877;869;547;322
16;121304;121300;32-651;1016;738;730;467;263
17;121304;121300;32-651;1091;834;821;495;326
18;121304;121300;32-651;1296;993;981;549;432
19;121304;121300;32-651;1297;964;958;552;406
20;121304;121300;32-650;1830;1347;1341;990;351
21;121304;121300;32-652;51;26;25;21;4
1;121305;121300;32-608;2072;1478;1470;927;543
2;121305;121300;32-608;1550;1107;1099;735;364
3;121305;121300;32-608;1602;1164;1154;845;309
4;121305;121300;32-608;1071;773;770;545;225
1;121306;121300;32-600;1572;1174;1164;566;598
2;121306;121300;32-600;455;373;370;227;143
3;121306;121300;32-615;734;570;561;299;262
4;121306;121300;32-600;1732;1320;1298;687;611
5;121306;121300;32-600;564;440;435;288;147
6;121306;121300;32-600;1850;1436;1423;846;577
7;121306;121300;32-600;1214;954;940;510;430
8;121306;121300;32-642;1213;907;905;593;312
9;121306;121300;32-642;232;167;165;95;70
10;121306;121300;32-600;1299;1063;1055;448;607
11;121306;121300;32-615;954;676;671;362;309
12;121306;121300;32-600;302;226;225;153;72
13;121306;121300;32-642;277;207;206;117;89
14;121306;121300;32-615;1002;712;710;450;260
15;121306;121300;32-600;1102;883;877;355;522
16;121306;121300;32-615;55;15;13;6;7
1;121307;121300;32-607;1607;1213;1199;743;456
2;121307;121300;32-607;842;625;621;381;240
3;121307;121300;32-607;874;694;687;455;232
1;121308;121300;32-641;2094;1517;1504;804;700
2;121308;121300;32-641;789;581;576;322;254
3;121308;121300;32-641;1743;1269;1259;817;442
4;121308;121300;32-641;403;299;299;186;113
1;121309;121300;32-640;1329;941;931;521;410
2;121309;121300;32-640;379;295;292;215;77
3;121309;121300;32-640;350;253;251;141;110
4;121309;121300;32-640;709;519;517;328;189
5;121309;121300;32-640;1110;799;792;492;300
6;121309;121300;32-640;596;413;411;263;148
7;121309;121300;32-640;401;278;277;196;81
8;121309;121300;32-640;387;278;275;183;92
9;121309;121300;32-640;462;323;321;204;117
10;121309;121300;32-640;1157;878;871;431;440
11;121309;121300;32-640;241;177;177;111;66
12;121309;121300;32-640;56;20;18;11;7
1;121401;121400;32-104;812;573;569;376;193
2;121401;121400;32-104;336;218;216;161;55
3;121401;121400;32-104;591;397;392;290;102
4;121401;121400;32-104;472;299;298;211;87
5;121401;121400;32-104;689;489;486;361;125
6;121401;121400;32-104;668;462;461;362;99
7;121401;121400;32-104;134;100;98;78;20
8;121401;121400;32-104;588;441;438;308;130
9;121401;121400;32-104;421;344;342;220;122
10;121401;121400;32-104;279;186;185;160;25
11;121401;121400;32-104;349;243;241;188;53
12;121401;121400;32-104;246;198;194;142;52
13;121401;121400;32-104;263;195;193;165;28
14;121401;121400;32-104;296;227;226;173;53
15;121401;121400;32-104;173;112;112;94;18
16;121401;121400;32-104;230;155;154;123;31
17;121401;121400;32-104;178;111;109;99;10
18;121401;121400;32-104;198;149;148;127;21
19;121401;121400;32-104;64;50;48;38;10
1;121402;121400;32-130;796;517;513;350;163
2;121402;121400;32-130;647;431;423;333;90
3;121402;121400;32-130;718;457;455;334;121
4;121402;121400;32-130;361;234;231;180;51
5;121402;121400;32-130;316;221;221;188;33
6;121402;121400;32-130;302;183;181;137;44
7;121402;121400;32-130;167;106;105;88;17
8;121402;121400;32-130;177;112;109;90;19
9;121402;121400;32-130;298;165;163;106;57
10;121402;121400;32-130;218;148;147;104;43
11;121402;121400;32-130;257;167;165;129;36
1;121403;121400;32-120;1285;982;972;657;315
2;121403;121400;32-120;605;448;439;316;123
3;121403;121400;32-120;180;140;139;95;44
4;121403;121400;32-120;451;303;303;227;76
5;121403;121400;32-120;214;142;140;119;21
6;121403;121400;32-120;174;119;118;105;13
7;121403;121400;32-120;256;188;185;141;44
8;121403;121400;32-120;184;122;122;104;18
9;121403;121400;32-120;328;206;203;154;49
10;121403;121400;32-120;167;114;113;90;23
11;121403;121400;32-120;337;234;233;177;56
12;121403;121400;32-120;276;192;189;152;37
1;121404;121400;32-109;402;283;279;180;99
2;121404;121400;32-109;140;106;104;85;19
3;121404;121400;32-112;468;338;338;274;64
4;121404;121400;32-109;475;317;317;258;59
5;121404;121400;32-109;345;217;214;192;22
6;121404;121400;32-109;157;103;103;81;22
7;121404;121400;32-109;208;145;143;107;36
8;121404;121400;32-109;188;129;128;103;25
9;121404;121400;32-109;197;157;157;121;36
10;121404;121400;32-109;149;106;104;89;15
1;121405;121400;32-100;847;595;590;301;289
2;121405;121400;32-100;1370;927;918;493;425
3;121405;121400;32-100;1070;727;721;420;301
4;121405;121400;32-100;1222;868;860;485;375
5;121405;121400;32-112;1064;735;728;566;162
6;121405;121400;32-100;691;447;445;336;109
7;121405;121400;32-112;627;422;418;335;83
8;121405;121400;32-100;551;361;360;283;77
9;121405;121400;32-100;292;210;209;174;35
10;121405;121400;32-100;317;217;213;137;76
11;121405;121400;32-112;683;473;467;361;106
12;121405;121400;32-100;674;489;486;316;170
13;121405;121400;32-100;206;148;147;90;57
14;121405;121400;32-100;250;181;180;125;55
15;121405;121400;32-100;310;224;222;150;72
16;121405;121400;32-100;281;192;187;128;59
17;121405;121400;32-112;177;119;119;83;36
18;121405;121400;32-100;204;145;145;128;17
19;121405;121400;32-100;254;168;167;117;50
20;121405;121400;32-100;329;226;224;149;75
21;121405;121400;32-100;196;137;137;114;23
22;121405;121400;32-100;249;169;168;145;23
23;121405;121400;32-112;217;138;137;104;33
24;121405;121400;32-100;261;163;163;119;44
25;121405;121400;32-100;96;48;45;30;15
1;121406;121400;32-107;335;207;206;141;65
2;121406;121400;32-107;518;381;380;293;87
3;121406;121400;32-107;468;344;342;278;64
4;121406;121400;32-107;354;256;254;211;43
5;121406;121400;32-107;243;182;182;166;16
6;121406;121400;32-100;247;157;157;114;43
7;121406;121400;32-107;241;163;162;125;37
8;121406;121400;32-107;214;165;165;135;30
1;121501;121500;34-240;1187;843;835;558;277
2;121501;121500;34-240;1024;679;674;482;192
3;121501;121500;34-240;1182;869;863;521;342
4;121501;121500;34-240;462;329;324;177;147
1;121502;121500;34-200;1945;1382;1368;711;657
2;121502;121500;34-200;717;514;512;242;270
3;121502;121500;34-200;779;525;520;221;299
4;121502;121500;34-200;892;634;633;313;320
5;121502;121500;34-200;1545;1121;1105;573;532
6;121502;121500;34-200;902;635;629;438;191
7;121502;121500;34-200;131;58;56;36;20
1;121503;121500;34-212;1650;1160;1156;952;204
2;121503;121500;34-211;2166;1456;1449;1039;410
3;121503;121500;34-211;719;503;500;390;110
4;121503;121500;34-211;691;474;474;360;114
5;121503;121500;34-211;989;674;668;563;105
6;121503;121500;34-211;404;282;281;200;81
1;121504;121500;34-235;1439;978;972;719;253
2;121504;121500;34-235;1016;629;625;477;148
3;121504;121500;34-236;1442;1006;996;761;235
4;121504;121500;34-236;1282;907;902;772;130
1;121505;121500;34-242;2126;1557;1547;1233;314
2;121505;121500;34-240;1535;1039;1032;804;228
3;121505;121500;34-234;1095;797;792;603;189
4;121505;121500;34-234;1142;854;847;673;174
5;121505;121500;34-240;1692;1152;1139;946;193
6;121505;121500;34-240;660;448;447;379;68
7;121505;121500;34-242;58;28;28;24;4
1;121506;121500;34-220;949;633;628;409;219
2;121506;121500;34-220;1681;1196;1184;636;548
3;121506;121500;34-220;1655;1166;1154;596;558
4;121506;121500;34-220;1966;1374;1363;857;506
5;121506;121500;34-220;1759;1255;1246;959;287
6;121506;121500;34-231;1834;1329;1320;1139;181
7;121506;121500;34-231;486;350;347;273;74
8;121506;121500;34-231;520;366;359;254;105
9;121506;121500;34-220;949;681;678;543;135
10;121506;121500;34-220;129;27;25;20;5
11;121506;121500;34-220;99;19;19;12;7
12;121506;121500;34-220;56;42;40;18;22
1;121507;121500;34-206;1299;945;940;683;257
2;121507;121500;34-206;639;469;465;317;148
3;121507;121500;34-206;549;405;404;274;130
4;121507;121500;34-205;2090;1466;1460;972;488
5;121507;121500;34-205;2108;1460;1446;1086;360
6;121507;121500;34-232;1616;1214;1205;797;408
7;121507;121500;34-233;484;338;333;247;86
8;121507;121500;34-233;218;162;161;105;56
9;121507;121500;34-233;229;164;161;108;53
1;121508;121500;34-221;1603;1100;1092;826;266
2;121508;121500;34-221;389;247;245;188;57
3;121508;121500;34-222;266;184;182;122;60
4;121508;121500;34-222;966;726;722;543;179
5;121508;121500;34-222;1559;1114;1106;693;413
6;121508;121500;34-222;450;331;325;234;91
7;121508;121500;34-222;659;454;446;278;168
8;121508;121500;34-222;1237;908;897;488;409
1;121509;121500;34-210;563;390;385;262;123
2;121509;121500;34-210;1637;1193;1181;736;445
3;121509;121500;34-210;1099;770;759;525;234
4;121509;121500;34-210;658;476;473;350;123
5;121509;121500;34-210;281;195;194;133;61
1;121601;121600;33-190;501;347;342;247;95
2;121601;121600;33-192;754;481;477;393;84
3;121601;121600;33-190;1861;1300;1290;910;380
4;121601;121600;33-191;1230;840;836;636;200
5;121601;121600;33-190;895;549;544;475;69
6;121601;121600;33-192;295;203;203;172;31
7;121601;121600;33-190;583;403;399;258;141
8;121601;121600;33-191;573;373;371;290;81
9;121601;121600;33-190;273;197;196;178;18
10;121601;121600;33-190;435;275;273;230;43
11;121601;121600;33-190;389;273;272;200;72
12;121601;121600;33-192;470;332;328;256;72
13;121601;121600;33-190;244;163;161;127;34
1;121602;121600;33-182;552;366;365;332;33
2;121602;121600;33-180;984;681;678;597;81
3;121602;121600;33-180;319;237;236;217;19
4;121602;121600;33-180;1215;861;854;677;177
5;121602;121600;33-180;1354;951;945;799;146
6;121602;121600;33-180;504;311;309;265;44
7;121602;121600;33-181;1425;992;987;879;108
8;121602;121600;33-182;222;161;161;147;14
1;121603;121600;33-140;1646;1183;1171;914;257
2;121603;121600;33-103;860;643;633;392;241
3;121603;121600;33-151;906;635;629;555;74
4;121603;121600;33-140;1455;972;966;747;219
5;121603;121600;33-151;762;579;576;493;83
6;121603;121600;33-151;1459;1028;1022;837;185
7;121603;121600;33-140;878;635;630;529;101
8;121603;121600;33-140;621;461;456;394;62
9;121603;121600;33-140;1076;789;779;477;302
10;121603;121600;33-140;440;316;314;278;36
11;121603;121600;33-140;695;491;487;332;155
12;121603;121600;33-140;821;579;576;371;205
1;121604;121600;33-115;380;238;235;179;56
2;121604;121600;33-115;836;582;578;449;129
3;121604;121600;33-172;902;590;584;480;104
4;121604;121600;33-115;276;174;174;141;33
5;121604;121600;33-171;865;621;616;442;174
6;121604;121600;33-171;1022;727;712;464;248
7;121604;121600;33-171;540;379;375;255;120
8;121604;121600;33-114;1485;1136;1130;768;362
9;121604;121600;33-171;506;326;323;271;52
10;121604;121600;33-114;1150;783;780;622;158
11;121604;121600;33-114;808;548;543;459;84
12;121604;121600;33-171;321;228;225;155;70
1;121605;121600;33-130;1091;719;712;506;206
2;121605;121600;33-130;961;684;677;484;193
3;121605;121600;33-130;713;489;486;355;131
4;121605;121600;33-130;770;485;483;343;140
5;121605;121600;33-130;194;144;143;107;36
6;121605;121600;33-273;210;120;118;98;20
7;121605;121600;33-133;645;444;442;356;86
8;121605;121600;33-133;897;605;603;450;153
9;121605;121600;33-130;158;110;110;96;14
10;121605;121600;33-130;187;134;133;112;21
11;121605;121600;33-130;249;179;177;144;33
12;121605;121600;33-273;299;177;174;149;25
13;121605;121600;33-273;358;241;239;180;59
14;121605;121600;33-133;507;330;329;252;77
1;121606;121600;33-160;1129;775;766;594;172
2;121606;121600;33-160;1023;649;649;495;154
3;121606;121600;33-160;710;463;460;356;104
4;121606;121600;33-160;596;430;429;339;90
5;121606;121600;33-161;748;531;530;452;78
6;121606;121600;33-162;649;448;440;380;60
7;121606;121600;33-159;1151;840;833;699;134
8;121606;121600;33-159;1268;922;913;717;196
9;121606;121600;33-162;1414;977;973;870;103
1;121607;121600;33-164;1643;1243;1237;1110;127
2;121607;121600;33-163;877;598;592;498;94
3;121607;121600;33-163;988;689;684;552;132
4;121607;121600;33-163;483;351;348;301;47
5;121607;121600;33-167;894;645;642;544;98
6;121607;121600;33-163;201;156;156;146;10
1;121608;121600;33-156;1493;1022;1010;721;289
2;121608;121600;33-156;1383;962;953;608;345
3;121608;121600;33-156;1343;1005;995;714;281
4;121608;121600;33-157;930;634;630;524;106
5;121608;121600;33-157;804;564;556;450;106
6;121608;121600;33-152;1291;943;934;670;264
7;121608;121600;33-152;1174;816;812;578;234
8;121608;121600;33-158;1242;892;887;710;177
9;121608;121600;33-158;1214;824;819;709;110
1;121609;121600;33-150;978;684;676;502;174
2;121609;121600;33-150;1517;1069;1055;714;341
3;121609;121600;33-150;1577;1130;1123;779;344
4;121609;121600;33-150;1444;1030;1020;752;268
5;121609;121600;33-102;396;268;265;209;56
6;121609;121600;33-113;676;514;508;350;158
7;121609;121600;33-111;2282;1627;1611;946;665
8;121609;121600;33-113;2258;1652;1640;990;650
9;121609;121600;33-113;2150;1652;1639;1076;563
10;121609;121600;33-111;1622;1225;1218;855;363
11;121609;121600;33-112;553;405;405;339;66
12;121609;121600;33-112;540;408;406;343;63
13;121609;121600;33-112;594;443;435;297;138
14;121609;121600;33-112;552;406;404;263;141
15;121609;121600;33-112;1788;1251;1237;676;561
16;121609;121600;33-112;870;682;674;435;239
17;121609;121600;33-112;83;57;53;42;11
1;121610;121600;33-170;511;350;348;302;46
2;121610;121600;33-170;956;658;655;475;180
3;121610;121600;33-170;565;368;364;288;76
4;121610;121600;33-173;1000;694;684;572;112
5;121610;121600;33-170;646;440;439;327;112
6;121610;121600;33-172;638;415;411;331;80
7;121610;121600;33-170;715;429;427;347;80
8;121610;121600;33-172;1665;1199;1192;983;209
9;121610;121600;33-170;332;219;218;176;42
10;121610;121600;33-170;652;470;467;392;75
11;121610;121600;33-170;366;240;239;195;44
12;121610;121600;33-170;310;214;214;193;21
13;121610;121600;33-170;1016;770;763;604;159
14;121610;121600;33-170;1051;762;755;536;219
15;121610;121600;33-170;938;688;683;448;235
16;121610;121600;33-170;773;501;494;401;93
17;121610;121600;33-170;942;647;639;405;234
18;121610;121600;33-170;52;36;36;21;15
19;121610;121600;33-172;25;20;20;19;1
1;121611;121600;33-122;645;461;460;376;84
2;121611;121600;33-121;932;697;691;447;244
3;121611;121600;33-122;376;279;277;176;101
4;121611;121600;33-122;533;387;385;326;59
5;121611;121600;33-121;1227;820;816;633;183
6;121611;121600;33-121;710;487;484;374;110
7;121611;121600;33-122;1319;900;892;536;356
8;121611;121600;33-122;1299;923;915;514;401
9;121611;121600;33-122;271;192;192;148;44
10;121611;121600;33-101;425;330;330;217;113
11;121611;121600;33-122;452;311;306;249;57
1;121612;121600;33-271;717;410;409;307;102
2;121612;121600;33-270;380;230;230;184;46
3;121612;121600;33-270;461;256;254;169;85
4;121612;121600;33-270;314;196;195;144;51
5;121612;121600;33-270;353;213;212;178;34
6;121612;121600;33-270;383;195;191;135;56
7;121612;121600;33-270;330;218;217;176;41
8;121612;121600;33-270;63;37;36;23;13
1;121613;121600;32-830;1242;892;881;589;292
2;121613;121600;32-830;792;566;561;397;164
3;121613;121600;32-830;895;651;647;514;133
4;121613;121600;32-830;1208;863;855;622;233
5;121613;121600;32-830;680;517;511;391;120
6;121613;121600;32-828;899;597;589;438;151
7;121613;121600;32-830;911;662;659;536;123
8;121613;121600;32-830;1025;723;719;522;197
9;121613;121600;32-831;710;492;487;378;109
10;121613;121600;32-830;627;439;437;370;67
11;121613;121600;32-830;415;288;286;243;43
12;121613;121600;32-831;370;261;260;235;25
13;121613;121600;32-830;208;154;150;121;29
1;121614;121600;32-840;1145;835;830;549;281
2;121614;121600;32-840;322;228;227;195;32
3;121614;121600;32-842;970;676;674;525;149
4;121614;121600;32-841;448;338;335;227;108
5;121614;121600;32-840;1104;772;768;609;159
6;121614;121600;32-840;537;404;402;355;47
7;121614;121600;32-855;729;490;489;364;125
8;121614;121600;32-840;538;376;375;341;34
9;121614;121600;32-840;728;514;513;403;110
10;121614;121600;32-840;796;572;567;464;103
11;121614;121600;32-840;526;391;390;326;64
12;121614;121600;32-840;555;387;385;297;88
13;121614;121600;32-842;248;166;163;139;24
14;121614;121600;32-840;202;119;119;97;22
15;121614;121600;32-840;195;165;165;128;37
16;121614;121600;32-840;232;162;162;132;30
17;121614;121600;32-840;67;52;51;43;8
18;121614;121600;32-840;58;52;52;43;9
1;121615;121600;33-240;1536;1018;1007;664;343
2;121615;121600;33-240;1639;1103;1089;723;366
3;121615;121600;33-131;1029;741;736;522;214
4;121615;121600;33-131;2083;1437;1420;1051;369
5;121615;121600;33-250;646;364;360;278;82
6;121615;121600;33-131;1022;714;710;562;148
7;121615;121600;33-240;724;444;440;365;75
8;121615;121600;33-250;641;443;439;319;120
9;121615;121600;33-132;1348;894;884;575;309
10;121615;121600;33-131;601;391;387;328;59
11;121615;121600;33-250;559;347;343;270;73
12;121615;121600;33-240;148;119;119;103;16
13;121615;121600;33-240;778;523;521;445;76
14;121615;121600;33-270;297;184;182;154;28
15;121615;121600;33-250;257;147;147;112;35
16;121615;121600;33-250;328;206;206;167;39
17;121615;121600;33-250;303;173;173;133;40
18;121615;121600;33-240;149;109;109;85;24
19;121615;121600;33-240;47;33;31;18;13
20;121615;121600;33-250;52;17;17;9;8
1;121616;121600;38-246;1706;1180;1170;930;240
2;121616;121600;38-247;1701;1205;1196;1025;171
3;121616;121600;38-245;1284;792;788;700;88
4;121616;121600;38-247;748;566;563;476;87
5;121616;121600;38-246;436;267;267;231;36
1;121701;121700;34-500;1236;926;922;419;503
2;121701;121700;34-500;1106;902;893;485;408
3;121701;121700;34-500;1056;787;777;398;379
4;121701;121700;34-500;1451;1089;1073;633;440
5;121701;121700;34-500;954;709;703;356;347
6;121701;121700;34-500;1012;752;748;348;400
7;121701;121700;34-500;1746;1255;1245;623;622
8;121701;121700;34-500;1086;730;722;344;378
9;121701;121700;34-500;1522;1220;1211;493;718
10;121701;121700;34-500;1252;957;947;436;511
11;121701;121700;34-500;1021;676;671;407;264
12;121701;121700;34-500;1356;954;952;711;241
13;121701;121700;34-500;1595;1201;1192;834;358
14;121701;121700;34-500;1151;862;856;350;506
15;121701;121700;34-500;1309;1012;1005;410;595
16;121701;121700;34-500;1058;869;865;365;500
17;121701;121700;34-500;1176;932;926;398;528
18;121701;121700;34-500;1022;772;767;309;458
19;121701;121700;34-500;1722;1174;1163;667;496
20;121701;121700;34-500;86;54;54;32;22
21;121701;121700;34-500;92;41;40;25;15
22;121701;121700;34-500;184;156;154;83;71
23;121701;121700;34-500;57;34;33;22;11
24;121701;121700;34-500;63;26;25;16;9
1;121702;121700;34-425;771;483;480;397;83
2;121702;121700;34-425;1152;723;717;565;152
3;121702;121700;34-425;706;457;454;328;126
4;121702;121700;34-425;1023;682;678;571;107
5;121702;121700;34-425;378;228;227;196;31
6;121702;121700;34-425;732;501;498;367;131
7;121702;121700;34-425;309;183;180;158;22
8;121702;121700;34-425;413;265;262;239;23
1;121703;121700;34-530;1585;1208;1201;828;373
2;121703;121700;34-530;957;842;839;603;236
3;121703;121700;34-405;2047;1467;1456;1021;435
4;121703;121700;34-532;599;414;409;336;73
5;121703;121700;34-532;862;517;513;390;123
6;121703;121700;34-532;488;290;289;251;38
7;121703;121700;34-406;1428;856;853;754;99
8;121703;121700;34-532;815;614;611;399;212
9;121703;121700;34-406;1345;823;820;744;76
10;121703;121700;34-532;595;399;397;344;53
1;121704;121700;34-511;2224;1667;1652;973;679
2;121704;121700;34-511;1843;1290;1281;678;603
3;121704;121700;34-514;1803;1110;1107;953;154
4;121704;121700;34-512;1451;897;889;639;250
1;121705;121700;34-520;1823;1224;1212;815;397
2;121705;121700;34-520;1203;825;820;590;230
3;121705;121700;34-531;482;357;354;260;94
4;121705;121700;34-531;1377;1050;1046;689;357
5;121705;121700;34-520;912;559;554;478;76
6;121705;121700;34-521;1987;1239;1218;1026;192
7;121705;121700;34-521;1024;656;655;582;73
8;121705;121700;34-520;457;310;307;254;53
1;121801;121800;34-120;1561;1125;1118;635;483
2;121801;121800;34-120;1582;1125;1117;574;543
3;121801;121800;34-120;1522;1169;1159;620;539
4;121801;121800;34-120;1526;1085;1072;565;507
5;121801;121800;34-120;1420;984;968;480;488
6;121801;121800;34-120;1436;893;888;504;384
7;121801;121800;34-120;1296;911;905;498;407
8;121801;121800;34-120;1264;919;913;467;446
9;121801;121800;34-120;1255;892;882;482;400
10;121801;121800;34-120;1193;847;839;443;396
11;121801;121800;34-120;1675;1278;1269;806;463
12;121801;121800;34-120;1603;1188;1173;750;423
13;121801;121800;34-120;1626;1239;1224;776;448
14;121801;121800;34-120;1220;927;920;603;317
15;121801;121800;34-120;798;604;598;406;192
16;121801;121800;34-120;1223;911;903;624;279
17;121801;121800;34-120;1115;825;817;542;275
18;121801;121800;34-125;1704;1266;1255;870;385
19;121801;121800;34-125;1192;862;850;614;236
20;121801;121800;34-125;1194;857;854;720;134
21;121801;121800;34-120;1761;1281;1272;921;351
22;121801;121800;34-120;1238;920;911;570;341
23;121801;121800;34-120;1313;963;950;684;266
24;121801;121800;34-120;173;92;88;63;25
1;121802;121800;34-114;1127;843;833;445;388
2;121802;121800;34-114;1090;783;779;490;289
3;121802;121800;34-114;770;579;574;354;220
4;121802;121800;34-113;809;615;611;382;229
5;121802;121800;34-115;1200;849;843;547;296
6;121802;121800;34-113;992;723;719;474;245
7;121802;121800;34-114;348;249;248;176;72
8;121802;121800;34-114;329;240;240;149;91
9;121802;121800;34-113;478;314;312;214;98
10;121802;121800;34-114;424;316;315;213;102
11;121802;121800;34-114;390;306;304;211;93
12;121802;121800;34-114;322;235;235;153;82
1;121803;121800;34-130;1652;1230;1223;681;542
2;121803;121800;34-130;1729;1254;1238;696;542
3;121803;121800;34-130;1092;771;767;495;272
4;121803;121800;34-124;1084;736;730;467;263
5;121803;121800;34-130;924;649;643;399;244
6;121803;121800;34-130;1034;694;690;435;255
7;121803;121800;34-130;390;283;278;172;106
8;121803;121800;34-142;1243;949;941;585;356
9;121803;121800;34-141;2188;1499;1489;1038;451
10;121803;121800;34-130;1254;887;880;552;328
11;121803;121800;34-130;764;556;549;327;222
12;121803;121800;34-130;1176;837;830;538;292
13;121803;121800;34-142;457;351;348;237;111
14;121803;121800;34-142;128;100;100;65;35
15;121803;121800;34-142;318;215;211;131;80
16;121803;121800;34-130;54;28;28;17;11
1;121804;121800;34-143;1664;1229;1219;824;395
2;121804;121800;34-144;1785;1241;1227;814;413
3;121804;121800;34-143;817;587;584;476;108
4;121804;121800;34-143;567;423;418;276;142
1;121805;121800;34-106;855;628;623;347;276
2;121805;121800;34-106;758;547;540;332;208
3;121805;121800;34-106;331;255;254;157;97
4;121805;121800;34-106;554;387;385;285;100
5;121805;121800;34-106;709;521;514;348;166
1;121806;121800;34-116;1755;1254;1248;915;333
2;121806;121800;34-115;1992;1386;1378;949;429
3;121806;121800;34-116;483;347;342;227;115
4;121806;121800;34-116;916;645;640;418;222
5;121806;121800;34-116;2127;1511;1499;960;539
6;121806;121800;34-115;408;282;280;228;52
1;121807;121800;34-124;1130;825;816;514;302
2;121807;121800;34-146;524;360;356;265;91
3;121807;121800;34-146;1575;1057;1053;703;350
4;121807;121800;34-145;919;667;663;434;229
5;121807;121800;34-145;942;631;627;430;197
6;121807;121800;34-145;231;173;172;142;30
1;121808;121800;34-103;348;265;263;199;64
2;121808;121800;34-103;1053;762;755;518;237
3;121808;121800;34-100;1395;981;964;567;397
4;121808;121800;34-100;2137;1556;1538;847;691
5;121808;121800;34-103;944;645;642;438;204
6;121808;121800;34-103;339;233;231;165;66
1;121809;121800;34-100;1464;1049;1039;546;493
2;121809;121800;34-100;1491;1052;1040;475;565
3;121809;121800;34-100;1305;953;944;423;521
4;121809;121800;34-100;1472;933;923;446;477
5;121809;121800;34-100;588;434;430;223;207
6;121809;121800;34-100;1331;984;979;433;546
7;121809;121800;34-100;1393;1014;1001;442;559
8;121809;121800;34-100;1170;832;825;413;412
9;121809;121800;34-100;1287;935;925;463;462
10;121809;121800;34-100;1497;1102;1089;501;588
11;121809;121800;34-123;1707;1265;1256;728;528
12;121809;121800;34-123;1414;959;952;566;386
13;121809;121800;34-123;1174;854;851;618;233
14;121809;121800;34-100;731;503;498;324;174
15;121809;121800;34-100;890;628;624;410;214
16;121809;121800;34-100;1349;938;927;469;458
17;121809;121800;34-124;1906;1437;1425;863;562
18;121809;121800;34-124;641;460;457;307;150
19;121809;121800;34-124;522;363;363;242;121
20;121809;121800;34-103;1057;817;814;606;208
21;121809;121800;34-105;1495;1051;1045;713;332
22;121809;121800;34-105;874;564;554;390;164
23;121809;121800;34-100;650;451;447;250;197
24;121809;121800;34-123;275;203;201;153;48
25;121809;121800;34-100;88;43;39;31;8
26;121809;121800;34-100;225;138;137;85;52
27;121809;121800;34-100;273;223;218;36;182
28;121809;121800;34-100;69;31;30;13;17
1;121810;121800;34-122;1208;934;929;577;352
2;121810;121800;34-122;1429;1098;1085;745;340
3;121810;121800;34-122;1257;948;938;670;268
4;121810;121800;34-108;1197;830;823;620;203
5;121810;121800;34-108;1124;833;828;633;195
6;121810;121800;34-122;1025;756;748;545;203
7;121810;121800;34-122;1098;800;796;601;195
8;121810;121800;34-108;809;569;565;408;157
9;121810;121800;34-122;378;290;288;200;88
1;121901;121900;32-020;885;668;659;415;244
2;121901;121900;32-020;1134;864;850;517;333
3;121901;121900;32-020;1296;998;988;626;362
4;121901;121900;32-020;1298;1006;1001;666;335
5;121901;121900;32-020;795;603;597;435;162
6;121901;121900;32-020;456;350;347;218;129
7;121901;121900;32-020;821;644;637;450;187
8;121901;121900;32-020;442;327;325;236;89
9;121901;121900;32-020;575;441;436;241;195
10;121901;121900;32-020;554;431;429;268;161
11;121901;121900;32-020;420;338;336;210;126
12;121901;121900;32-020;59;26;26;23;3
1;121902;121900;32-420;1495;1113;1097;636;461
2;121902;121900;32-420;1964;1483;1470;796;674
3;121902;121900;32-420;693;530;526;351;175
4;121902;121900;32-420;529;368;365;269;96
5;121902;121900;32-420;496;374;374;228;146
6;121902;121900;32-420;850;620;615;411;204
7;121902;121900;32-420;423;329;328;238;90
8;121902;121900;32-420;451;349;346;281;65
9;121902;121900;32-420;807;595;589;422;167
10;121902;121900;32-420;635;493;490;300;190
11;121902;121900;32-420;319;251;249;188;61
12;121902;121900;32-420;751;557;549;387;162
13;121902;121900;32-420;475;370;369;310;59
14;121902;121900;32-420;458;331;330;268;62
15;121902;121900;32-420;411;329;327;234;93
16;121902;121900;32-420;192;162;159;119;40
17;121902;121900;32-420;182;142;141;97;44
18;121902;121900;32-420;503;370;369;278;91
19;121902;121900;32-420;433;356;348;292;56
20;121902;121900;32-420;377;287;282;193;89
21;121902;121900;32-420;377;282;281;209;72
22;121902;121900;32-420;294;214;212;136;76
23;121902;121900;32-420;234;177;177;144;33
24;121902;121900;32-420;174;113;113;78;35
25;121902;121900;32-420;172;131;128;92;36
26;121902;121900;32-420;173;130;129;54;75
27;121902;121900;32-420;365;299;293;185;108
1;121903;121900;32-014;732;522;510;353;157
2;121903;121900;32-014;579;449;441;225;216
3;121903;121900;32-015;306;245;244;132;112
4;121903;121900;32-015;300;228;223;124;99
5;121903;121900;32-014;763;548;540;312;228
6;121903;121900;32-015;1268;939;927;459;468
7;121903;121900;32-015;1597;1166;1154;635;519
8;121903;121900;32-014;595;456;451;304;147
9;121903;121900;32-014;1083;805;798;484;314
10;121903;121900;32-015;1404;1007;996;505;491
1;121904;121900;32-005;1756;1417;1404;617;787
2;121904;121900;32-005;1959;1531;1517;662;855
3;121904;121900;32-005;1910;1492;1476;639;837
4;121904;121900;32-005;1605;1228;1218;670;548
5;121904;121900;32-005;719;565;560;360;200
6;121904;121900;32-005;1744;1424;1413;648;765
7;121904;121900;32-003;1681;1298;1283;679;604
8;121904;121900;32-005;1191;858;840;536;304
9;121904;121900;32-005;638;481;477;308;169
10;121904;121900;32-003;939;722;715;398;317
11;121904;121900;32-007;1395;980;972;623;349
12;121904;121900;32-007;1401;998;989;603;386
13;121904;121900;32-007;1041;705;694;481;213
14;121904;121900;32-007;256;176;175;119;56
15;121904;121900;32-003;511;383;378;212;166
16;121904;121900;32-005;402;315;312;223;89
17;121904;121900;32-005;263;212;209;165;44
18;121904;121900;32-003;484;394;388;255;133
19;121904;121900;32-005;847;651;643;315;328
20;121904;121900;32-005;1218;963;953;400;553
21;121904;121900;32-005;883;739;729;422;307
22;121904;121900;32-007;1180;913;902;479;423
1;121905;121900;32-020;1363;1012;1007;384;623
2;121905;121900;32-020;1226;919;911;379;532
3;121905;121900;32-020;1579;1232;1217;565;652
4;121905;121900;32-020;1518;1106;1096;575;521
5;121905;121900;32-020;1466;1046;1038;516;522
6;121905;121900;32-020;2261;1781;1760;824;936
7;121905;121900;32-020;1208;1015;1005;405;600
8;121905;121900;32-020;2062;1702;1683;715;968
9;121905;121900;32-020;1971;1501;1487;709;778
10;121905;121900;32-020;1864;1542;1524;587;937
11;121905;121900;32-020;1450;1203;1189;451;738
12;121905;121900;32-020;1197;903;892;516;376
13;121905;121900;32-020;1718;1305;1296;670;626
14;121905;121900;30-698;1462;1069;1063;665;398
15;121905;121900;32-020;1082;834;825;567;258
16;121905;121900;32-020;872;668;653;493;160
17;121905;121900;32-020;1157;842;836;616;220
18;121905;121900;32-020;911;736;734;426;308
19;121905;121900;32-020;610;471;468;364;104
20;121905;121900;32-020;838;627;620;382;238
21;121905;121900;32-020;1048;814;808;480;328
22;121905;121900;32-020;762;554;548;371;177
23;121905;121900;32-020;963;763;757;419;338
24;121905;121900;32-020;1498;1107;1092;603;489
25;121905;121900;32-020;547;408;404;274;130
26;121905;121900;32-020;818;629;624;362;262
27;121905;121900;32-020;1259;966;959;447;512
28;121905;121900;32-020;1430;1127;1118;570;548
29;121905;121900;32-002;853;655;645;376;269
30;121905;121900;32-002;582;479;474;222;252
31;121905;121900;32-002;2200;1825;1807;849;958
32;121905;121900;32-002;611;441;437;275;162
33;121905;121900;32-002;530;407;404;255;149
34;121905;121900;32-002;1911;1487;1470;667;803
35;121905;121900;32-020;1063;869;854;382;472
36;121905;121900;32-020;1685;1334;1324;515;809
37;121905;121900;32-020;1675;1281;1265;589;676
38;121905;121900;32-020;321;235;234;173;61
39;121905;121900;32-020;550;435;432;277;155
40;121905;121900;32-020;1760;1406;1391;582;809
1;126101;126100;31-057;1812;1437;1426;472;954
2;126101;126100;31-054;1319;1011;1001;273;728
3;126101;126100;31-052;1481;1148;1132;351;781
4;126101;126100;31-067;1225;1003;992;380;612
5;126101;126100;31-067;1021;807;793;284;509
6;126101;126100;31-069;1429;1125;1107;446;661
7;126101;126100;31-039;1370;1096;1088;345;743
8;126101;126100;31-072;935;795;791;251;540
9;126101;126100;31-024;1427;1146;1131;403;728
10;126101;126100;31-024;1337;1112;1101;397;704
11;126101;126100;31-101;782;620;616;181;435
12;126101;126100;31-108;1707;1393;1377;441;936
13;126101;126100;31-120;579;462;458;131;327
14;126101;126100;31-114;945;774;769;351;418
15;126101;126100;31-123;1316;1079;1071;289;782
16;126101;126100;31-131;854;694;684;206;478
17;126101;126100;31-136;1285;1052;1038;294;744
18;126101;126100;31-136;1002;804;793;264;529
19;126101;126100;31-141;1171;957;949;291;658
20;126101;126100;31-145;767;627;617;158;459
21;126101;126100;31-148;1669;1354;1336;531;805
22;126101;126100;31-150;2044;1701;1681;502;1179
23;126101;126100;31-413;1051;841;827;251;576
24;126101;126100;31-521;1366;1114;1096;378;718
25;126101;126100;31-521;961;811;800;233;567
26;126101;126100;31-506;1784;1457;1442;441;1001
27;126101;126100;31-523;1115;899;881;286;595
28;126101;126100;31-517;1172;977;971;275;696
29;126101;126100;31-526;1072;887;880;266;614
30;126101;126100;31-543;2866;2423;2401;672;1729
31;126101;126100;31-543;2514;1911;1898;615;1283
32;126101;126100;31-542;1734;1475;1460;379;1081
33;126101;126100;31-542;2112;1768;1755;458;1297
34;126101;126100;31-531;1096;854;845;299;546
35;126101;126100;31-535;1167;926;915;269;646
36;126101;126100;31-531;1194;940;927;277;650
37;126101;126100;31-540;1223;981;978;276;702
38;126101;126100;31-559;1734;1403;1386;443;943
39;126101;126100;31-559;1025;819;811;338;473
40;126101;126100;31-564;1811;1361;1343;474;869
41;126101;126100;31-564;2303;1966;1944;524;1420
42;126101;126100;31-443;2161;1771;1743;529;1214
43;126101;126100;31-443;1773;1532;1517;434;1083
44;126101;126100;31-450;1021;786;779;306;473
45;126101;126100;31-450;981;728;723;282;441
46;126101;126100;31-455;1180;950;936;300;636
47;126101;126100;31-455;1058;864;847;276;571
48;126101;126100;31-462;1854;1526;1501;458;1043
49;126101;126100;31-469;1320;1061;1047;337;710
50;126101;126100;31-469;1515;1117;1096;456;640
51;126101;126100;31-469;1128;843;833;330;503
52;126101;126100;31-470;976;735;729;300;429
53;126101;126100;31-465;1615;1249;1235;458;777
54;126101;126100;31-465;1206;1021;1005;337;668
55;126101;126100;31-465;1066;848;837;427;410
56;126101;126100;31-422;2183;1756;1735;587;1148
57;126101;126100;31-422;2162;1817;1796;554;1242
58;126101;126100;31-422;2020;1569;1556;596;960
59;126101;126100;31-422;1584;1194;1180;478;702
60;126101;126100;31-422;1829;1478;1465;533;932
61;126101;126100;31-481;1567;1240;1231;439;792
62;126101;126100;31-423;1343;1071;1060;398;662
63;126101;126100;31-423;1349;1083;1066;372;694
64;126101;126100;31-406;1467;1262;1244;436;808
65;126101;126100;31-413;1325;1039;1025;390;635
66;126101;126100;31-413;1659;1289;1277;483;794
67;126101;126100;31-413;1596;1273;1263;451;812
68;126101;126100;31-406;1133;947;934;299;635
69;126101;126100;31-236;2351;1994;1973;682;1291
70;126101;126100;31-236;1667;1262;1243;482;761
71;126101;126100;31-236;1284;1081;1075;346;729
72;126101;126100;31-234;2216;1908;1893;601;1292
73;126101;126100;31-234;2301;1943;1928;655;1273
74;126101;126100;31-230;2367;1988;1965;680;1285
75;126101;126100;31-230;1777;1454;1438;514;924
76;126101;126100;31-214;1532;1242;1231;419;812
77;126101;126100;31-214;1818;1559;1540;450;1090
78;126101;126100;31-214;937;802;786;220;566
79;126101;126100;31-214;1543;1231;1223;398;825
80;126101;126100;31-214;1600;1287;1273;488;785
81;126101;126100;31-216;2577;2190;2166;697;1469
82;126101;126100;31-216;1385;1147;1135;337;798
83;126101;126100;31-216;1620;1353;1340;427;913
84;126101;126100;31-216;2296;1788;1760;592;1168
85;126101;126100;31-271;1674;1384;1366;422;944
86;126101;126100;31-271;1218;913;901;332;569
87;126101;126100;31-271;1814;1524;1504;518;986
88;126101;126100;31-271;1297;1020;1010;354;656
89;126101;126100;31-272;1970;1559;1536;600;936
90;126101;126100;31-272;1967;1546;1517;496;1021
91;126101;126100;31-272;2074;1752;1732;535;1197
92;126101;126100;31-229;1743;1425;1403;494;909
93;126101;126100;31-264;1257;1077;1069;361;708
94;126101;126100;31-346;2220;1839;1828;661;1167
95;126101;126100;31-346;1980;1684;1672;1132;540
96;126101;126100;31-349;2356;2117;2102;561;1541
97;126101;126100;31-319;1462;1285;1262;365;897
98;126101;126100;31-319;1510;1248;1240;392;848
99;126101;126100;31-319;1440;1054;1028;430;598
100;126101;126100;31-319;1040;791;783;291;492
101;126101;126100;31-319;1396;1026;1018;409;609
102;126101;126100;31-322;1561;1194;1175;417;758
103;126101;126100;31-322;1465;1122;1106;434;672
104;126101;126100;31-328;1873;1370;1356;575;781
105;126101;126100;31-328;1918;1494;1478;530;948
106;126101;126100;30-076;1869;1607;1591;509;1082
107;126101;126100;30-076;1640;1359;1347;454;893
108;126101;126100;30-014;1386;1155;1138;351;787
109;126101;126100;30-014;1278;1043;1022;392;630
110;126101;126100;30-019;3290;2797;2767;693;2074
111;126101;126100;30-019;1658;1309;1295;397;898
112;126101;126100;30-019;1480;1194;1183;374;809
113;126101;126100;30-019;1631;1286;1277;433;844
114;126101;126100;30-003;1507;1277;1260;362;898
115;126101;126100;30-074;2184;1783;1754;495;1259
116;126101;126100;30-033;686;584;575;150;425
117;126101;126100;30-049;1163;965;955;249;706
118;126101;126100;30-048;1637;1343;1324;358;966
119;126101;126100;30-079;1512;1241;1228;347;881
120;126101;126100;30-079;1288;1060;1047;297;750
121;126101;126100;30-059;1856;1614;1574;440;1134
122;126101;126100;30-071;1818;1463;1438;439;999
123;126101;126100;30-071;1686;1386;1368;495;873
124;126101;126100;30-071;1926;1677;1650;441;1209
125;126101;126100;30-132;1610;1316;1300;393;907
126;126101;126100;30-132;1476;1186;1176;372;804
127;126101;126100;30-095;1953;1639;1619;405;1214
128;126101;126100;30-095;1623;1287;1263;453;810
129;126101;126100;30-127;2260;1930;1906;536;1370
130;126101;126100;30-127;1632;1398;1377;398;979
131;126101;126100;30-147;1898;1644;1630;482;1148
132;126101;126100;30-147;1758;1414;1394;492;902
133;126101;126100;30-147;1469;1194;1178;425;753
134;126101;126100;30-147;1495;1219;1207;405;802
135;126101;126100;31-351;1704;1507;1485;407;1078
136;126101;126100;30-198;1435;1235;1225;442;783
137;126101;126100;30-198;1105;911;897;335;562
138;126101;126100;30-298;1336;997;984;500;484
139;126101;126100;30-238;2046;1711;1696;510;1186
140;126101;126100;30-243;1878;1534;1516;631;885
141;126101;126100;30-252;914;761;754;257;497
142;126101;126100;30-224;1726;1518;1510;401;1109
143;126101;126100;30-224;1773;1497;1482;378;1104
144;126101;126100;30-209;1262;1080;1071;300;771
145;126101;126100;30-209;1199;1012;1000;303;697
146;126101;126100;30-117;1579;1322;1306;386;920
147;126101;126100;30-106;1762;1424;1410;431;979
148;126101;126100;30-106;2036;1656;1636;545;1091
149;126101;126100;30-317;1158;1009;997;279;718
150;126101;126100;30-317;1372;1115;1096;374;722
151;126101;126100;30-334;1706;1353;1346;401;945
152;126101;126100;30-334;1465;1164;1153;382;771
153;126101;126100;30-334;1313;1050;1035;378;657
154;126101;126100;30-334;1471;1207;1192;404;788
155;126101;126100;30-337;1934;1593;1584;464;1120
156;126101;126100;30-337;2201;1867;1851;490;1361
157;126101;126100;30-322;923;716;713;272;441
158;126101;126100;30-377;1142;966;958;290;668
159;126101;126100;30-377;1214;996;989;353;636
160;126101;126100;30-376;1820;1499;1479;621;858
161;126101;126100;30-398;1269;959;949;517;432
162;126101;126100;30-398;1183;893;885;391;494
163;126101;126100;30-399;1544;1273;1257;493;764
164;126101;126100;30-399;1334;1022;1018;475;543
165;126101;126100;30-394;1910;1529;1505;567;938
166;126101;126100;30-394;1384;1095;1082;502;580
167;126101;126100;30-394;998;838;834;252;582
168;126101;126100;30-383;2304;1941;1916;530;1386
169;126101;126100;30-383;1740;1495;1472;471;1001
170;126101;126100;30-383;1293;1133;1118;332;786
171;126101;126100;30-383;1632;1410;1385;350;1035
172;126101;126100;30-383;1845;1558;1547;395;1152
173;126101;126100;30-383;1370;1155;1132;292;840
174;126101;126100;30-385;2015;1687;1664;601;1063
175;126101;126100;30-385;2191;1844;1820;526;1294
176;126101;126100;30-385;1519;1208;1189;455;734
177;126101;126100;30-385;1427;1109;1096;407;689
178;126101;126100;30-385;1225;949;935;392;543
179;126101;126100;30-385;2037;1684;1660;537;1123
180;126101;126100;30-349;1406;1143;1128;356;772
181;126101;126100;30-349;1407;1174;1164;374;790
182;126101;126100;30-349;1212;964;946;375;571
183;126101;126100;30-349;1666;1413;1396;459;937
184;126101;126100;30-410;1407;1117;1109;461;648
185;126101;126100;30-347;1222;956;948;403;545
186;126101;126100;30-418;1271;1057;1048;372;676
187;126101;126100;30-605;2037;1696;1662;617;1045
188;126101;126100;30-605;1201;1022;1013;514;499
189;126101;126100;30-418;611;467;465;175;290
190;126101;126100;30-426;1668;1395;1380;440;940
191;126101;126100;30-426;1635;1377;1353;426;927
192;126101;126100;30-424;1834;1415;1399;482;917
193;126101;126100;30-436;1155;980;974;364;610
194;126101;126100;30-436;1496;1278;1263;423;840
195;126101;126100;30-436;1539;1221;1208;440;768
196;126101;126100;30-389;1859;1561;1542;439;1103
197;126101;126100;30-389;2349;2019;1990;752;1238
198;126101;126100;30-499;2122;1775;1765;647;1118
199;126101;126100;30-499;1381;1008;1000;504;496
200;126101;126100;30-433;1736;1417;1399;513;886
201;126101;126100;30-698;1860;1471;1459;664;795
202;126101;126100;30-698;1941;1587;1574;595;979
203;126101;126100;30-698;1338;1061;1052;475;577
204;126101;126100;30-698;1216;922;912;509;403
205;126101;126100;30-698;600;402;401;261;140
206;126101;126100;30-698;989;792;772;377;395
207;126101;126100;30-698;820;631;622;292;330
208;126101;126100;30-694;799;649;642;282;360
209;126101;126100;30-687;1684;1375;1361;624;737
210;126101;126100;30-614;1564;1261;1251;549;702
211;126101;126100;30-614;2007;1688;1669;555;1114
212;126101;126100;30-614;1278;1004;993;385;608
213;126101;126100;30-611;1472;1140;1130;499;631
214;126101;126100;30-611;1541;1200;1190;562;628
215;126101;126100;30-611;1462;1136;1131;444;687
216;126101;126100;30-611;1557;1252;1235;535;700
217;126101;126100;30-611;1521;1254;1234;470;764
218;126101;126100;30-611;1568;1256;1240;442;798
219;126101;126100;30-611;1645;1347;1334;426;908
220;126101;126100;30-611;1640;1217;1210;495;715
221;126101;126100;30-611;1852;1541;1521;526;995
222;126101;126100;30-620;1626;1251;1247;502;745
223;126101;126100;30-620;1504;1182;1175;485;690
224;126101;126100;30-620;1584;1225;1209;469;740
225;126101;126100;30-633;1470;1173;1155;456;699
226;126101;126100;30-624;1141;927;921;316;605
227;126101;126100;30-624;1507;1150;1140;495;645
228;126101;126100;30-624;2040;1722;1689;590;1099
229;126101;126100;30-644;1027;837;827;316;511
230;126101;126100;30-638;1547;1179;1165;512;653
231;126101;126100;30-638;1452;1159;1146;409;737
232;126101;126100;30-638;1543;1154;1146;439;707
233;126101;126100;30-638;1716;1311;1303;504;799
234;126101;126100;30-686;1781;1399;1386;571;815
235;126101;126100;30-686;1584;1239;1225;504;721
236;126101;126100;30-686;2348;2038;2021;768;1253
237;126101;126100;30-682;1176;858;849;348;501
238;126101;126100;30-682;1383;1020;998;409;589
239;126101;126100;30-682;1121;842;836;354;482
240;126101;126100;30-684;1355;959;949;393;556
241;126101;126100;30-684;1040;723;716;293;423
242;126101;126100;30-684;1742;1321;1309;529;780
243;126101;126100;30-820;1211;920;899;336;563
244;126101;126100;30-820;1522;1255;1239;486;753
245;126101;126100;30-818;1281;1034;1027;401;626
246;126101;126100;30-818;1199;1016;1004;445;559
247;126101;126100;30-816;2093;1649;1623;581;1042
248;126101;126100;30-836;1633;1228;1217;504;713
249;126101;126100;30-836;1563;1175;1167;542;625
250;126101;126100;30-836;1644;1318;1305;529;776
251;126101;126100;30-809;1057;819;812;349;463
252;126101;126100;30-809;1200;959;950;428;522
253;126101;126100;30-868;1299;966;962;438;524
254;126101;126100;30-868;1020;747;741;333;408
255;126101;126100;30-868;1120;804;804;372;432
256;126101;126100;30-868;1370;1050;1042;462;580
257;126101;126100;30-695;1427;1060;1051;458;593
258;126101;126100;30-695;1239;953;952;467;485
259;126101;126100;30-837;1550;1252;1242;536;706
260;126101;126100;30-837;1676;1272;1260;513;747
261;126101;126100;30-837;1612;1232;1217;516;701
262;126101;126100;30-837;1606;1273;1258;556;702
263;126101;126100;30-838;1890;1459;1447;608;839
264;126101;126100;30-838;1990;1524;1505;619;886
265;126101;126100;30-856;1438;1134;1125;500;625
266;126101;126100;30-898;1395;1138;1122;469;653
267;126101;126100;30-898;1728;1404;1384;616;768
268;126101;126100;30-898;1747;1364;1353;611;742
269;126101;126100;30-798;1896;1568;1554;611;943
270;126101;126100;30-798;2114;1784;1762;744;1018
271;126101;126100;30-798;1232;934;926;549;377
272;126101;126100;30-723;1232;975;971;486;485
273;126101;126100;30-724;2048;1687;1666;533;1133
274;126101;126100;30-724;1552;1260;1242;418;824
275;126101;126100;30-718;2162;1903;1876;540;1336
276;126101;126100;30-718;2131;1737;1722;700;1022
277;126101;126100;30-718;2451;2091;2062;699;1363
278;126101;126100;30-718;1980;1592;1573;562;1011
279;126101;126100;30-715;1967;1627;1607;536;1071
280;126101;126100;30-715;1872;1563;1542;566;976
281;126101;126100;30-552;1599;1311;1300;460;840
282;126101;126100;30-552;2352;1948;1925;699;1226
283;126101;126100;30-540;1559;1261;1246;354;892
284;126101;126100;30-363;2370;2055;2031;498;1533
285;126101;126100;30-523;963;794;779;258;521
286;126101;126100;30-503;1571;1308;1295;348;947
287;126101;126100;30-503;924;712;705;211;494
288;126101;126100;30-533;1181;950;940;316;624
289;126101;126100;30-529;1344;1073;1058;295;763
290;126101;126100;30-534;1760;1455;1442;425;1017
291;126101;126100;30-534;1264;1003;991;306;685
292;126101;126100;30-701;2548;2231;2206;495;1711
293;126101;126100;31-586;1173;950;943;415;528
294;126101;126100;31-586;2598;2187;2163;636;1527
295;126101;126100;31-586;2464;2026;2013;820;1193
296;126101;126100;31-586;2254;1808;1790;630;1160
297;126101;126100;31-941;2238;1701;1684;638;1046
298;126101;126100;31-941;1266;1004;996;355;641
299;126101;126100;31-450;1395;1206;1193;360;833
300;126101;126100;31-869;1569;1220;1215;506;709
301;126101;126100;31-869;1929;1574;1554;627;927
302;126101;126100;31-869;1718;1371;1357;541;816
303;126101;126100;31-869;1561;1366;1340;428;912
304;126101;126100;31-875;1376;1082;1063;429;634
305;126101;126100;31-875;1509;1233;1217;496;721
306;126101;126100;31-875;1009;811;802;314;488
307;126101;126100;31-875;1337;1033;1023;453;570
308;126101;126100;31-875;1312;1066;1053;388;665
309;126101;126100;31-866;1226;1068;1060;387;673
310;126101;126100;31-636;1808;1492;1477;622;855
311;126101;126100;31-636;1617;1232;1219;598;621
312;126101;126100;31-636;1745;1364;1348;616;732
313;126101;126100;31-636;1655;1422;1406;428;978
314;126101;126100;31-610;1475;1152;1147;503;644
315;126101;126100;31-610;1505;1210;1198;541;657
316;126101;126100;31-606;1462;1102;1087;546;541
317;126101;126100;31-606;1535;1178;1170;544;626
318;126101;126100;31-630;1622;1221;1213;616;597
319;126101;126100;31-616;1647;1232;1223;594;629
320;126101;126100;31-616;1297;956;942;472;470
321;126101;126100;31-615;1643;1403;1391;485;906
322;126101;126100;31-615;1498;1143;1122;560;562
323;126101;126100;31-618;1389;1075;1064;474;590
324;126101;126100;31-618;2075;1645;1625;733;892
325;126101;126100;31-620;1229;958;945;443;502
326;126101;126100;31-620;1236;960;957;459;498
327;126101;126100;31-620;1523;1193;1181;543;638
328;126101;126100;31-620;1360;951;943;454;489
329;126101;126100;31-624;1527;1167;1153;534;619
330;126101;126100;31-624;1560;1074;1070;572;498
331;126101;126100;31-624;1615;1136;1127;534;593
332;126101;126100;31-624;1655;1223;1212;608;604
333;126101;126100;31-624;1858;1422;1407;649;758
334;126101;126100;31-624;2278;1882;1851;809;1042
335;126101;126100;31-624;1604;1287;1268;585;683
336;126101;126100;31-826;1512;1244;1230;485;745
337;126101;126100;31-826;986;674;667;340;327
338;126101;126100;31-832;1413;980;975;517;458
339;126101;126100;31-832;1290;854;847;463;384
340;126101;126100;31-832;1446;1029;1021;549;472
341;126101;126100;31-832;1187;757;754;397;357
342;126101;126100;31-818;1892;1382;1368;684;684
343;126101;126100;31-819;1405;1048;1037;511;526
344;126101;126100;31-819;1103;786;779;395;384
345;126101;126100;31-814;1454;1028;1019;513;506
346;126101;126100;31-814;1540;1100;1090;590;500
347;126101;126100;31-810;1145;827;817;420;397
348;126101;126100;31-810;1076;815;808;423;385
349;126101;126100;31-858;1819;1405;1394;643;751
350;126101;126100;31-855;1039;728;724;330;394
351;126101;126100;31-855;1199;833;829;420;409
352;126101;126100;31-855;1319;1077;1063;391;672
353;126101;126100;31-862;886;696;687;303;384
354;126101;126100;31-862;1372;1054;1039;456;583
355;126101;126100;31-833;1253;946;939;477;462
356;126101;126100;31-833;1053;763;749;388;361
357;126101;126100;31-833;1065;742;733;360;373
358;126101;126100;31-828;1246;984;977;463;514
359;126101;126100;31-828;1145;895;880;389;491
360;126101;126100;31-706;1374;1110;1105;537;568
361;126101;126100;31-706;1348;977;972;510;462
362;126101;126100;31-706;1422;981;966;512;454
363;126101;126100;31-708;1312;918;912;480;432
364;126101;126100;31-722;1505;939;933;534;399
365;126101;126100;31-722;1969;1406;1392;766;626
366;126101;126100;31-763;857;620;614;285;329
367;126101;126100;31-764;1671;1297;1289;712;577
368;126101;126100;31-990;2260;1794;1774;978;796
369;126101;126100;31-766;804;596;593;369;224
370;126101;126100;31-752;836;653;646;284;362
371;126101;126100;31-975;1235;898;888;400;488
372;126101;126100;31-977;811;595;591;304;287
373;126101;126100;31-972;637;488;483;213;270
374;126101;126100;31-927;1465;1118;1110;512;598
375;126101;126100;31-957;1195;880;871;388;483
376;126101;126100;31-977;1399;1000;996;439;557
377;126101;126100;31-751;792;581;571;233;338
378;126101;126100;31-964;921;695;692;369;323
379;126101;126100;31-964;877;637;631;264;367
380;126101;126100;31-959;971;752;740;369;371
381;126101;126100;31-948;1236;877;869;361;508
382;126101;126100;31-948;715;546;537;243;294
383;126101;126100;31-948;1124;783;775;351;424
384;126101;126100;31-943;943;708;703;279;424
385;126101;126100;31-941;1302;958;952;407;545
386;126101;126100;31-941;1226;928;920;384;536
387;126101;126100;31-935;828;645;636;248;388
388;126101;126100;31-935;996;738;730;289;441
389;126101;126100;31-935;1095;779;773;355;418
390;126101;126100;31-935;1131;845;836;362;474
391;126101;126100;31-923;1552;1168;1159;451;708
392;126101;126100;31-909;903;716;715;323;392
393;126101;126100;31-909;1363;996;978;473;505
394;126101;126100;31-909;1326;921;912;459;453
395;126101;126100;31-909;1053;761;754;329;425
396;126101;126100;31-901;1249;918;913;422;491
397;126101;126100;31-901;960;694;688;303;385
398;126101;126100;31-922;834;617;611;317;294
399;126101;126100;31-922;1418;1071;1060;448;612
400;126101;126100;31-979;1697;1319;1296;633;663
401;126101;126100;31-983;300;220;219;131;88
402;126101;126100;31-985;909;721;715;436;279
403;126101;126100;31-998;1323;977;968;668;300
404;126101;126100;31-999;1499;1077;1071;734;337
405;126101;126100;31-998;1059;793;783;520;263
406;126101;126100;30-389;1788;1477;1461;525;936
407;126101;126100;30-394;1945;1683;1658;467;1191
408;126101;126100;30-798;1871;1429;1413;536;877
409;126101;126100;31-351;1464;1290;1267;419;848
410;126101;126100;31-869;1781;1534;1515;489;1026
411;126101;126100;31-763;698;527;519;260;259
412;126101;126100;31-264;1257;1008;999;340;659
413;126101;126100;31-061;84;56;56;44;12
414;126101;126100;31-066;158;85;85;53;32
415;126101;126100;31-115;68;51;51;31;20
416;126101;126100;31-121;157;99;97;43;54
417;126101;126100;31-137;7;7;7;3;4
418;126101;126100;31-148;362;141;137;89;48
419;126101;126100;31-155;576;422;411;101;310
420;126101;126100;31-502;75;39;39;38;1
421;126101;126100;31-501;188;111;109;61;48
422;126101;126100;31-419;39;22;22;6;16
423;126101;126100;31-202;337;273;270;156;114
424;126101;126100;31-202;289;127;126;62;64
425;126101;126100;31-222;84;44;39;20;19
426;126101;126100;31-207;97;16;16;6;10
427;126101;126100;30-901;166;126;123;58;65
428;126101;126100;30-053;65;52;52;28;24
429;126101;126100;30-072;773;773;748;263;485
430;126101;126100;30-059;135;131;127;36;91
431;126101;126100;30-056;120;117;116;21;95
432;126101;126100;30-119;53;40;40;26;14
433;126101;126100;30-224;117;96;93;46;47
434;126101;126100;30-329;75;26;23;16;7
435;126101;126100;30-329;77;43;43;30;13
436;126101;126100;30-336;141;81;80;38;42
437;126101;126100;30-398;52;38;38;35;3
438;126101;126100;30-393;31;25;24;11;13
439;126101;126100;30-393;635;320;312;177;135
440;126101;126100;30-693;119;36;36;17;19
441;126101;126100;30-663;455;147;145;75;70
442;126101;126100;30-688;304;162;160;70;90
443;126101;126100;30-688;335;170;168;85;83
444;126101;126100;30-688;238;140;138;74;64
445;126101;126100;30-725;39;28;25;16;9
446;126101;126100;30-725;105;57;57;45;12
447;126101;126100;30-725;213;126;114;70;44
448;126101;126100;31-826;116;116;114;56;58
449;126101;126100;31-826;153;121;119;67;52
450;126101;126100;31-826;26;22;22;13;9
451;126101;126100;31-988;290;243;241;61;180
452;126101;126100;31-965;30;23;23;13;10
453;126101;126100;31-977;45;23;22;15;7
454;126101;126100;31-752;56;53;51;32;19
455;126101;126100;31-913;116;116;115;71;44
456;126101;126100;31-989;35;23;23;11;12
1;126201;126200;33-300;1343;988;982;627;355
2;126201;126200;33-300;1925;1410;1398;849;549
3;126201;126200;33-300;790;515;507;308;199
4;126201;126200;33-300;719;473;467;253;214
5;126201;126200;33-300;1120;763;759;426;333
6;126201;126200;33-300;1263;970;957;530;427
7;126201;126200;33-300;1523;1087;1081;570;511
8;126201;126200;33-300;1564;1067;1060;607;453
9;126201;126200;33-300;1186;906;901;512;389
10;126201;126200;33-300;1760;1237;1231;785;446
11;126201;126200;33-300;931;719;713;523;190
12;126201;126200;33-300;884;642;631;359;272
13;126201;126200;33-300;756;506;501;287;214
14;126201;126200;33-300;1130;798;789;464;325
15;126201;126200;33-300;1122;749;747;439;308
16;126201;126200;33-300;1155;787;778;453;325
17;126201;126200;33-300;1182;867;857;522;335
18;126201;126200;33-300;1285;1006;997;687;310
19;126201;126200;33-300;1225;919;914;604;310
20;126201;126200;33-300;1492;1106;1098;658;440
21;126201;126200;33-300;700;526;525;317;208
22;126201;126200;33-300;1034;812;806;507;299
23;126201;126200;33-300;1529;1119;1110;623;487
24;126201;126200;33-300;852;567;561;293;268
25;126201;126200;33-300;899;666;661;423;238
26;126201;126200;33-300;1265;897;892;426;466
27;126201;126200;33-300;1889;1423;1414;801;613
28;126201;126200;33-300;1436;1053;1047;645;402
29;126201;126200;33-300;1429;1089;1078;652;426
30;126201;126200;33-300;774;588;584;354;230
31;126201;126200;33-300;1441;1104;1089;701;388
32;126201;126200;33-300;1162;803;797;453;344
33;126201;126200;33-300;1722;1351;1343;910;433
34;126201;126200;33-300;2002;1587;1574;1075;499
35;126201;126200;33-300;913;684;681;383;298
36;126201;126200;33-300;991;717;712;462;250
37;126201;126200;33-300;1319;932;930;509;421
38;126201;126200;33-300;1206;843;840;473;367
39;126201;126200;33-300;876;606;602;342;260
40;126201;126200;33-300;1074;846;831;386;445
41;126201;126200;33-300;1615;1195;1187;767;420
42;126201;126200;33-300;1046;759;757;426;331
43;126201;126200;33-300;1450;1121;1107;778;329
44;126201;126200;33-300;1073;845;836;653;183
45;126201;126200;33-300;2205;1687;1662;1212;450
46;126201;126200;33-300;853;627;622;356;266
47;126201;126200;33-300;1178;910;904;386;518
48;126201;126200;33-300;69;43;42;27;15
49;126201;126200;33-300;49;21;21;14;7
50;126201;126200;33-300;82;26;26;22;4
51;126201;126200;33-300;170;170;169;127;42
52;126201;126200;33-300;19;13;13;11;2
53;126201;126200;33-300;352;284;278;46;232
1;126301;126300;33-100;698;402;397;241;156
2;126301;126300;33-100;1227;787;778;374;404
3;126301;126300;33-100;706;455;450;214;236
4;126301;126300;33-100;473;318;311;164;147
5;126301;126300;33-100;978;620;614;326;288
6;126301;126300;33-100;672;416;414;222;192
7;126301;126300;33-100;904;615;610;307;303
8;126301;126300;33-100;1418;991;983;535;448
9;126301;126300;33-100;1486;1025;1018;500;518
10;126301;126300;33-100;944;686;680;317;363
11;126301;126300;33-100;948;672;666;348;318
12;126301;126300;33-100;500;300;295;126;169
13;126301;126300;33-100;781;551;547;271;276
14;126301;126300;33-100;822;536;535;269;266
15;126301;126300;33-100;1128;852;848;423;425
16;126301;126300;33-100;1531;1062;1048;512;536
17;126301;126300;33-100;1149;696;690;368;322
18;126301;126300;33-100;1543;1058;1054;498;556
19;126301;126300;33-100;1056;771;766;395;371
20;126301;126300;33-100;1096;781;776;363;413
21;126301;126300;33-100;1075;819;805;409;396
22;126301;126300;33-100;1602;1246;1235;604;631
23;126301;126300;33-100;691;455;453;216;237
24;126301;126300;33-100;928;597;591;329;262
25;126301;126300;33-100;790;553;549;273;276
26;126301;126300;33-100;1124;767;763;428;335
27;126301;126300;33-100;770;595;588;311;277
28;126301;126300;33-100;822;586;579;306;273
29;126301;126300;33-100;1532;1176;1168;531;637
30;126301;126300;33-100;887;622;617;336;281
31;126301;126300;33-100;1293;950;944;498;446
32;126301;126300;33-100;715;520;518;242;276
33;126301;126300;33-100;1016;771;764;396;368
34;126301;126300;33-100;914;665;661;344;317
35;126301;126300;33-100;1459;1116;1111;574;537
36;126301;126300;33-100;812;596;593;289;304
37;126301;126300;33-100;712;486;482;228;254
38;126301;126300;33-100;1475;1049;1043;579;464
39;126301;126300;33-100;1336;890;883;491;392
40;126301;126300;33-100;1203;794;787;419;368
41;126301;126300;33-100;1023;640;633;315;318
42;126301;126300;33-100;871;569;566;301;265
43;126301;126300;33-100;1217;789;782;411;371
44;126301;126300;33-100;1234;820;817;454;363
45;126301;126300;33-100;1520;1049;1045;557;488
46;126301;126300;33-100;1341;899;895;403;492
47;126301;126300;33-100;1250;942;934;473;461
48;126301;126300;33-100;581;394;393;201;192
49;126301;126300;33-100;1410;1077;1065;501;564
50;126301;126300;33-100;1103;688;685;346;339
51;126301;126300;33-100;1135;765;752;445;307
52;126301;126300;33-100;1701;1239;1231;552;679
53;126301;126300;33-101;2082;1534;1517;781;736
54;126301;126300;33-100;1911;1430;1419;602;817
55;126301;126300;33-100;1320;1005;998;446;552
56;126301;126300;33-101;1088;766;758;339;419
57;126301;126300;33-101;1125;761;751;372;379
58;126301;126300;33-100;1497;1102;1093;541;552
59;126301;126300;33-100;1922;1361;1353;906;447
60;126301;126300;33-100;1781;1282;1274;751;523
61;126301;126300;33-100;1521;1126;1120;582;538
62;126301;126300;33-100;1400;1011;1005;548;457
63;126301;126300;33-100;1341;980;975;497;478
64;126301;126300;33-100;1290;989;982;544;438
65;126301;126300;33-100;1169;867;862;430;432
66;126301;126300;33-100;2040;1472;1462;837;625
67;126301;126300;33-100;344;141;141;86;55
68;126301;126300;33-100;372;227;222;150;72
69;126301;126300;33-101;76;52;51;33;18
70;126301;126300;33-100;140;54;52;26;26
71;126301;126300;33-101;69;13;13;7;6
72;126301;126300;33-101;323;228;226;35;191
73;126301;126300;33-100;783;573;562;85;477
74;126301;126300;33-101;57;55;55;55;0
1;140101;140100;26-800;1382;1032;1017;552;465
2;140101;140100;26-800;1661;1298;1288;777;511
3;140101;140100;26-800;1459;1115;1103;732;371
4;140101;140100;26-800;1662;1283;1267;802;465
5;140101;140100;26-800;1556;1169;1161;817;344
6;140101;140100;26-800;175;137;132;17;115
1;140102;140100;26-803;750;529;524;394;130
2;140102;140100;05-610;877;651;644;493;151
3;140102;140100;05-610;685;478;476;362;114
4;140102;140100;26-803;807;606;599;487;112
5;140102;140100;26-803;688;509;509;355;154
6;140102;140100;26-803;592;442;436;279;157
1;140103;140100;26-807;972;678;672;544;128
2;140103;140100;26-807;937;707;701;610;91
3;140103;140100;26-807;386;320;318;269;49
4;140103;140100;26-807;269;195;194;157;37
5;140103;140100;26-800;184;150;148;115;33
6;140103;140100;26-806;192;143;140;126;14
1;140104;140100;26-806;831;617;606;459;147
2;140104;140100;26-806;494;372;372;297;75
3;140104;140100;26-806;454;328;327;291;36
4;140104;140100;26-806;852;651;650;586;64
5;140104;140100;26-806;234;199;197;193;4
6;140104;140100;26-806;298;234;230;202;28
7;140104;140100;26-806;410;299;295;252;43
8;140104;140100;26-806;317;245;244;195;49
9;140104;140100;26-806;276;217;217;199;18
1;140105;140100;26-804;447;343;341;307;34
2;140105;140100;26-804;504;371;368;284;84
3;140105;140100;26-804;861;571;567;463;104
4;140105;140100;26-804;572;392;386;335;51
5;140105;140100;26-804;850;558;552;423;129
6;140105;140100;26-804;668;497;493;385;108
7;140105;140100;26-804;164;129;129;112;17
8;140105;140100;26-804;201;146;145;119;26
1;140106;140100;26-811;1305;1006;1003;803;200
2;140106;140100;26-811;350;258;257;231;26
3;140106;140100;26-811;569;432;427;358;69
1;140201;140200;06-400;1963;1482;1463;765;698
2;140201;140200;06-400;1197;865;858;518;340
3;140201;140200;06-400;1215;882;877;480;397
4;140201;140200;06-400;1620;1233;1228;615;613
5;140201;140200;06-400;1601;1244;1237;639;598
6;140201;140200;06-400;1098;731;728;392;336
7;140201;140200;06-400;1311;834;825;494;331
8;140201;140200;06-400;1499;898;895;539;356
9;140201;140200;06-400;1572;1150;1137;647;490
10;140201;140200;06-400;1451;1137;1128;625;503
11;140201;140200;06-400;1342;979;968;531;437
12;140201;140200;06-400;1427;1058;1044;504;540
13;140201;140200;06-400;1705;1274;1268;603;665
14;140201;140200;06-400;1613;1190;1181;571;610
15;140201;140200;06-400;1354;1001;994;511;483
16;140201;140200;06-400;1357;1045;1036;552;484
17;140201;140200;06-400;1335;892;884;519;365
18;140201;140200;06-400;1843;1392;1380;664;716
19;140201;140200;06-400;1654;1220;1208;682;526
20;140201;140200;06-400;1732;1241;1230;739;491
21;140201;140200;06-400;1550;1161;1154;632;522
22;140201;140200;06-400;230;99;99;57;42
23;140201;140200;06-400;141;89;86;64;22
24;140201;140200;06-400;86;42;39;30;9
1;140202;140200;06-400;1184;864;860;470;390
2;140202;140200;06-452;597;377;374;274;100
3;140202;140200;06-400;1105;795;788;481;307
4;140202;140200;06-452;857;574;567;411;156
5;140202;140200;06-400;524;403;400;232;168
6;140202;140200;06-400;534;404;401;261;140
7;140202;140200;06-400;253;170;170;139;31
8;140202;140200;06-400;532;391;389;278;111
1;140203;140200;06-450;1403;849;845;638;207
2;140203;140200;06-450;1344;925;915;606;309
3;140203;140200;06-450;1300;848;845;592;253
4;140203;140200;06-452;509;349;348;259;89
5;140203;140200;06-450;1120;737;732;538;194
1;140204;140200;06-420;929;668;662;504;158
2;140204;140200;06-420;813;551;549;458;91
3;140204;140200;06-420;1087;710;705;640;65
1;140205;140200;06-460;874;593;588;380;208
2;140205;140200;06-460;847;608;606;532;74
3;140205;140200;06-460;890;605;603;489;114
1;140206;140200;06-456;1210;827;818;605;213
2;140206;140200;06-456;849;574;571;422;149
3;140206;140200;06-456;1181;747;744;584;160
1;140207;140200;06-406;1114;764;759;575;184
2;140207;140200;06-406;432;334;330;275;55
3;140207;140200;06-406;525;367;367;310;57
4;140207;140200;06-406;849;531;526;421;105
5;140207;140200;06-406;853;652;647;404;243
6;140207;140200;06-406;516;340;337;268;69
7;140207;140200;06-406;251;170;167;126;41
1;140208;140200;06-461;1043;762;750;525;225
2;140208;140200;06-461;647;420;416;314;102
3;140208;140200;06-461;238;169;168;116;52
4;140208;140200;06-461;785;555;550;458;92
5;140208;140200;06-461;378;288;284;201;83
6;140208;140200;06-461;191;142;141;119;22
7;140208;140200;06-461;289;192;191;134;57
8;140208;140200;06-461;166;114;114;96;18
1;140209;140200;06-430;1525;1070;1060;727;333
2;140209;140200;06-430;591;402;400;341;59
3;140209;140200;06-440;335;254;251;200;51
4;140209;140200;06-440;1819;1221;1211;863;348
5;140209;140200;06-440;314;220;219;166;53
6;140209;140200;06-430;166;114;114;99;15
7;140209;140200;06-430;546;402;398;257;141
8;140209;140200;06-440;231;158;155;135;20
9;140209;140200;06-440;165;127;127;110;17
10;140209;140200;06-430;69;37;37;32;5
1;140301;140300;08-400;875;691;684;408;276
2;140301;140300;08-400;676;494;484;316;168
3;140301;140300;08-400;526;426;420;262;158
4;140301;140300;08-400;863;641;631;374;257
5;140301;140300;08-400;1010;835;825;502;323
6;140301;140300;08-400;1136;889;880;543;337
7;140301;140300;08-400;909;682;676;412;264
8;140301;140300;08-400;1192;920;908;546;362
9;140301;140300;08-400;873;685;679;405;274
10;140301;140300;08-400;845;652;641;409;232
11;140301;140300;08-400;561;460;451;306;145
12;140301;140300;08-400;822;601;594;361;233
13;140301;140300;08-400;639;521;518;321;197
14;140301;140300;08-400;1003;796;788;451;337
15;140301;140300;08-400;920;692;679;346;333
16;140301;140300;08-400;37;14;14;11;3
1;140302;140300;08-450;736;549;543;380;163
2;140302;140300;08-450;1000;747;746;609;137
3;140302;140300;08-450;1006;750;744;533;211
4;140302;140300;08-450;810;604;593;428;165
1;140303;140300;08-412;294;221;221;180;41
2;140303;140300;08-412;404;312;309;247;62
3;140303;140300;08-412;690;481;475;352;123
4;140303;140300;08-412;576;426;424;344;80
5;140303;140300;08-412;931;761;753;601;152
6;140303;140300;08-412;166;118;118;90;28
7;140303;140300;08-412;276;211;207;167;40
8;140303;140300;08-412;175;143;139;112;27
9;140303;140300;08-412;277;210;208;183;25
10;140303;140300;08-412;207;164;164;130;34
1;140304;140300;08-400;810;615;610;496;114
2;140304;140300;08-410;279;196;192;166;26
3;140304;140300;08-410;566;428;424;318;106
4;140304;140300;08-400;580;459;457;345;112
5;140304;140300;08-400;644;520;513;376;137
6;140304;140300;08-400;477;361;356;253;103
7;140304;140300;08-410;496;366;365;278;87
8;140304;140300;08-410;486;393;392;262;130
9;140304;140300;08-410;481;345;343;297;46
10;140304;140300;08-400;653;508;507;352;155
11;140304;140300;08-410;903;685;679;433;246
12;140304;140300;08-400;588;467;461;259;202
13;140304;140300;08-400;371;282;278;204;74
14;140304;140300;08-400;479;377;376;248;128
15;140304;140300;08-410;590;454;452;345;107
16;140304;140300;08-400;790;644;635;461;174
17;140304;140300;08-400;835;651;646;492;154
1;140305;140300;08-400;538;400;397;307;90
2;140305;140300;08-404;345;263;261;232;29
3;140305;140300;08-404;562;456;454;423;31
4;140305;140300;08-404;443;362;361;301;60
5;140305;140300;08-404;716;592;585;485;100
6;140305;140300;08-404;760;609;599;499;100
7;140305;140300;08-404;396;316;313;252;61
8;140305;140300;08-404;283;206;204;167;37
9;140305;140300;08-404;395;324;318;251;67
10;140305;140300;08-404;346;249;245;193;52
11;140305;140300;08-404;180;143;141;108;33
12;140305;140300;08-404;144;49;48;31;17
1;140306;140300;08-450;986;777;770;596;174
2;140306;140300;08-450;485;339;335;269;66
3;140306;140300;08-450;1176;945;938;748;190
4;140306;140300;08-450;529;381;380;304;76
5;140306;140300;08-450;559;426;423;349;74
6;140306;140300;08-450;290;240;237;175;62
1;140307;140300;08-480;1101;841;828;577;251
2;140307;140300;08-480;1284;891;882;734;148
3;140307;140300;08-480;337;257;254;232;22
4;140307;140300;08-480;373;276;274;237;37
5;140307;140300;08-480;263;189;188;153;35
6;140307;140300;08-480;231;173;170;142;28
7;140307;140300;08-480;217;160;160;132;28
8;140307;140300;08-480;300;207;205;168;37
9;140307;140300;08-480;495;398;396;331;65
10;140307;140300;08-480;186;138;138;114;24
11;140307;140300;08-480;326;254;249;209;40
12;140307;140300;08-480;181;130;129;117;12
1;140308;140300;08-420;568;461;459;329;130
2;140308;140300;08-420;453;344;341;316;25
3;140308;140300;08-420;170;135;134;101;33
4;140308;140300;08-420;259;186;185;143;42
5;140308;140300;08-420;548;434;432;353;79
6;140308;140300;08-420;399;314;311;242;69
7;140308;140300;08-420;164;132;130;105;25
8;140308;140300;08-420;226;174;171;129;42
9;140308;140300;08-420;319;246;246;187;59
10;140308;140300;08-420;273;233;231;204;27
11;140308;140300;08-420;238;200;199;175;24
1;140309;140300;08-441;826;657;653;520;133
2;140309;140300;08-441;141;102;102;93;9
3;140309;140300;08-441;525;375;374;341;33
4;140309;140300;08-441;442;339;337;281;56
5;140309;140300;08-441;181;135;132;105;27
6;140309;140300;08-441;205;160;160;143;17
7;140309;140300;08-441;352;268;266;243;23
8;140309;140300;08-441;291;227;226;218;8
9;140309;140300;08-441;175;129;129;104;25
1;140310;140300;08-440;638;512;508;424;84
2;140310;140300;08-440;585;449;445;363;82
3;140310;140300;08-440;835;581;578;386;192
4;140310;140300;08-440;551;450;446;302;144
5;140310;140300;08-440;366;279;274;232;42
6;140310;140300;08-440;671;510;507;407;100
7;140310;140300;08-440;1307;1008;988;681;307
8;140310;140300;08-440;999;766;759;562;197
9;140310;140300;08-440;1023;789;781;522;259
10;140310;140300;08-440;546;430;426;333;93
11;140310;140300;08-440;170;109;108;93;15
12;140310;140300;08-440;229;191;191;178;13
13;140310;140300;08-440;174;133;131;116;15
1;140311;140300;08-460;699;566;563;490;73
2;140311;140300;08-460;769;627;623;560;63
3;140311;140300;08-460;1586;1149;1139;856;283
4;140311;140300;08-460;1119;849;841;598;243
5;140311;140300;08-460;441;337;334;294;40
6;140311;140300;08-460;455;319;315;264;51
7;140311;140300;08-460;392;316;314;278;36
8;140311;140300;08-460;572;444;440;405;35
1;140312;140300;08-455;785;597;589;459;130
2;140312;140300;08-455;283;209;207;171;36
3;140312;140300;08-455;824;613;611;493;118
4;140312;140300;08-455;363;261;260;232;28
5;140312;140300;08-455;439;373;369;344;25
6;140312;140300;08-455;244;196;196;161;35
7;140312;140300;08-455;1065;750;745;627;118
8;140312;140300;08-455;298;237;234;198;36
9;140312;140300;08-455;320;256;251;228;23
10;140312;140300;08-455;336;264;259;193;66
11;140312;140300;08-455;273;214;211;182;29
12;140312;140300;08-455;313;256;255;238;17
1;140313;140300;08-470;1013;752;745;461;284
2;140313;140300;08-470;755;544;540;376;164
3;140313;140300;08-470;742;541;537;343;194
4;140313;140300;08-470;403;318;316;273;43
5;140313;140300;08-470;921;686;677;357;320
6;140313;140300;08-470;479;374;371;247;124
1;140314;140300;08-430;1049;776;769;587;182
2;140314;140300;08-430;900;673;664;533;131
3;140314;140300;08-430;469;342;338;285;53
4;140314;140300;08-430;451;349;343;311;32
5;140314;140300;08-430;977;786;779;705;74
6;140314;140300;08-430;441;341;336;280;56
7;140314;140300;08-430;215;179;179;155;24
8;140314;140300;08-430;216;172;170;153;17
9;140314;140300;08-430;894;643;633;468;165
10;140314;140300;08-430;402;324;321;269;52
11;140314;140300;08-430;19;19;19;8;11
1;140401;140400;09-500;844;574;570;265;305
2;140401;140400;09-500;984;680;678;359;319
3;140401;140400;09-500;724;518;510;236;274
4;140401;140400;09-500;967;716;707;365;342
5;140401;140400;09-500;846;577;573;308;265
6;140401;140400;09-500;957;737;729;366;363
7;140401;140400;09-500;1001;602;596;363;233
8;140401;140400;09-500;740;490;484;259;225
9;140401;140400;09-500;742;508;505;248;257
10;140401;140400;09-500;981;704;701;356;345
11;140401;140400;09-500;790;569;566;337;229
12;140401;140400;09-500;1626;1162;1152;551;601
13;140401;140400;09-500;1482;1002;993;569;424
14;140401;140400;09-500;286;110;107;66;41
15;140401;140400;09-500;107;61;56;40;16
16;140401;140400;09-500;65;40;38;11;27
1;140402;140400;09-500;777;532;527;306;221
2;140402;140400;09-500;592;386;385;307;78
3;140402;140400;09-500;530;360;356;223;133
4;140402;140400;09-500;598;385;381;292;89
5;140402;140400;09-500;1130;813;807;498;309
6;140402;140400;09-500;1110;673;665;492;173
7;140402;140400;09-500;436;297;293;210;83
8;140402;140400;09-500;501;352;349;275;74
9;140402;140400;09-500;591;432;427;272;155
10;140402;140400;09-500;936;529;525;392;133
11;140402;140400;09-500;853;629;625;388;237
12;140402;140400;09-500;260;187;182;96;86
13;140402;140400;09-500;385;256;253;187;66
14;140402;140400;09-500;210;142;139;97;42
15;140402;140400;09-500;297;221;218;142;76
16;140402;140400;09-500;166;132;129;103;26
17;140402;140400;09-500;114;88;88;58;30
1;140403;140400;09-541;655;429;423;321;102
2;140403;140400;09-541;785;517;516;444;72
3;140403;140400;09-541;313;226;225;171;54
4;140403;140400;09-541;531;353;350;291;59
5;140403;140400;09-451;308;197;196;150;46
6;140403;140400;09-541;44;29;28;23;5
1;140404;140400;09-540;416;265;262;215;47
2;140404;140400;09-540;240;172;171;156;15
3;140404;140400;09-540;519;324;323;282;41
4;140404;140400;09-540;639;467;462;321;141
5;140404;140400;09-540;615;456;452;330;122
6;140404;140400;09-540;502;306;305;201;104
7;140404;140400;09-540;303;223;219;175;44
8;140404;140400;09-540;617;457;454;365;89
9;140404;140400;09-540;273;191;190;155;35
10;140404;140400;09-540;396;268;265;238;27
1;140405;140400;09-550;1068;752;744;494;250
2;140405;140400;09-550;837;536;532;439;93
3;140405;140400;09-550;1008;690;684;557;127
4;140405;140400;09-550;886;563;560;443;117
1;140501;140500;05-822;1393;1131;1120;412;708
2;140501;140500;05-822;1754;1432;1415;522;893
3;140501;140500;05-822;740;622;613;231;382
4;140501;140500;05-822;1498;1236;1227;465;762
5;140501;140500;05-822;1902;1477;1460;620;840
6;140501;140500;05-822;1910;1607;1582;687;895
7;140501;140500;05-822;1846;1440;1428;591;837
8;140501;140500;05-822;1516;1275;1256;499;757
1;140502;140500;05-807;1562;1318;1299;421;878
2;140502;140500;05-807;1508;1307;1292;408;884
1;140503;140500;96-314;1314;914;904;571;333
2;140503;140500;96-314;604;462;458;317;141
3;140503;140500;96-314;941;750;744;454;290
4;140503;140500;96-314;1144;779;770;503;267
1;140504;140500;05-825;1536;1185;1167;560;607
2;140504;140500;05-825;1665;1246;1229;610;619
3;140504;140500;05-825;1846;1484;1467;584;883
4;140504;140500;05-825;1182;873;866;400;466
5;140504;140500;05-825;1040;763;758;323;435
6;140504;140500;05-825;1604;1166;1153;532;621
7;140504;140500;05-825;1153;853;846;361;485
8;140504;140500;05-825;1726;1412;1398;520;878
9;140504;140500;05-825;1460;1139;1132;492;640
10;140504;140500;05-827;1800;1490;1472;558;914
11;140504;140500;05-827;1454;1178;1171;480;691
12;140504;140500;05-827;1667;1375;1362;541;821
13;140504;140500;05-825;1800;1519;1506;575;931
14;140504;140500;05-825;1829;1513;1499;619;880
15;140504;140500;05-825;1418;1081;1069;518;551
16;140504;140500;05-825;543;407;404;240;164
17;140504;140500;05-825;734;559;551;261;290
18;140504;140500;05-825;1510;1236;1224;487;737
19;140504;140500;05-825;1128;934;928;388;540
20;140504;140500;05-825;694;587;573;249;324
21;140504;140500;05-825;1129;888;876;360;516
22;140504;140500;05-825;1279;1013;1006;534;472
23;140504;140500;05-825;1748;1459;1444;598;846
24;140504;140500;05-825;1362;1177;1158;426;732
25;140504;140500;05-825;805;679;678;277;401
26;140504;140500;05-825;1470;1217;1202;428;774
27;140504;140500;05-825;1511;1181;1170;471;699
28;140504;140500;05-825;1690;1473;1453;459;994
29;140504;140500;05-825;749;532;529;355;174
30;140504;140500;05-825;133;56;56;23;33
31;140504;140500;05-825;20;13;13;12;1
32;140504;140500;05-825;20;12;10;6;4
1;140505;140500;96-313;1767;1345;1328;720;608
2;140505;140500;96-316;1856;1488;1468;621;847
3;140505;140500;96-313;702;534;526;298;228
4;140505;140500;96-316;579;430;423;212;211
5;140505;140500;96-313;1989;1575;1565;837;728
6;140505;140500;96-316;2022;1532;1522;744;778
7;140505;140500;96-313;1329;1016;1001;559;442
1;140506;140500;96-321;1059;820;813;370;443
2;140506;140500;96-321;1466;1108;1091;668;423
3;140506;140500;96-321;730;571;567;332;235
4;140506;140500;96-321;1476;1241;1236;471;765
5;140506;140500;96-321;1262;1025;1011;484;527
6;140506;140500;96-321;1227;1014;1006;444;562
7;140506;140500;96-321;1345;1077;1072;411;661
1;140601;140600;05-622;1077;764;756;441;315
2;140601;140600;05-622;605;450;445;326;119
3;140601;140600;05-622;775;590;583;416;167
4;140601;140600;05-622;304;218;214;122;92
5;140601;140600;05-622;456;309;305;204;101
6;140601;140600;05-622;559;407;402;318;84
7;140601;140600;05-622;959;662;655;453;202
8;140601;140600;05-622;250;188;188;109;79
1;140602;140600;05-620;1123;858;851;585;266
2;140602;140600;05-620;752;545;541;418;123
3;140602;140600;05-620;1647;1215;1206;945;261
4;140602;140600;05-620;1099;777;773;556;217
5;140602;140600;05-620;1125;745;738;586;152
1;140603;140600;05-650;1852;1378;1366;871;495
2;140603;140600;05-650;708;487;484;311;173
3;140603;140600;05-650;597;427;423;287;136
4;140603;140600;05-650;477;332;328;263;65
5;140603;140600;05-650;675;446;444;327;117
6;140603;140600;05-651;1370;948;935;601;334
7;140603;140600;05-651;507;380;378;215;163
8;140603;140600;05-650;1673;1313;1298;695;603
1;140604;140600;05-610;745;594;586;445;141
2;140604;140600;05-610;735;553;550;447;103
3;140604;140600;05-610;484;362;358;301;57
4;140604;140600;05-610;325;252;248;211;37
1;140605;140600;05-600;1980;1543;1533;696;837
2;140605;140600;05-600;1338;1056;1047;459;588
3;140605;140600;05-600;1206;964;954;440;514
4;140605;140600;05-600;1676;1291;1276;616;660
5;140605;140600;05-600;1514;1156;1148;514;634
6;140605;140600;05-600;1357;974;966;477;489
7;140605;140600;05-600;1127;794;793;408;385
8;140605;140600;05-600;588;443;438;234;204
9;140605;140600;05-600;1164;877;871;505;366
10;140605;140600;05-600;1037;805;799;338;461
11;140605;140600;05-600;644;419;417;304;113
12;140605;140600;05-600;561;385;384;239;145
13;140605;140600;05-600;697;519;516;310;206
14;140605;140600;05-600;640;458;457;268;189
15;140605;140600;05-600;180;135;134;81;53
16;140605;140600;05-600;652;521;517;277;240
17;140605;140600;05-600;171;140;139;92;47
18;140605;140600;05-600;298;228;228;134;94
19;140605;140600;05-600;482;358;355;194;161
20;140605;140600;05-600;984;783;773;339;434
21;140605;140600;05-600;1174;883;874;414;460
22;140605;140600;05-600;157;127;125;26;99
23;140605;140600;05-600;151;66;65;43;22
24;140605;140600;05-600;83;32;31;14;17
1;140606;140600;05-604;1521;1126;1114;708;406
2;140606;140600;05-604;785;605;601;439;162
3;140606;140600;05-604;844;586;582;431;151
4;140606;140600;05-604;526;359;357;227;130
5;140606;140600;05-604;522;386;385;302;83
1;140607;140600;05-640;1130;821;813;560;253
2;140607;140600;05-640;913;639;630;440;190
3;140607;140600;05-640;1337;1009;1002;748;254
4;140607;140600;05-640;652;471;469;352;117
5;140607;140600;05-640;524;380;379;306;73
6;140607;140600;26-420;527;379;379;316;63
7;140607;140600;05-640;676;516;511;430;81
8;140607;140600;05-640;547;402;399;329;70
9;140607;140600;05-640;379;292;289;203;86
10;140607;140600;05-640;94;50;41;25;16
1;140608;140600;26-420;1410;1072;1052;719;333
2;140608;140600;26-420;1298;1011;997;598;399
3;140608;140600;26-420;1095;804;801;674;127
4;140608;140600;26-420;858;619;617;537;80
5;140608;140600;26-420;1210;882;871;587;284
6;140608;140600;26-420;33;13;13;12;1
7;140608;140600;26-420;30;20;20;17;3
1;140609;140600;05-652;1004;734;725;473;252
2;140609;140600;05-652;636;482;474;323;151
3;140609;140600;05-652;784;596;592;333;259
4;140609;140600;05-652;827;605;598;372;226
5;140609;140600;05-652;558;431;427;285;142
1;140611;140600;05-660;1834;1378;1365;820;545
2;140611;140600;05-660;1601;1194;1178;707;471
3;140611;140600;05-660;1203;953;945;537;408
4;140611;140600;05-660;1221;924;919;584;335
5;140611;140600;05-660;1374;1089;1077;690;387
6;140611;140600;05-660;1576;1244;1235;775;460
7;140611;140600;05-660;439;322;319;224;95
8;140611;140600;05-660;983;683;677;453;224
9;140611;140600;05-660;536;370;366;253;113
10;140611;140600;05-660;530;376;375;281;94
11;140611;140600;05-660;303;225;220;154;66
12;140611;140600;05-660;410;311;308;235;73
13;140611;140600;05-660;528;404;398;280;118
14;140611;140600;05-660;789;585;582;399;183
15;140611;140600;05-660;191;144;143;105;38
16;140611;140600;05-660;292;226;223;153;70
17;140611;140600;05-660;213;166;162;117;45
18;140611;140600;05-660;242;197;196;158;38
19;140611;140600;05-660;151;117;115;85;30
20;140611;140600;05-660;170;113;111;88;23
1;140701;140700;26-930;530;407;403;240;163
2;140701;140700;26-930;1064;772;765;515;250
3;140701;140700;26-930;1368;999;992;671;321
4;140701;140700;26-930;424;266;264;210;54
5;140701;140700;26-930;419;308;306;254;52
6;140701;140700;26-930;329;259;252;38;214
1;140702;140700;26-903;1481;1134;1124;893;231
2;140702;140700;26-903;382;276;273;224;49
3;140702;140700;26-903;1247;952;941;710;231
4;140702;140700;26-903;328;248;246;202;44
5;140702;140700;26-903;674;515;513;431;82
6;140702;140700;26-903;684;518;514;458;56
7;140702;140700;26-903;266;204;202;163;39
8;140702;140700;26-903;239;178;174;140;34
9;140702;140700;26-903;135;100;100;74;26
1;140703;140700;26-920;513;343;342;262;80
2;140703;140700;26-920;731;512;511;373;138
3;140703;140700;26-920;525;377;373;296;77
4;140703;140700;26-920;519;359;358;301;57
5;140703;140700;26-920;377;262;261;208;53
6;140703;140700;26-920;266;195;192;160;32
1;140704;140700;26-902;1387;1089;1081;753;328
2;140704;140700;26-902;946;705;702;584;118
3;140704;140700;26-902;551;407;403;329;74
4;140704;140700;26-902;446;337;333;263;70
1;140705;140700;26-900;597;443;442;283;159
2;140705;140700;26-900;920;587;583;431;152
3;140705;140700;26-900;782;606;603;501;102
4;140705;140700;26-900;821;579;575;409;166
5;140705;140700;26-900;778;585;580;370;210
6;140705;140700;26-900;722;543;538;334;204
7;140705;140700;26-900;981;782;774;562;212
8;140705;140700;26-900;1319;929;921;600;321
9;140705;140700;26-900;969;701;693;524;169
10;140705;140700;26-900;668;448;446;359;87
11;140705;140700;26-900;991;749;743;385;358
12;140705;140700;26-900;1148;824;814;515;299
13;140705;140700;26-900;1022;707;701;414;287
14;140705;140700;26-900;677;503;499;312;187
15;140705;140700;26-900;1123;867;862;445;417
16;140705;140700;26-900;1060;816;811;411;400
17;140705;140700;26-900;865;632;631;399;232
18;140705;140700;26-900;1102;802;795;464;331
19;140705;140700;26-900;1048;753;746;420;326
20;140705;140700;26-900;886;612;608;339;269
21;140705;140700;26-900;96;43;40;26;14
22;140705;140700;26-900;1009;799;796;521;275
23;140705;140700;26-900;1087;774;767;428;339
24;140705;140700;26-900;163;121;118;86;32
25;140705;140700;26-900;373;281;280;202;78
26;140705;140700;26-900;277;192;189;149;40
27;140705;140700;26-900;163;53;52;32;20
1;140706;140700;26-910;905;665;660;193;467
2;140706;140700;26-910;856;622;616;506;110
3;140706;140700;26-910;691;533;530;417;113
4;140706;140700;26-910;306;221;220;194;26
5;140706;140700;26-910;400;311;309;212;97
6;140706;140700;26-910;565;403;401;323;78
7;140706;140700;26-910;573;444;439;268;171
8;140706;140700;26-910;439;329;324;217;107
9;140706;140700;26-910;313;213;212;176;36
10;140706;140700;26-910;327;267;266;225;41
1;140707;140700;26-922;682;458;452;337;115
2;140707;140700;26-922;681;490;487;382;105
3;140707;140700;26-922;923;631;620;436;184
4;140707;140700;26-922;240;159;158;129;29
5;140707;140700;26-922;437;318;318;259;59
1;140801;140800;05-120;1833;1440;1427;647;780
2;140801;140800;05-120;2283;1740;1723;800;923
3;140801;140800;05-119;1985;1597;1579;718;861
4;140801;140800;05-119;1493;1255;1241;484;757
5;140801;140800;05-119;2177;1570;1543;562;981
6;140801;140800;05-119;2082;1731;1719;570;1149
7;140801;140800;05-119;2475;1949;1930;735;1195
8;140801;140800;05-120;1939;1596;1587;643;944
9;140801;140800;05-120;1956;1506;1489;602;887
10;140801;140800;05-120;1724;1434;1423;581;842
11;140801;140800;05-120;1024;823;813;361;452
12;140801;140800;05-120;1670;1372;1363;579;784
13;140801;140800;05-120;1347;1135;1131;472;659
14;140801;140800;05-120;1512;1193;1185;550;635
15;140801;140800;05-120;1450;1147;1139;526;613
16;140801;140800;05-120;2175;1742;1728;753;975
17;140801;140800;05-120;1613;1285;1277;585;692
18;140801;140800;05-120;1722;1372;1358;602;756
19;140801;140800;05-120;1442;1181;1172;508;664
20;140801;140800;05-120;1390;1060;1047;501;546
21;140801;140800;05-120;1471;1151;1140;511;629
22;140801;140800;05-120;1300;993;983;455;528
23;140801;140800;05-120;1433;1186;1167;484;683
24;140801;140800;05-120;85;57;47;26;21
25;140801;140800;05-119;79;16;16;5;11
1;140802;140800;05-110;2098;1675;1657;622;1035
2;140802;140800;05-110;2296;1898;1886;731;1155
3;140802;140800;05-110;1426;1163;1148;407;741
4;140802;140800;05-110;1584;1282;1278;602;676
5;140802;140800;05-123;1673;1395;1384;491;893
6;140802;140800;05-123;2387;1958;1936;750;1186
7;140802;140800;05-123;1997;1639;1628;591;1037
8;140802;140800;05-101;1500;1243;1234;469;765
9;140802;140800;05-101;1265;1026;1014;463;551
1;140803;140800;05-126;694;594;590;186;404
2;140803;140800;05-126;1025;865;858;386;472
3;140803;140800;05-126;692;561;558;291;267
4;140803;140800;05-126;1186;980;974;506;468
5;140803;140800;05-127;823;621;616;265;351
6;140803;140800;05-126;1180;1040;1030;412;618
7;140803;140800;05-126;819;698;688;332;356
8;140803;140800;05-119;1246;1042;1031;423;608
9;140803;140800;05-126;1397;1157;1139;544;595
10;140803;140800;05-119;838;754;750;201;549
11;140803;140800;05-119;979;852;844;329;515
12;140803;140800;05-126;769;626;623;372;251
13;140803;140800;05-130;627;468;464;196;268
14;140803;140800;05-127;278;223;222;138;84
15;140803;140800;05-127;183;146;145;101;44
1;140804;140800;05-140;2676;2136;2117;963;1154
2;140804;140800;05-140;1533;1257;1251;588;663
3;140804;140800;05-140;597;433;432;210;222
4;140804;140800;05-140;1189;971;964;438;526
5;140804;140800;05-140;3104;2385;2358;1077;1281
6;140804;140800;05-140;2425;1835;1822;1058;764
7;140804;140800;05-140;2227;1797;1784;773;1011
8;140804;140800;05-131;733;591;586;209;377
1;140805;140800;05-124;928;739;728;410;318
2;140805;140800;05-123;1515;1288;1270;537;733
3;140805;140800;05-124;2025;1635;1622;702;920
4;140805;140800;05-135;1789;1375;1360;674;686
5;140805;140800;05-135;1972;1566;1541;719;822
6;140805;140800;05-119;1842;1514;1500;639;861
7;140805;140800;05-119;1407;1126;1110;512;598
8;140805;140800;05-135;1432;1199;1187;486;701
9;140805;140800;05-124;494;374;371;216;155
10;140805;140800;05-124;201;158;157;77;80
11;140805;140800;05-124;645;549;540;250;290
12;140805;140800;05-135;481;414;407;176;231
13;140805;140800;05-119;19;19;19;9;10
14;140805;140800;05-135;81;73;73;48;25
1;140901;140900;27-312;430;254;253;186;67
2;140901;140900;27-312;758;523;521;397;124
3;140901;140900;27-312;679;444;440;361;79
1;140902;140900;27-310;323;228;226;195;31
2;140902;140900;27-310;336;208;204;166;38
3;140902;140900;27-310;568;409;408;261;147
4;140902;140900;27-310;1581;1053;1045;827;218
5;140902;140900;27-310;653;435;434;334;100
6;140902;140900;27-310;382;255;255;206;49
7;140902;140900;27-310;311;199;197;172;25
1;140903;140900;27-300;1361;902;899;478;421
2;140903;140900;27-300;1051;752;749;471;278
3;140903;140900;27-300;1379;932;923;527;396
4;140903;140900;27-300;495;333;325;240;85
5;140903;140900;27-300;340;231;231;172;59
6;140903;140900;27-300;714;490;480;366;114
7;140903;140900;27-300;211;129;129;109;20
8;140903;140900;27-300;703;457;451;329;122
9;140903;140900;27-300;529;353;352;269;83
10;140903;140900;27-300;575;390;385;278;107
11;140903;140900;27-300;73;29;26;15;11
12;140903;140900;27-300;552;354;354;244;110
13;140903;140900;27-300;173;67;65;45;20
1;140904;140900;27-353;1172;833;827;651;176
2;140904;140900;27-353;350;249;246;199;47
3;140904;140900;27-353;882;592;589;488;101
4;140904;140900;27-353;418;292;291;220;71
5;140904;140900;27-353;417;260;258;225;33
1;140905;140900;27-350;892;585;579;398;181
2;140905;140900;27-350;430;262;262;226;36
3;140905;140900;27-350;567;353;347;281;66
4;140905;140900;27-350;382;273;271;216;55
5;140905;140900;27-350;789;549;548;455;93
6;140905;140900;27-350;448;291;288;226;62
7;140905;140900;27-350;826;531;529;369;160
1;140906;140900;27-320;849;561;558;354;204
2;140906;140900;27-320;243;142;141;102;39
3;140906;140900;27-320;448;244;243;193;50
4;140906;140900;27-320;520;328;324;222;102
5;140906;140900;27-320;386;229;226;169;57
6;140906;140900;27-320;292;193;193;128;65
7;140906;140900;27-320;192;131;131;115;16
8;140906;140900;27-320;313;196;196;162;34
9;140906;140900;27-320;171;112;112;77;35
10;140906;140900;27-320;338;227;226;175;51
1;141001;141000;08-206;538;386;381;315;66
2;141001;141000;08-206;352;232;232;185;47
3;141001;141000;08-206;386;293;291;252;39
4;141001;141000;08-206;527;354;352;322;30
5;141001;141000;08-206;254;170;168;152;16
1;141002;141000;08-200;1144;860;850;599;251
2;141002;141000;08-200;1123;787;781;510;271
3;141002;141000;08-200;963;677;672;416;256
4;141002;141000;08-200;893;581;574;374;200
5;141002;141000;08-200;260;196;196;168;28
6;141002;141000;08-200;629;431;430;333;97
7;141002;141000;08-200;354;231;228;199;29
8;141002;141000;08-200;639;457;451;362;89
9;141002;141000;08-200;154;91;87;77;10
10;141002;141000;08-200;174;121;121;103;18
11;141002;141000;08-200;169;126;124;92;32
12;141002;141000;08-200;161;125;125;111;14
13;141002;141000;08-200;249;174;173;133;40
14;141002;141000;08-200;936;680;674;479;195
15;141002;141000;08-200;100;49;49;34;15
1;141003;141000;08-207;445;337;333;289;44
2;141003;141000;08-207;454;345;343;302;41
3;141003;141000;08-207;779;581;576;467;109
4;141003;141000;08-207;318;272;271;246;25
5;141003;141000;08-207;167;131;131;116;15
1;141004;141000;08-210;239;174;171;153;18
2;141004;141000;08-210;621;457;448;321;127
3;141004;141000;08-210;838;516;512;428;84
4;141004;141000;08-210;394;272;271;219;52
5;141004;141000;08-210;369;260;259;219;40
6;141004;141000;08-210;328;222;220;161;59
7;141004;141000;08-210;157;94;94;71;23
8;141004;141000;08-210;337;239;239;178;61
9;141004;141000;08-210;248;182;182;143;39
1;141005;141000;08-220;1173;822;816;565;251
2;141005;141000;08-220;516;348;345;279;66
3;141005;141000;08-220;711;514;512;409;103
4;141005;141000;08-220;772;570;565;382;183
5;141005;141000;08-221;195;140;140;103;37
6;141005;141000;08-221;257;187;187;164;23
1;141006;141000;08-205;976;624;619;485;134
2;141006;141000;08-205;344;240;239;217;22
3;141006;141000;08-205;293;241;239;225;14
4;141006;141000;08-205;480;309;307;274;33
5;141006;141000;08-205;361;227;222;183;39
6;141006;141000;08-205;273;176;175;157;18
7;141006;141000;08-205;461;325;323;288;35
8;141006;141000;08-205;258;181;180;151;29
1;141101;141100;06-200;1010;717;713;433;280
2;141101;141100;06-200;1081;713;708;396;312
3;141101;141100;06-200;1644;1098;1086;639;447
4;141101;141100;06-200;1535;1139;1132;712;420
5;141101;141100;06-200;1422;996;986;580;406
6;141101;141100;06-200;125;69;69;53;16
7;141101;141100;06-200;37;23;22;9;13
1;141102;141100;06-232;522;369;368;302;66
2;141102;141100;06-200;304;213;211;161;50
3;141102;141100;06-232;145;104;102;86;16
4;141102;141100;06-232;162;110;110;89;21
5;141102;141100;06-232;209;167;167;132;35
6;141102;141100;06-232;255;195;194;171;23
7;141102;141100;06-200;176;124;123;97;26
8;141102;141100;06-200;276;207;204;152;52
1;141103;141100;06-425;1792;1244;1231;942;289
2;141103;141100;06-425;570;390;389;300;89
3;141103;141100;06-425;746;539;529;415;114
4;141103;141100;06-100;726;542;537;452;85
1;141104;141100;06-212;1253;820;813;538;275
2;141104;141100;06-212;528;349;346;275;71
3;141104;141100;06-212;524;337;335;277;58
4;141104;141100;06-212;364;230;229;189;40
5;141104;141100;06-214;1181;781;772;601;171
6;141104;141100;06-214;387;263;260;219;41
7;141104;141100;06-212;377;255;255;212;43
1;141105;141100;06-231;512;372;366;292;74
2;141105;141100;06-231;311;210;207;177;30
3;141105;141100;06-231;289;227;224;207;17
4;141105;141100;06-231;191;156;154;121;33
1;141106;141100;06-210;485;350;348;290;58
2;141106;141100;06-210;219;166;164;121;43
3;141106;141100;06-210;730;494;487;332;155
4;141106;141100;06-210;452;322;320;261;59
5;141106;141100;06-211;860;547;543;435;108
6;141106;141100;06-211;647;434;433;323;110
7;141106;141100;06-211;307;208;206;166;40
8;141106;141100;06-210;238;161;159;139;20
1;141107;141100;06-230;1122;845;837;526;311
2;141107;141100;06-230;979;699;697;463;234
3;141107;141100;06-230;1384;973;969;656;313
1;141108;141100;06-225;1170;878;868;657;211
2;141108;141100;06-225;678;509;507;290;217
3;141108;141100;06-225;321;233;233;173;60
1;141109;141100;06-216;1046;752;742;588;154
2;141109;141100;06-216;179;116;116;101;15
3;141109;141100;06-213;191;134;134;114;20
4;141109;141100;06-213;950;681;675;545;130
1;141110;141100;06-220;564;418;416;298;118
2;141110;141100;06-200;525;367;364;251;113
3;141110;141100;06-200;221;161;159;131;28
4;141110;141100;06-220;354;272;267;193;74
5;141110;141100;06-220;376;279;278;227;51
6;141110;141100;06-220;170;110;110;79;31
7;141110;141100;06-200;193;124;124;116;8
8;141110;141100;06-220;443;333;330;271;59
1;141201;141200;05-300;1461;1201;1194;644;550
2;141201;141200;05-300;1442;1126;1113;577;536
3;141201;141200;05-300;1425;1150;1140;601;539
4;141201;141200;05-300;1541;1214;1195;561;634
5;141201;141200;05-300;1647;1303;1298;571;727
6;141201;141200;05-300;1335;1063;1059;519;540
7;141201;141200;05-300;1508;1180;1168;588;580
8;141201;141200;05-300;1510;1212;1196;624;572
9;141201;141200;05-300;1499;1138;1126;572;554
10;141201;141200;05-300;1484;1228;1220;544;676
11;141201;141200;05-300;1464;1147;1131;510;621
12;141201;141200;05-300;1221;934;927;438;489
13;141201;141200;05-300;1303;984;974;611;363
14;141201;141200;05-300;1280;988;977;520;457
15;141201;141200;05-300;1154;832;825;417;408
16;141201;141200;05-300;901;745;740;319;421
17;141201;141200;05-300;1331;1068;1061;482;579
18;141201;141200;05-300;1043;836;831;389;442
19;141201;141200;05-300;1757;1430;1415;719;696
20;141201;141200;05-300;1150;900;891;427;464
21;141201;141200;05-300;2036;1662;1657;866;791
22;141201;141200;05-300;74;26;26;18;8
1;141204;141200;05-319;1105;875;865;464;401
2;141204;141200;05-319;1194;890;879;492;387
3;141204;141200;05-319;382;278;276;211;65
4;141204;141200;05-319;513;388;386;279;107
5;141204;141200;05-319;327;238;235;164;71
6;141204;141200;05-319;754;530;525;303;222
7;141204;141200;05-319;321;248;243;169;74
8;141204;141200;05-319;125;40;35;25;10
1;141205;141200;05-311;918;703;700;432;268
2;141205;141200;05-311;1370;1038;1030;625;405
3;141205;141200;05-300;1218;882;874;607;267
4;141205;141200;05-311;1709;1376;1358;810;548
5;141205;141200;05-311;1365;1060;1044;607;437
6;141205;141200;05-311;1248;1023;1017;571;446
7;141205;141200;05-300;291;196;194;136;58
8;141205;141200;05-311;436;355;350;235;115
1;141206;141200;05-307;848;635;630;382;248
2;141206;141200;05-307;840;631;629;430;199
3;141206;141200;05-307;1118;798;790;596;194
4;141206;141200;05-307;750;522;520;396;124
5;141206;141200;05-307;602;473;470;354;116
6;141206;141200;05-307;379;291;289;199;90
7;141206;141200;05-307;304;232;231;150;81
1;141207;141200;05-074;1079;805;795;401;394
2;141207;141200;05-074;1765;1432;1422;694;728
3;141207;141200;05-074;877;692;687;335;352
4;141207;141200;05-079;958;754;747;481;266
5;141207;141200;05-079;708;565;559;346;213
6;141207;141200;05-074;855;678;668;328;340
7;141207;141200;05-074;1125;940;923;552;371
8;141207;141200;05-074;1553;1270;1263;655;608
9;141207;141200;05-071;738;592;585;345;240
10;141207;141200;05-074;1605;1309;1293;643;650
11;141207;141200;05-079;844;654;649;371;278
12;141207;141200;05-074;371;285;283;160;123
13;141207;141200;05-074;617;527;521;247;274
1;141208;141200;05-306;1013;757;751;565;186
2;141208;141200;05-306;614;470;467;334;133
3;141208;141200;05-306;823;645;641;480;161
4;141208;141200;05-306;646;447;441;292;149
5;141208;141200;05-306;788;583;577;446;131
1;141209;141200;05-310;1230;883;877;582;295
2;141209;141200;05-310;908;691;682;446;236
3;141209;141200;05-310;1210;869;862;709;153
4;141209;141200;05-310;431;316;315;243;72
5;141209;141200;05-310;614;445;443;338;105
1;141210;141200;05-334;1085;764;758;532;226
2;141210;141200;05-334;543;380;377;312;65
3;141210;141200;05-334;1154;835;832;668;164
4;141210;141200;05-334;676;481;473;382;91
5;141210;141200;05-334;297;237;235;193;42
6;141210;141200;05-334;241;158;156;127;29
1;141211;141200;05-300;773;561;556;381;175
2;141211;141200;05-300;927;706;704;411;293
3;141211;141200;05-300;1791;1362;1348;977;371
4;141211;141200;05-300;1346;976;964;543;421
5;141211;141200;05-300;1114;825;821;497;324
6;141211;141200;05-300;1607;1187;1180;777;403
7;141211;141200;05-300;1115;904;890;536;354
8;141211;141200;05-300;1390;1054;1041;598;443
9;141211;141200;05-300;921;719;710;397;313
10;141211;141200;05-300;857;698;688;369;319
11;141211;141200;05-300;382;280;279;154;125
12;141211;141200;05-300;53;21;19;7;12
1;141212;141200;05-317;450;309;305;251;54
2;141212;141200;05-317;583;411;407;310;97
3;141212;141200;05-320;471;334;328;249;79
4;141212;141200;05-320;445;316;311;262;49
5;141212;141200;05-320;374;264;264;184;80
6;141212;141200;05-320;1472;1127;1116;609;507
7;141212;141200;05-320;895;628;623;439;184
8;141212;141200;05-320;940;706;702;346;356
9;141212;141200;05-320;816;659;651;376;275
10;141212;141200;05-320;299;234;230;145;85
11;141212;141200;05-320;155;86;86;55;31
1;141213;141200;05-332;1368;1090;1076;652;424
2;141213;141200;05-332;538;366;361;253;108
3;141213;141200;05-332;920;671;668;504;164
4;141213;141200;05-332;880;614;609;414;195
5;141213;141200;05-332;586;432;426;275;151
6;141213;141200;05-332;549;391;387;300;87
7;141213;141200;05-332;459;352;349;218;131
8;141213;141200;05-332;244;186;185;154;31
9;141213;141200;05-332;255;187;184;143;41
10;141213;141200;05-332;239;55;55;37;18
1;141214;141200;05-304;1402;1126;1120;745;375
2;141214;141200;05-304;1134;874;865;645;220
3;141214;141200;05-304;326;255;250;166;84
4;141214;141200;05-304;562;423;419;321;98
5;141214;141200;05-304;476;318;314;246;68
6;141214;141200;05-304;220;167;166;147;19
7;141214;141200;05-304;149;110;110;83;27
8;141214;141200;05-304;643;500;496;400;96
9;141214;141200;05-304;540;408;401;304;97
1;141215;141200;05-070;3101;2551;2522;1107;1415
2;141215;141200;05-070;1160;922;911;445;466
3;141215;141200;05-070;1975;1610;1591;705;886
4;141215;141200;05-071;1806;1357;1346;747;599
5;141215;141200;05-071;1226;970;958;510;448
6;141215;141200;05-071;2123;1732;1719;888;831
7;141215;141200;05-071;945;752;748;387;361
8;141215;141200;05-070;1584;1291;1278;599;679
9;141215;141200;05-070;1954;1596;1574;782;792
10;141215;141200;05-070;140;64;61;17;44
1;141301;141300;06-500;1791;1228;1222;718;504
2;141301;141300;06-500;1292;900;890;500;390
3;141301;141300;06-500;1150;769;762;384;378
4;141301;141300;06-500;1913;1407;1403;798;605
5;141301;141300;06-500;1808;1331;1324;734;590
6;141301;141300;06-500;1728;1225;1221;668;553
7;141301;141300;06-500;1495;978;971;541;430
8;141301;141300;06-500;1618;1123;1116;470;646
9;141301;141300;06-500;1525;1106;1100;590;510
10;141301;141300;06-500;1590;1085;1073;526;547
11;141301;141300;06-500;1478;1020;1014;635;379
12;141301;141300;06-500;1533;1128;1119;586;533
13;141301;141300;06-500;1578;1042;1035;607;428
14;141301;141300;06-500;1700;1143;1137;701;436
15;141301;141300;06-500;100;25;25;16;9
1;141302;141300;06-520;422;304;303;246;57
2;141302;141300;06-520;285;191;189;152;37
3;141302;141300;06-520;525;356;356;266;90
4;141302;141300;06-520;530;339;336;285;51
5;141302;141300;06-520;423;280;278;240;38
1;141303;141300;06-545;765;537;533;381;152
2;141303;141300;06-545;614;393;388;288;100
3;141303;141300;06-545;759;463;460;377;83
4;141303;141300;06-500;828;550;540;350;190
5;141303;141300;06-545;312;238;238;191;47
6;141303;141300;06-645;343;198;198;142;56
1;141304;141300;06-540;339;215;212;174;38
2;141304;141300;06-540;159;119;119;85;34
3;141304;141300;06-540;1309;864;858;613;245
4;141304;141300;06-540;619;431;428;349;79
1;141305;141300;06-445;851;557;551;327;224
2;141305;141300;06-445;1289;882;877;607;270
3;141305;141300;06-445;429;288;287;245;42
4;141305;141300;06-445;578;401;398;320;78
5;141305;141300;06-445;1377;930;922;741;181
6;141305;141300;06-445;1107;763;759;643;116
1;141306;141300;06-561;1091;677;670;484;186
2;141306;141300;06-560;1365;873;869;634;235
3;141306;141300;06-561;512;315;315;244;71
4;141306;141300;06-561;384;274;269;204;65
5;141306;141300;06-561;191;143;141;122;19
6;141306;141300;06-561;58;50;50;18;32
7;141306;141300;06-560;65;32;31;8;23
1;141307;141300;06-550;1848;1201;1196;977;219
2;141307;141300;06-550;577;366;361;293;68
3;141307;141300;06-550;608;395;395;321;74
1;141308;141300;06-516;1198;817;810;580;230
2;141308;141300;06-516;1127;715;708;565;143
3;141308;141300;06-516;762;529;523;396;127
4;141308;141300;06-516;279;194;194;140;54
1;141309;141300;06-513;1028;691;688;505;183
2;141309;141300;06-513;495;308;307;280;27
3;141309;141300;06-513;673;435;431;354;77
4;141309;141300;06-513;485;339;332;254;78
5;141309;141300;06-513;277;175;175;136;39
1;141310;141300;06-521;414;296;296;184;112
2;141310;141300;06-521;675;427;425;315;110
3;141310;141300;06-521;568;415;413;323;90
4;141310;141300;06-521;434;282;278;199;79
5;141310;141300;06-521;342;238;236;167;69
6;141310;141300;06-521;325;221;218;142;76
7;141310;141300;06-521;367;260;258;198;60
8;141310;141300;06-521;252;171;171;141;30
9;141310;141300;06-521;225;162;160;128;32
10;141310;141300;06-521;340;234;233;173;60
1;141401;141400;05-101;1535;1216;1199;483;716
2;141401;141400;05-101;2682;2127;2097;831;1266
3;141401;141400;05-101;2669;2114;2094;881;1213
4;141401;141400;05-100;1298;943;934;418;516
5;141401;141400;05-100;1544;1188;1178;548;630
6;141401;141400;05-100;996;707;701;402;299
7;141401;141400;05-100;1010;761;753;353;400
8;141401;141400;05-100;2041;1478;1464;709;755
9;141401;141400;05-100;1889;1374;1367;720;647
10;141401;141400;05-160;1815;1275;1266;507;759
11;141401;141400;05-160;1658;1108;1102;442;660
12;141401;141400;05-102;2091;1514;1498;789;709
13;141401;141400;05-100;42;13;13;7;6
1;141402;141400;05-152;1204;975;958;475;483
2;141402;141400;05-152;1902;1514;1499;725;774
3;141402;141400;05-152;1533;1247;1232;591;641
4;141402;141400;05-152;1243;936;929;537;392
5;141402;141400;05-152;1800;1432;1424;716;708
6;141402;141400;05-152;673;513;507;236;271
1;141403;141400;05-155;381;258;254;190;64
2;141403;141400;05-155;1543;1172;1166;751;415
3;141403;141400;05-155;1490;1120;1108;645;463
4;141403;141400;05-155;1173;897;888;624;264
1;141404;141400;05-190;713;482;476;282;194
2;141404;141400;05-190;684;499;495;271;224
3;141404;141400;05-190;1074;793;790;437;353
4;141404;141400;05-190;940;685;680;390;290
5;141404;141400;05-190;1099;778;767;451;316
6;141404;141400;05-190;1010;752;746;472;274
7;141404;141400;05-191;1052;752;746;456;290
8;141404;141400;05-191;1192;817;810;524;286
9;141404;141400;05-190;1122;716;711;528;183
10;141404;141400;05-190;964;655;650;479;171
11;141404;141400;05-190;1254;948;936;657;279
12;141404;141400;05-190;706;492;487;367;120
13;141404;141400;05-191;814;578;571;354;217
14;141404;141400;05-191;1049;766;762;546;216
15;141404;141400;05-192;1297;922;912;598;314
16;141404;141400;05-190;67;23;21;12;9
1;141405;141400;05-180;998;793;784;434;350
2;141405;141400;05-180;972;799;790;351;439
3;141405;141400;05-180;751;594;588;283;305
4;141405;141400;05-180;653;453;449;267;182
5;141405;141400;05-180;495;384;383;217;166
6;141405;141400;05-180;494;377;375;250;125
7;141405;141400;05-180;624;498;493;307;186
8;141405;141400;05-180;505;395;390;209;181
9;141405;141400;05-180;687;544;540;253;287
10;141405;141400;05-180;471;336;335;217;118
11;141405;141400;05-180;768;552;552;289;263
1;141406;141400;05-170;1291;858;851;530;321
2;141406;141400;05-170;1222;849;844;448;396
3;141406;141400;05-180;713;481;477;339;138
4;141406;141400;05-170;848;514;512;349;163
5;141406;141400;05-170;715;444;440;280;160
1;141501;141500;06-320;1283;888;885;560;325
2;141501;141500;06-320;517;319;315;243;72
3;141501;141500;06-320;487;310;308;255;53
4;141501;141500;06-320;687;426;425;336;89
5;141501;141500;06-320;406;265;263;199;64
6;141501;141500;06-320;788;500;499;404;95
7;141501;141500;06-320;382;253;251;188;63
8;141501;141500;06-320;235;134;134;118;16
1;141502;141500;07-431;639;363;361;295;66
2;141502;141500;07-431;262;161;159;146;13
3;141502;141500;07-431;172;122;121;101;20
4;141502;141500;07-431;727;453;451;409;42
1;141503;141500;07-407;909;637;633;472;161
2;141503;141500;07-407;218;134;134;123;11
3;141503;141500;07-407;172;113;112;91;21
4;141503;141500;07-407;467;325;322;283;39
5;141503;141500;07-407;855;603;602;550;52
6;141503;141500;07-407;231;160;157;116;41
7;141503;141500;07-407;303;222;220;185;35
8;141503;141500;07-407;234;165;164;138;26
9;141503;141500;07-407;428;290;289;249;40
1;141504;141500;07-440;1509;1032;1028;737;291
2;141504;141500;07-440;316;198;196;166;30
3;141504;141500;07-440;825;522;521;441;80
4;141504;141500;07-440;491;349;346;238;108
5;141504;141500;07-440;423;308;304;265;39
6;141504;141500;07-440;719;503;500;413;87
7;141504;141500;07-440;381;236;232;195;37
8;141504;141500;07-440;340;237;236;207;29
9;141504;141500;07-440;453;283;280;232;48
10;141504;141500;07-440;382;224;224;164;60
11;141504;141500;07-440;406;277;274;223;51
1;141505;141500;07-420;472;333;331;249;82
2;141505;141500;07-420;458;288;287;192;95
3;141505;141500;07-420;611;420;418;307;111
4;141505;141500;07-420;482;295;294;216;78
5;141505;141500;07-420;700;517;512;375;137
6;141505;141500;07-420;497;355;347;248;99
7;141505;141500;07-420;232;167;167;148;19
8;141505;141500;07-420;662;431;428;365;63
9;141505;141500;07-420;514;350;346;291;55
10;141505;141500;07-420;510;344;341;296;45
11;141505;141500;07-420;497;332;329;280;49
12;141505;141500;07-420;259;179;179;158;21
13;141505;141500;07-420;560;349;346;295;51
14;141505;141500;07-420;514;301;300;258;42
15;141505;141500;07-420;292;182;180;152;28
16;141505;141500;07-420;320;218;215;184;31
17;141505;141500;07-420;214;172;172;141;31
18;141505;141500;07-420;204;130;130;114;16
19;141505;141500;07-420;150;94;93;77;16
20;141505;141500;07-420;229;122;120;103;17
1;141506;141500;07-402;1302;899;886;670;216
2;141506;141500;07-402;584;371;367;336;31
3;141506;141500;07-402;593;439;435;332;103
4;141506;141500;07-402;1310;942;934;781;153
5;141506;141500;07-402;701;456;453;388;65
6;141506;141500;07-402;547;385;384;314;70
7;141506;141500;07-402;701;504;501;403;98
8;141506;141500;07-402;1166;873;866;606;260
9;141506;141500;07-402;378;274;273;195;78
1;141507;141500;07-438;371;245;245;194;51
2;141507;141500;07-438;386;234;234;209;25
3;141507;141500;07-438;391;256;254;224;30
4;141507;141500;07-437;318;203;203;160;43
5;141507;141500;07-437;1807;1156;1146;851;295
6;141507;141500;07-436;984;583;577;443;134
7;141507;141500;07-436;344;230;230;193;37
8;141507;141500;07-436;300;179;177;152;25
9;141507;141500;07-438;364;236;236;216;20
10;141507;141500;07-437;295;199;197;169;28
11;141507;141500;07-437;306;193;192;157;35
12;141507;141500;07-438;308;201;200;178;22
1;141508;141500;07-430;1111;717;713;490;223
2;141508;141500;07-430;1262;869;864;641;223
3;141508;141500;07-430;749;504;501;406;95
4;141508;141500;07-430;435;284;280;263;17
5;141508;141500;07-430;371;237;237;208;29
6;141508;141500;07-430;710;490;486;410;76
7;141508;141500;07-430;615;394;393;335;58
8;141508;141500;07-430;751;450;447;383;64
9;141508;141500;07-430;363;227;224;205;19
10;141508;141500;07-430;151;117;117;109;8
11;141508;141500;07-430;139;97;97;86;11
12;141508;141500;07-430;282;159;159;148;11
13;141508;141500;07-430;320;199;197;179;18
14;141508;141500;07-430;375;254;254;203;51
1;141509;141500;07-415;1596;1236;1224;789;435
2;141509;141500;07-415;1315;955;948;656;292
3;141509;141500;07-416;1552;986;978;776;202
4;141509;141500;07-416;447;308;304;206;98
5;141509;141500;07-416;355;191;191;160;31
6;141509;141500;07-410;1845;1351;1343;979;364
7;141509;141500;07-415;561;427;420;343;77
8;141509;141500;07-415;523;372;370;277;93
1;141510;141500;07-411;1917;1490;1474;919;555
2;141510;141500;07-411;447;344;342;282;60
3;141510;141500;07-411;682;478;475;365;110
4;141510;141500;07-410;1106;862;858;531;327
5;141510;141500;07-411;315;239;237;187;50
6;141510;141500;07-401;952;652;648;450;198
7;141510;141500;07-411;419;354;353;214;139
8;141510;141500;07-410;407;326;321;180;141
9;141510;141500;07-411;228;172;171;131;40
10;141510;141500;07-411;767;553;550;366;184
11;141510;141500;07-411;235;168;167;107;60
12;141510;141500;07-411;208;155;152;132;20
13;141510;141500;07-411;206;149;146;113;33
14;141510;141500;07-411;254;195;194;166;28
15;141510;141500;07-411;422;300;299;228;71
16;141510;141500;07-411;1075;916;905;87;818
1;141511;141500;07-405;686;480;476;434;42
2;141511;141500;07-405;253;174;170;157;13
3;141511;141500;07-405;433;305;305;250;55
4;141511;141500;07-405;663;438;428;377;51
5;141511;141500;07-405;442;301;298;253;45
6;141511;141500;07-405;795;605;600;416;184
7;141511;141500;07-405;274;201;199;149;50
1;141601;141600;07-300;1692;1255;1244;778;466
2;141601;141600;07-300;1598;1121;1112;650;462
3;141601;141600;07-300;948;631;627;399;228
4;141601;141600;07-300;1493;1099;1089;650;439
5;141601;141600;07-300;1495;967;960;569;391
6;141601;141600;07-300;691;486;484;302;182
7;141601;141600;07-300;787;550;543;205;338
8;141601;141600;07-300;1390;936;928;553;375
9;141601;141600;07-300;1726;1135;1127;694;433
10;141601;141600;07-300;1382;974;965;533;432
11;141601;141600;07-300;1708;1267;1255;722;533
12;141601;141600;07-300;1333;910;901;517;384
13;141601;141600;07-300;112;91;90;63;27
1;141602;141600;07-305;904;664;660;566;94
2;141602;141600;07-305;823;585;582;492;90
3;141602;141600;07-305;476;316;312;276;36
4;141602;141600;07-305;406;296;296;252;44
5;141602;141600;07-305;490;379;376;325;51
1;141603;141600;07-325;835;648;642;526;116
2;141603;141600;07-325;328;240;239;215;24
3;141603;141600;07-325;206;157;154;141;13
4;141603;141600;07-325;273;200;199;175;24
5;141603;141600;07-325;228;173;172;147;25
1;141604;141600;07-306;866;614;607;374;233
2;141604;141600;07-306;392;272;270;202;68
3;141604;141600;07-306;749;564;560;305;255
4;141604;141600;07-306;237;166;164;125;39
1;141605;141600;07-320;977;707;699;523;176
2;141605;141600;07-320;782;529;526;351;175
3;141605;141600;07-320;698;469;463;307;156
4;141605;141600;07-320;814;579;575;378;197
5;141605;141600;07-320;592;478;476;309;167
6;141605;141600;07-319;515;357;354;311;43
7;141605;141600;07-319;598;452;450;356;94
8;141605;141600;07-319;460;315;312;279;33
9;141605;141600;07-320;416;294;290;229;61
10;141605;141600;07-320;666;498;490;342;148
11;141605;141600;07-320;600;424;419;341;78
12;141605;141600;07-320;586;410;405;326;79
13;141605;141600;07-320;402;270;267;203;64
14;141605;141600;07-320;209;165;165;132;33
15;141605;141600;07-320;273;220;219;196;23
1;141606;141600;07-322;764;553;552;412;140
2;141606;141600;07-322;219;162;162;135;27
3;141606;141600;07-322;404;305;305;247;58
4;141606;141600;07-322;309;243;241;200;41
5;141606;141600;07-322;392;278;278;225;53
1;141607;141600;07-308;338;230;226;192;34
2;141607;141600;07-308;436;291;286;254;32
3;141607;141600;07-300;412;297;294;224;70
4;141607;141600;07-300;678;482;480;365;115
5;141607;141600;07-310;771;554;544;366;178
6;141607;141600;07-310;255;173;173;125;48
7;141607;141600;07-302;582;362;355;300;55
8;141607;141600;07-300;694;485;484;366;118
9;141607;141600;07-304;253;201;200;175;25
10;141607;141600;07-304;707;464;459;368;91
11;141607;141600;07-304;475;312;310;237;73
12;141607;141600;07-304;334;234;233;180;53
13;141607;141600;07-300;748;550;550;427;123
14;141607;141600;07-300;254;190;189;162;27
15;141607;141600;07-310;582;447;445;218;227
16;141607;141600;07-300;245;176;176;130;46
17;141607;141600;07-310;271;216;216;172;44
18;141607;141600;07-300;260;210;208;173;35
19;141607;141600;07-300;232;164;163;133;30
20;141607;141600;07-308;264;169;166;125;41
21;141607;141600;07-302;173;115;115;94;21
22;141607;141600;07-300;181;135;135;106;29
23;141607;141600;07-300;327;232;229;158;71
24;141607;141600;07-300;237;170;170;140;30
25;141607;141600;07-310;43;13;13;7;6
1;141608;141600;07-303;997;666;661;551;110
2;141608;141600;07-303;300;204;201;180;21
3;141608;141600;07-303;441;309;309;259;50
4;141608;141600;07-303;457;365;365;324;41
5;141608;141600;07-303;170;123;123;107;16
6;141608;141600;07-303;177;124;124;117;7
7;141608;141600;07-303;219;183;179;165;14
1;141609;141600;07-324;644;462;457;360;97
2;141609;141600;07-324;570;402;401;345;56
1;141610;141600;07-311;424;287;285;188;97
2;141610;141600;07-311;463;345;345;273;72
3;141610;141600;07-311;216;139;137;101;36
4;141610;141600;07-311;415;285;283;224;59
5;141610;141600;07-311;602;400;396;299;97
6;141610;141600;07-311;268;172;171;154;17
7;141610;141600;07-311;408;273;271;207;64
8;141610;141600;07-311;395;306;302;259;43
1;141611;141600;07-323;854;595;592;530;62
2;141611;141600;07-323;494;335;332;288;44
3;141611;141600;07-323;937;673;664;509;155
4;141611;141600;07-323;253;163;161;152;9
5;141611;141600;07-323;201;153;152;126;26
1;141701;141700;05-410;2220;1852;1833;703;1130
2;141701;141700;05-420;1144;969;959;404;555
3;141701;141700;05-420;1813;1537;1520;673;847
4;141701;141700;05-420;1937;1560;1539;732;807
5;141701;141700;05-420;913;785;770;295;475
6;141701;141700;05-420;1423;1212;1205;496;709
7;141701;141700;05-410;825;704;696;278;418
8;141701;141700;05-410;1673;1364;1350;580;770
9;141701;141700;05-410;1065;863;852;380;472
10;141701;141700;05-420;1383;1152;1137;445;692
11;141701;141700;05-410;1450;1214;1200;487;713
1;141702;141700;05-400;1525;1209;1194;472;722
2;141702;141700;05-400;655;518;512;217;295
3;141702;141700;05-400;1245;925;914;416;498
4;141702;141700;05-400;1294;1035;1022;442;580
5;141702;141700;05-400;888;685;677;297;380
6;141702;141700;05-400;594;466;459;218;241
7;141702;141700;05-400;1595;1262;1249;637;612
8;141702;141700;05-400;1156;937;930;393;537
9;141702;141700;05-400;2106;1640;1625;692;933
10;141702;141700;05-400;1071;807;797;371;426
11;141702;141700;05-400;2090;1663;1640;882;758
12;141702;141700;05-400;2278;1878;1855;849;1006
13;141702;141700;05-402;1282;891;879;462;417
14;141702;141700;05-402;1014;804;795;415;380
15;141702;141700;05-402;1436;1147;1137;544;593
16;141702;141700;05-402;1400;1054;1045;460;585
17;141702;141700;05-400;1381;1058;1042;541;501
18;141702;141700;05-400;1442;1223;1195;480;715
19;141702;141700;05-400;1192;897;886;462;424
20;141702;141700;05-400;564;431;427;237;190
21;141702;141700;05-400;940;744;741;356;385
22;141702;141700;05-400;897;656;648;306;342
23;141702;141700;05-400;1094;836;826;472;354
24;141702;141700;05-400;1471;1245;1237;772;465
25;141702;141700;05-400;1241;996;982;559;423
26;141702;141700;05-480;1088;908;895;392;503
27;141702;141700;05-400;54;35;35;13;22
28;141702;141700;05-400;198;174;170;84;86
29;141702;141700;05-400;98;97;95;55;40
30;141702;141700;05-400;218;133;133;75;58
31;141702;141700;05-400;61;28;27;10;17
1;141703;141700;05-430;619;476;470;244;226
2;141703;141700;05-430;329;266;263;161;102
3;141703;141700;05-430;485;363;357;266;91
4;141703;141700;05-430;1855;1479;1456;801;655
5;141703;141700;05-430;2003;1605;1580;922;658
6;141703;141700;05-430;461;373;369;240;129
7;141703;141700;05-430;497;390;384;315;69
8;141703;141700;05-430;585;491;486;362;124
9;141703;141700;05-430;800;642;634;364;270
10;141703;141700;05-430;853;681;672;441;231
11;141703;141700;05-430;218;173;169;116;53
12;141703;141700;05-430;272;193;190;125;65
1;141704;141700;05-480;2084;1601;1590;920;670
2;141704;141700;05-480;1479;1194;1174;664;510
3;141704;141700;05-480;1363;1079;1072;615;457
4;141704;141700;05-480;1378;1064;1059;448;611
5;141704;141700;05-480;923;776;774;349;425
6;141704;141700;05-480;846;663;657;517;140
7;141704;141700;05-480;840;640;633;407;226
8;141704;141700;05-480;828;643;639;380;259
9;141704;141700;05-480;451;348;345;189;156
10;141704;141700;05-480;535;403;395;296;99
11;141704;141700;05-480;705;582;578;324;254
12;141704;141700;05-480;311;238;236;176;60
13;141704;141700;05-480;390;295;293;198;95
14;141704;141700;05-480;24;22;21;16;5
1;141705;141700;05-340;1426;1136;1123;743;380
2;141705;141700;05-340;1010;771;763;588;175
3;141705;141700;05-340;556;413;406;250;156
4;141705;141700;05-340;979;758;751;533;218
5;141705;141700;05-340;781;599;591;462;129
6;141705;141700;05-340;953;754;748;527;221
7;141705;141700;05-340;734;582;577;402;175
1;141706;141700;08-445;369;298;294;243;51
2;141706;141700;08-445;375;285;283;234;49
3;141706;141700;08-445;740;590;584;486;98
4;141706;141700;08-445;884;699;686;462;224
5;141706;141700;08-445;308;260;258;223;35
6;141706;141700;08-455;211;168;167;110;57
1;141707;141700;08-443;1094;845;833;516;317
2;141707;141700;08-443;677;517;510;324;186
3;141707;141700;08-443;578;413;409;268;141
4;141707;141700;08-443;652;498;493;352;141
5;141707;141700;08-443;856;674;663;495;168
6;141707;141700;08-443;667;541;534;388;146
7;141707;141700;08-443;356;286;285;193;92
1;141708;141700;05-077;473;370;370;200;170
2;141708;141700;05-077;561;470;468;193;275
3;141708;141700;05-462;475;417;412;156;256
4;141708;141700;05-462;731;606;603;302;301
5;141708;141700;05-462;302;274;271;97;174
6;141708;141700;05-462;566;497;494;204;290
7;141708;141700;05-462;208;179;177;128;49
8;141708;141700;05-462;702;599;593;285;308
9;141708;141700;05-462;270;214;212;106;106
10;141708;141700;05-462;448;351;348;191;157
11;141708;141700;05-462;578;501;496;233;263
12;141708;141700;05-462;356;304;299;116;183
13;141708;141700;05-462;544;472;466;225;241
14;141708;141700;05-462;743;644;643;283;360
15;141708;141700;05-462;488;383;378;176;202
16;141708;141700;05-462;769;653;647;349;298
17;141708;141700;05-462;516;435;430;210;220
18;141708;141700;05-408;328;273;271;128;143
19;141708;141700;05-462;190;168;168;72;96
20;141708;141700;05-408;309;250;248;162;86
21;141708;141700;05-408;373;311;303;200;103
22;141708;141700;05-408;430;333;329;266;63
23;141708;141700;05-408;391;318;316;185;131
24;141708;141700;05-408;619;491;487;325;162
25;141708;141700;05-408;297;224;221;137;84
26;141708;141700;05-462;116;50;48;16;32
1;141801;141800;05-530;887;705;696;334;362
2;141801;141800;05-530;1238;906;900;569;331
3;141801;141800;05-530;808;603;597;397;200
4;141801;141800;05-530;1043;830;824;464;360
5;141801;141800;05-530;654;494;491;308;183
6;141801;141800;05-530;412;317;316;143;173
7;141801;141800;05-530;983;792;785;420;365
8;141801;141800;05-532;1466;1115;1103;586;517
9;141801;141800;05-532;1470;1130;1111;542;569
10;141801;141800;05-532;1651;1332;1321;617;704
11;141801;141800;05-520;992;757;752;454;298
12;141801;141800;05-530;1333;1072;1059;562;497
13;141801;141800;05-530;1413;1063;1056;533;523
14;141801;141800;05-530;914;685;683;334;349
15;141801;141800;05-530;1362;998;990;520;470
16;141801;141800;05-530;1914;1458;1443;719;724
17;141801;141800;05-530;1226;919;904;480;424
18;141801;141800;05-530;1196;923;909;471;438
19;141801;141800;05-530;328;101;100;82;18
1;141802;141800;05-510;1166;938;928;379;549
2;141802;141800;05-510;1325;1149;1140;399;741
3;141802;141800;05-510;602;506;505;227;278
4;141802;141800;05-510;968;799;788;215;573
5;141802;141800;05-510;1441;1154;1144;464;680
6;141802;141800;05-520;847;704;698;252;446
7;141802;141800;05-520;1551;1177;1166;557;609
8;141802;141800;05-510;1764;1433;1412;500;912
9;141802;141800;05-520;1679;1362;1351;493;858
10;141802;141800;05-520;1160;898;890;394;496
11;141802;141800;05-520;1620;1344;1338;574;764
12;141802;141800;05-520;951;761;756;444;312
13;141802;141800;05-520;685;573;563;235;328
14;141802;141800;05-520;1252;1020;1014;495;519
15;141802;141800;05-520;468;375;373;207;166
16;141802;141800;05-520;333;277;274;121;153
17;141802;141800;05-520;1000;834;828;282;546
18;141802;141800;05-510;36;25;24;14;10
19;141802;141800;05-510;43;41;41;12;29
20;141802;141800;05-510;51;38;36;7;29
21;141802;141800;05-510;105;101;98;53;45
22;141802;141800;05-510;218;198;198;83;115
23;141802;141800;05-520;23;19;18;6;12
24;141802;141800;05-510;121;121;121;76;45
25;141802;141800;05-520;52;26;26;10;16
26;141802;141800;05-510;33;26;26;7;19
27;141802;141800;05-510;18;18;17;3;14
28;141802;141800;05-510;25;24;22;4;18
1;141803;141800;05-500;1498;1198;1186;631;555
2;141803;141800;05-500;1382;1237;1233;315;918
3;141803;141800;05-500;1686;1479;1460;405;1055
4;141803;141800;05-500;1662;1461;1443;409;1034
5;141803;141800;05-500;1514;1361;1347;526;821
6;141803;141800;05-500;2070;1861;1841;580;1261
7;141803;141800;05-500;2726;2311;2293;776;1517
8;141803;141800;05-506;361;302;299;159;140
9;141803;141800;05-506;1168;961;951;411;540
10;141803;141800;05-506;2208;1966;1942;739;1203
11;141803;141800;05-552;1170;1061;1050;342;708
12;141803;141800;05-506;1245;1102;1092;327;765
13;141803;141800;05-552;2782;2246;2216;917;1299
14;141803;141800;05-552;581;454;450;239;211
15;141803;141800;05-552;769;614;604;255;349
16;141803;141800;05-552;2292;1884;1865;891;974
17;141803;141800;05-506;1047;866;855;243;612
1;141804;141800;05-500;1016;816;810;279;531
2;141804;141800;05-500;958;748;744;282;462
3;141804;141800;05-500;1521;1293;1281;410;871
4;141804;141800;05-500;1645;1333;1324;510;814
5;141804;141800;05-500;1365;1106;1099;406;693
6;141804;141800;05-500;1708;1285;1276;590;686
7;141804;141800;05-500;1005;847;843;340;503
8;141804;141800;05-500;1122;906;895;378;517
9;141804;141800;05-500;1711;1456;1449;474;975
10;141804;141800;05-500;1305;1128;1119;409;710
11;141804;141800;05-500;1522;1145;1133;509;624
12;141804;141800;05-500;1657;1456;1445;458;987
13;141804;141800;05-500;981;827;820;237;583
14;141804;141800;05-500;1918;1550;1533;504;1029
15;141804;141800;05-500;1270;1063;1047;365;682
16;141804;141800;05-500;1085;877;869;332;537
17;141804;141800;05-500;1925;1621;1606;606;1000
18;141804;141800;05-500;1803;1435;1418;554;864
19;141804;141800;05-500;1174;1030;1019;398;621
20;141804;141800;05-501;1180;1010;1002;400;602
21;141804;141800;05-501;1176;1040;1032;382;650
22;141804;141800;05-501;1183;966;959;351;608
23;141804;141800;05-502;1151;923;913;342;571
24;141804;141800;05-502;1006;842;832;301;531
25;141804;141800;05-500;1982;1702;1691;360;1331
26;141804;141800;05-500;2178;1934;1923;357;1566
27;141804;141800;05-500;2165;1958;1944;423;1521
28;141804;141800;05-500;1537;1338;1328;293;1035
29;141804;141800;05-500;1569;1247;1236;326;910
30;141804;141800;05-510;1784;1517;1497;511;986
31;141804;141800;05-500;1762;1409;1402;560;842
32;141804;141800;05-532;667;549;541;236;305
33;141804;141800;05-540;1314;1078;1071;426;645
34;141804;141800;05-540;1460;1224;1213;429;784
35;141804;141800;05-502;1515;1334;1313;555;758
36;141804;141800;05-502;883;740;730;354;376
37;141804;141800;05-502;1397;1230;1217;382;835
38;141804;141800;05-502;1490;1221;1210;548;662
39;141804;141800;05-503;1648;1407;1397;569;828
40;141804;141800;05-503;1130;937;934;452;482
41;141804;141800;05-504;417;316;314;173;141
42;141804;141800;05-503;934;772;765;331;434
43;141804;141800;05-504;2073;1716;1697;575;1122
44;141804;141800;05-502;730;594;592;336;256
45;141804;141800;05-500;884;749;741;269;472
46;141804;141800;05-500;1382;1206;1191;425;766
47;141804;141800;05-500;1735;1470;1462;418;1044
48;141804;141800;05-503;740;621;620;256;364
49;141804;141800;05-500;86;52;52;20;32
50;141804;141800;05-500;117;60;60;21;39
1;141805;141800;05-540;1570;1230;1221;598;623
2;141805;141800;05-505;1244;961;952;520;432
3;141805;141800;05-505;879;690;684;431;253
4;141805;141800;05-540;1478;1209;1200;409;791
5;141805;141800;05-505;647;537;529;248;281
6;141805;141800;05-505;464;365;364;185;179
7;141805;141800;05-504;887;786;777;261;516
8;141805;141800;05-540;1153;882;872;493;379
9;141805;141800;05-540;1028;842;830;387;443
10;141805;141800;05-540;641;494;488;241;247
1;141806;141800;05-555;610;445;441;300;141
2;141806;141800;05-555;617;488;485;274;211
3;141806;141800;05-555;915;725;716;407;309
4;141806;141800;05-555;759;589;584;379;205
5;141806;141800;05-555;869;652;647;392;255
6;141806;141800;05-555;1749;1359;1352;746;606
7;141806;141800;05-555;1518;1205;1193;653;540
8;141806;141800;05-555;1731;1316;1305;855;450
9;141806;141800;05-555;801;665;660;326;334
1;141901;141900;09-230;1327;886;877;674;203
2;141901;141900;09-230;2103;1500;1481;921;560
3;141901;141900;09-230;949;615;610;492;118
4;141901;141900;09-230;351;232;231;188;43
5;141901;141900;09-230;750;479;471;393;78
6;141901;141900;09-230;1323;881;873;635;238
7;141901;141900;09-230;23;20;16;10;6
1;141902;141900;09-470;891;616;612;440;172
2;141902;141900;09-470;538;332;327;250;77
3;141902;141900;09-470;773;531;529;389;140
4;141902;141900;09-470;519;355;354;216;138
5;141902;141900;09-470;619;437;436;252;184
6;141902;141900;09-470;432;285;283;206;77
7;141902;141900;09-470;264;178;178;120;58
8;141902;141900;09-470;248;158;155;98;57
9;141902;141900;09-470;480;299;298;255;43
10;141902;141900;09-470;225;120;118;83;35
11;141902;141900;09-470;382;283;283;171;112
12;141902;141900;09-470;193;126;126;95;31
13;141902;141900;09-470;265;192;190;137;53
14;141902;141900;09-470;174;109;108;77;31
15;141902;141900;09-470;100;83;75;43;32
1;141903;141900;09-414;459;275;273;233;40
2;141903;141900;09-414;458;308;306;230;76
3;141903;141900;09-414;864;589;584;390;194
4;141903;141900;09-411;427;270;269;200;69
5;141903;141900;09-411;769;493;489;338;151
6;141903;141900;09-411;612;407;402;315;87
7;141903;141900;09-411;843;586;583;447;136
8;141903;141900;09-414;524;343;339;265;74
9;141903;141900;09-414;389;238;235;193;42
10;141903;141900;09-414;284;196;194;122;72
11;141903;141900;09-411;380;228;228;148;80
12;141903;141900;09-414;256;152;151;127;24
13;141903;141900;09-411;90;34;31;16;15
1;141904;141900;09-454;445;294;292;216;76
2;141904;141900;09-454;727;490;486;385;101
3;141904;141900;09-454;613;426;424;356;68
4;141904;141900;09-454;631;411;404;335;69
5;141904;141900;09-454;966;653;649;527;122
6;141904;141900;09-454;529;343;341;273;68
7;141904;141900;09-454;257;192;192;144;48
1;141905;141900;09-210;913;558;552;391;161
2;141905;141900;09-210;1167;679;675;541;134
3;141905;141900;09-210;320;192;191;150;41
4;141905;141900;09-210;649;402;399;349;50
5;141905;141900;09-210;1037;650;642;402;240
6;141905;141900;09-210;1580;951;943;710;233
1;141906;141900;09-530;1296;892;889;571;318
2;141906;141900;09-530;818;577;574;351;223
3;141906;141900;09-530;1095;750;746;428;318
4;141906;141900;09-530;815;562;557;394;163
5;141906;141900;09-530;876;644;639;401;238
6;141906;141900;09-530;462;311;309;271;38
7;141906;141900;09-530;939;670;668;449;219
8;141906;141900;09-530;978;656;650;530;120
9;141906;141900;09-530;356;219;219;177;42
10;141906;141900;09-530;354;250;247;196;51
11;141906;141900;09-530;379;224;223;159;64
12;141906;141900;09-530;158;111;111;80;31
13;141906;141900;09-530;100;58;52;26;26
1;141907;141900;09-520;1081;765;752;448;304
2;141907;141900;09-520;620;460;455;274;181
3;141907;141900;09-520;663;444;440;313;127
4;141907;141900;09-520;838;629;623;382;241
5;141907;141900;09-520;397;269;265;205;60
6;141907;141900;09-520;505;383;381;162;219
7;141907;141900;09-520;300;214;212;146;66
1;141908;141900;09-460;1033;665;657;480;177
2;141908;141900;09-460;898;554;551;442;109
3;141908;141900;09-460;991;724;714;465;249
4;141908;141900;09-460;862;514;514;421;93
5;141908;141900;09-460;615;381;379;308;71
6;141908;141900;09-460;65;26;25;14;11
1;141909;141900;09-505;867;629;627;450;177
2;141909;141900;09-505;721;507;501;372;129
3;141909;141900;09-505;262;182;181;138;43
4;141909;141900;09-506;498;327;326;182;144
5;141909;141900;09-506;721;503;503;337;166
1;141910;141900;09-451;1012;762;756;451;305
2;141910;141900;09-451;1028;709;701;500;201
3;141910;141900;09-451;449;318;315;238;77
4;141910;141900;09-451;838;558;553;423;130
5;141910;141900;09-442;1580;1114;1103;573;530
6;141910;141900;09-442;1520;1107;1095;638;457
7;141910;141900;09-451;177;105;105;72;33
1;141911;141900;09-533;436;254;250;207;43
2;141911;141900;09-533;474;322;320;263;57
3;141911;141900;09-533;648;438;435;365;70
4;141911;141900;09-533;432;280;278;217;61
5;141911;141900;09-533;721;505;500;385;115
6;141911;141900;09-533;671;495;493;334;159
1;141912;141900;09-408;202;148;147;71;76
2;141912;141900;09-408;339;269;268;120;148
3;141912;141900;09-472;422;228;224;130;94
4;141912;141900;09-472;188;135;135;96;39
5;141912;141900;09-410;528;459;454;121;333
6;141912;141900;09-410;573;498;490;158;332
7;141912;141900;09-472;833;713;705;299;406
8;141912;141900;09-472;1061;861;849;396;453
9;141912;141900;09-472;774;612;607;301;306
10;141912;141900;09-472;473;335;334;229;105
11;141912;141900;09-408;167;135;135;73;62
12;141912;141900;09-408;510;390;386;188;198
13;141912;141900;09-472;297;198;195;151;44
14;141912;141900;09-472;166;113;113;77;36
1;141913;141900;09-400;2281;1640;1624;942;682
2;141913;141900;09-412;816;461;456;335;121
3;141913;141900;09-411;570;390;384;279;105
4;141913;141900;09-411;817;544;537;362;175
5;141913;141900;09-411;1166;855;848;497;351
6;141913;141900;09-400;666;554;542;239;303
7;141913;141900;09-412;1208;862;857;560;297
8;141913;141900;09-411;579;427;426;265;161
9;141913;141900;09-411;212;161;161;135;26
10;141913;141900;09-411;179;133;133;94;39
11;141913;141900;09-400;516;408;401;186;215
12;141913;141900;09-400;62;53;53;14;39
1;141914;141900;09-440;350;242;238;163;75
2;141914;141900;09-440;615;356;351;278;73
3;141914;141900;09-440;627;347;346;279;67
4;141914;141900;09-440;1644;1150;1140;763;377
5;141914;141900;09-440;1188;719;716;593;123
6;141914;141900;09-440;448;301;298;238;60
7;141914;141900;09-440;299;185;183;156;27
8;141914;141900;09-440;145;87;87;75;12
9;141914;141900;09-440;33;15;14;5;9
1;141915;141900;09-450;637;414;413;228;185
2;141915;141900;09-450;620;377;372;211;161
3;141915;141900;09-450;649;474;466;279;187
4;141915;141900;09-450;416;297;297;219;78
5;141915;141900;09-450;651;419;415;324;91
6;141915;141900;09-450;601;373;370;314;56
7;141915;141900;09-450;174;135;131;104;27
8;141915;141900;09-450;184;110;110;89;21
9;141915;141900;09-450;269;180;179;162;17
10;141915;141900;09-450;33;29;28;15;13
1;142001;142000;09-100;741;554;552;259;293
2;142001;142000;09-100;929;715;712;364;348
3;142001;142000;09-100;595;420;414;233;181
4;142001;142000;09-100;626;464;462;234;228
5;142001;142000;09-100;900;632;625;356;269
6;142001;142000;09-100;712;468;464;235;229
7;142001;142000;09-100;867;652;650;303;347
8;142001;142000;09-100;783;562;558;220;338
9;142001;142000;09-100;1206;883;876;427;449
10;142001;142000;09-100;785;535;529;279;250
11;142001;142000;09-100;900;624;617;300;317
12;142001;142000;09-100;794;512;507;297;210
13;142001;142000;09-100;853;581;577;294;283
14;142001;142000;09-100;901;564;562;308;254
15;142001;142000;09-100;1175;863;858;482;376
16;142001;142000;09-100;1200;906;891;415;476
17;142001;142000;09-100;899;674;671;343;328
18;142001;142000;09-100;992;771;762;375;387
19;142001;142000;09-100;127;66;65;48;17
20;142001;142000;09-100;52;18;16;11;5
1;142002;142000;09-140;1047;725;715;444;271
2;142002;142000;09-140;1156;771;760;519;241
3;142002;142000;09-140;972;628;626;391;235
1;142003;142000;09-130;1366;913;902;660;242
2;142003;142000;09-130;1541;1057;1051;644;407
3;142003;142000;09-130;612;400;393;310;83
4;142003;142000;09-130;792;492;489;381;108
5;142003;142000;09-130;911;655;649;464;185
6;142003;142000;09-130;716;435;430;350;80
1;142004;142000;09-150;1811;1228;1220;874;346
2;142004;142000;09-151;767;455;452;367;85
3;142004;142000;09-151;1338;741;735;583;152
4;142004;142000;09-150;1248;732;730;564;166
5;142004;142000;09-150;626;346;345;274;71
1;142005;142000;09-164;1022;707;703;507;196
2;142005;142000;09-164;713;486;483;382;101
3;142005;142000;09-164;1020;696;692;565;127
1;142006;142000;09-131;1045;805;800;454;346
2;142006;142000;09-131;731;597;597;321;276
3;142006;142000;09-131;842;574;572;399;173
4;142006;142000;09-131;70;24;24;18;6
1;142007;142000;09-152;988;607;602;427;175
2;142007;142000;09-152;399;258;254;178;76
3;142007;142000;09-162;499;310;309;268;41
4;142007;142000;09-162;1356;876;871;681;190
5;142007;142000;09-152;883;551;548;436;112
6;142007;142000;09-152;286;173;172;127;45
7;142007;142000;09-152;320;208;205;171;34
1;142008;142000;09-120;492;353;349;262;87
2;142008;142000;09-120;1087;774;765;533;232
3;142008;142000;09-120;781;574;570;380;190
4;142008;142000;09-120;1324;1015;1003;577;426
5;142008;142000;09-120;182;138;137;93;44
6;142008;142000;09-120;43;20;18;11;7
1;142009;142000;09-100;1012;703;691;410;281
2;142009;142000;09-100;452;308;307;234;73
3;142009;142000;09-100;553;357;352;254;98
4;142009;142000;09-100;535;356;354;275;79
5;142009;142000;09-100;399;277;274;197;77
6;142009;142000;09-100;1496;972;965;613;352
7;142009;142000;09-100;808;554;552;382;170
8;142009;142000;09-100;571;396;390;246;144
9;142009;142000;09-100;592;415;412;258;154
1;142010;142000;09-166;1552;966;960;769;191
2;142010;142000;09-140;1204;784;777;653;124
3;142010;142000;09-140;783;509;504;410;94
4;142010;142000;09-140;1647;1020;1012;794;218
5;142010;142000;09-140;743;511;507;424;83
6;142010;142000;09-140;435;143;141;97;44
1;142011;142000;09-110;1495;1013;1004;619;385
2;142011;142000;09-110;869;615;608;424;184
3;142011;142000;09-110;797;524;522;385;137
4;142011;142000;09-110;1038;737;731;507;224
5;142011;142000;09-110;330;227;227;165;62
1;142012;142000;09-142;682;426;425;273;152
2;142012;142000;09-142;696;439;435;332;103
3;142012;142000;09-142;821;514;509;344;165
4;142012;142000;09-142;832;573;568;384;184
5;142012;142000;09-142;949;575;570;439;131
6;142012;142000;09-142;292;197;195;154;41
7;142012;142000;09-142;65;16;15;10;5
1;142101;142100;05-820;2358;1947;1932;854;1078
2;142101;142100;05-820;1723;1387;1373;595;778
3;142101;142100;05-820;1666;1280;1270;625;645
4;142101;142100;05-820;1390;1121;1115;558;557
5;142101;142100;05-820;1507;1195;1178;518;660
6;142101;142100;05-820;1467;1206;1200;511;689
7;142101;142100;05-820;1097;927;912;396;516
8;142101;142100;05-820;1844;1498;1479;639;840
9;142101;142100;05-820;1917;1551;1528;714;814
10;142101;142100;05-820;1943;1642;1619;672;947
1;142102;142100;05-800;2471;1745;1729;771;958
2;142102;142100;05-800;2429;1915;1895;740;1155
3;142102;142100;05-800;1876;1590;1566;598;968
4;142102;142100;05-800;2519;2035;2023;922;1101
5;142102;142100;05-800;1268;1042;1035;462;573
6;142102;142100;05-800;1614;1377;1363;593;770
7;142102;142100;05-800;1322;1059;1045;480;565
8;142102;142100;05-800;1482;1199;1189;480;709
9;142102;142100;05-800;1939;1541;1528;661;867
10;142102;142100;05-800;1383;1088;1080;479;601
11;142102;142100;05-800;1625;1305;1295;495;800
12;142102;142100;05-800;2649;2185;2151;766;1385
13;142102;142100;05-800;1434;1055;1044;450;594
14;142102;142100;05-800;1758;1416;1399;524;875
15;142102;142100;05-800;1213;917;909;373;536
16;142102;142100;05-800;2023;1572;1554;524;1030
17;142102;142100;05-800;1587;1283;1268;490;778
18;142102;142100;05-800;1680;1291;1274;549;725
19;142102;142100;05-800;1823;1399;1388;584;804
20;142102;142100;05-800;1970;1565;1553;667;886
21;142102;142100;05-800;1356;1173;1168;447;721
22;142102;142100;05-800;1045;834;828;307;521
23;142102;142100;05-800;1895;1633;1613;573;1040
24;142102;142100;05-800;2555;2165;2149;782;1367
25;142102;142100;05-800;1627;1351;1335;449;886
26;142102;142100;05-800;2173;1869;1849;736;1113
27;142102;142100;05-800;224;224;222;114;108
28;142102;142100;05-800;105;42;42;23;19
29;142102;142100;05-800;38;32;32;15;17
30;142102;142100;05-800;45;26;26;5;21
1;142103;142100;05-840;1603;1295;1274;548;726
2;142103;142100;05-840;976;790;787;366;421
3;142103;142100;05-840;852;698;695;303;392
4;142103;142100;05-840;1558;1309;1300;587;713
5;142103;142100;05-840;1521;1231;1224;469;755
6;142103;142100;05-840;1381;1195;1185;494;691
7;142103;142100;05-840;1746;1451;1432;551;881
8;142103;142100;05-840;1127;964;949;338;611
9;142103;142100;05-840;686;426;422;267;155
10;142103;142100;05-840;800;593;588;311;277
11;142103;142100;05-804;1526;1290;1273;476;797
12;142103;142100;05-805;1996;1715;1697;635;1062
13;142103;142100;05-805;960;820;809;308;501
14;142103;142100;05-805;1271;1099;1085;370;715
15;142103;142100;05-807;1316;1101;1092;401;691
16;142103;142100;05-807;1720;1442;1431;487;944
1;142104;142100;05-816;1335;1162;1148;409;739
2;142104;142100;05-816;1633;1404;1388;501;887
3;142104;142100;05-816;1672;1435;1424;483;941
4;142104;142100;05-816;1612;1360;1344;461;883
5;142104;142100;05-806;832;723;715;246;469
6;142104;142100;05-806;285;246;244;175;69
7;142104;142100;05-806;793;676;670;231;439
8;142104;142100;05-806;988;859;853;231;622
9;142104;142100;05-806;921;794;781;246;535
10;142104;142100;05-806;843;734;729;255;474
11;142104;142100;05-806;1712;1493;1475;529;946
12;142104;142100;05-806;1916;1702;1682;645;1037
1;142105;142100;05-830;1754;1394;1371;597;774
2;142105;142100;05-830;1598;1381;1367;496;871
3;142105;142100;05-830;2122;1732;1717;644;1073
4;142105;142100;05-830;1494;1220;1207;480;727
5;142105;142100;05-831;818;653;646;276;370
6;142105;142100;05-830;947;800;789;385;404
7;142105;142100;05-831;731;619;615;259;356
8;142105;142100;05-830;948;814;807;252;555
9;142105;142100;05-831;560;496;491;244;247
10;142105;142100;05-831;581;460;454;260;194
11;142105;142100;05-830;1794;1536;1514;504;1010
1;142106;142100;05-090;1661;1433;1419;631;788
2;142106;142100;05-090;841;697;691;314;377
3;142106;142100;05-090;2164;1847;1826;662;1164
4;142106;142100;05-090;1222;1080;1070;391;679
5;142106;142100;05-090;1412;1111;1101;526;575
6;142106;142100;05-090;1807;1464;1451;730;721
7;142106;142100;05-090;1037;788;780;446;334
8;142106;142100;05-090;954;761;747;334;413
9;142106;142100;05-090;1311;1048;1042;461;581
10;142106;142100;05-090;1215;937;929;506;423
11;142106;142100;05-090;1074;862;856;450;406
12;142106;142100;05-090;1482;1201;1191;630;561
13;142106;142100;05-090;761;623;616;245;371
14;142106;142100;05-090;317;253;246;123;123
15;142106;142100;05-090;1214;1021;1013;516;497
1;142201;142200;06-300;1098;822;816;506;310
2;142201;142200;06-300;936;669;663;366;297
3;142201;142200;06-300;622;426;419;267;152
4;142201;142200;06-300;1012;710;702;355;347
5;142201;142200;06-300;1401;938;929;537;392
6;142201;142200;06-300;1082;802;792;468;324
7;142201;142200;06-300;882;649;643;335;308
8;142201;142200;06-300;1088;870;860;431;429
9;142201;142200;06-300;700;501;496;277;219
10;142201;142200;06-300;611;419;415;270;145
11;142201;142200;06-300;1216;813;810;474;336
12;142201;142200;06-300;1345;991;981;569;412
13;142201;142200;06-300;92;64;53;43;10
14;142201;142200;06-300;100;60;56;36;20
15;142201;142200;06-300;80;48;48;43;5
1;142202;142200;06-330;1097;767;762;490;272
2;142202;142200;06-330;1068;725;719;506;213
3;142202;142200;06-330;430;285;283;240;43
4;142202;142200;06-330;433;257;255;205;50
5;142202;142200;06-330;430;284;282;226;56
6;142202;142200;06-330;359;236;234;187;47
7;142202;142200;06-330;387;212;212;165;47
8;142202;142200;06-330;418;283;283;225;58
9;142202;142200;06-333;629;382;375;298;77
10;142202;142200;06-333;647;414;413;335;78
11;142202;142200;06-330;517;309;304;254;50
12;142202;142200;06-333;411;238;236;207;29
13;142202;142200;06-333;442;272;271;242;29
1;142203;142200;06-415;773;524;522;403;119
2;142203;142200;06-415;424;290;287;274;13
3;142203;142200;06-415;592;428;427;357;70
4;142203;142200;06-415;602;441;438;351;87
5;142203;142200;06-415;216;153;152;129;23
6;142203;142200;06-415;185;131;131;82;49
1;142204;142200;06-323;1448;877;863;592;271
2;142204;142200;06-323;768;483;475;366;109
3;142204;142200;06-323;289;196;193;167;26
4;142204;142200;06-323;191;137;137;122;15
5;142204;142200;06-323;471;290;290;231;59
6;142204;142200;06-323;549;340;339;272;67
7;142204;142200;06-323;372;201;198;163;35
8;142204;142200;06-323;406;269;265;238;27
9;142204;142200;06-323;235;162;162;127;35
10;142204;142200;06-323;146;100;100;68;32
11;142204;142200;06-323;355;225;224;179;45
1;142205;142200;06-408;1451;960;955;740;215
2;142205;142200;06-408;433;292;291;244;47
3;142205;142200;06-408;713;505;501;428;73
1;142206;142200;06-316;1170;851;844;728;116
2;142206;142200;06-316;160;106;105;90;15
3;142206;142200;06-316;360;255;255;220;35
4;142206;142200;06-316;148;89;88;72;16
5;142206;142200;06-316;183;139;134;130;4
6;142206;142200;06-300;347;253;252;223;29
7;142206;142200;06-316;191;140;139;122;17
1;142207;142200;06-300;366;248;247;190;57
2;142207;142200;06-300;746;529;523;418;105
3;142207;142200;06-300;1059;693;692;563;129
4;142207;142200;06-300;366;226;225;156;69
5;142207;142200;06-300;606;393;391;284;107
6;142207;142200;06-300;402;272;269;205;64
7;142207;142200;06-300;600;384;379;306;73
8;142207;142200;06-300;371;257;257;220;37
9;142207;142200;06-300;704;499;497;420;77
1;142301;142300;26-422;288;211;211;173;38
2;142301;142300;26-422;445;274;274;214;60
3;142301;142300;26-422;546;358;356;249;107
4;142301;142300;26-422;204;133;132;93;39
5;142301;142300;26-422;688;507;501;334;167
6;142301;142300;26-422;498;391;385;285;100
7;142301;142300;26-422;359;256;254;200;54
8;142301;142300;26-422;190;148;147;109;38
1;142302;142300;26-434;1243;904;896;718;178
2;142302;142300;26-434;423;299;297;257;40
3;142302;142300;26-434;575;435;431;360;71
4;142302;142300;26-434;769;565;556;495;61
5;142302;142300;26-434;199;149;148;130;18
6;142302;142300;26-434;254;204;202;168;34
1;142303;142300;26-415;630;511;507;418;89
2;142303;142300;26-415;199;155;153;120;33
3;142303;142300;26-415;416;323;319;231;88
4;142303;142300;26-415;504;417;411;364;47
5;142303;142300;26-415;179;140;140;124;16
6;142303;142300;26-415;151;129;129;111;18
7;142303;142300;26-415;185;145;145;127;18
8;142303;142300;26-415;327;272;267;241;26
1;142304;142300;26-425;788;641;637;499;138
2;142304;142300;26-425;506;396;396;332;64
3;142304;142300;26-425;344;258;258;207;51
4;142304;142300;26-425;940;756;753;696;57
5;142304;142300;26-425;245;209;209;185;24
1;142305;142300;26-414;1155;861;859;699;160
2;142305;142300;26-414;766;532;530;464;66
3;142305;142300;26-414;268;203;201;181;20
4;142305;142300;26-414;532;386;384;345;39
5;142305;142300;26-414;486;385;383;342;41
1;142306;142300;26-400;1445;1074;1064;632;432
2;142306;142300;26-400;1755;1331;1314;762;552
3;142306;142300;26-400;1146;803;796;495;301
4;142306;142300;26-400;331;224;223;161;62
5;142306;142300;26-400;825;583;580;420;160
6;142306;142300;26-400;623;464;462;351;111
7;142306;142300;26-400;681;489;485;394;91
8;142306;142300;26-400;316;209;208;189;19
9;142306;142300;26-400;209;156;156;117;39
10;142306;142300;26-400;309;244;240;212;28
11;142306;142300;26-400;352;254;253;202;51
12;142306;142300;26-400;288;197;195;161;34
13;142306;142300;26-400;194;149;149;114;35
14;142306;142300;26-400;298;221;220;165;55
1;142307;142300;26-411;622;497;491;395;96
2;142307;142300;26-411;375;301;297;265;32
3;142307;142300;26-411;184;137;136;114;22
4;142307;142300;26-411;497;385;383;347;36
5;142307;142300;26-411;336;264;263;236;27
6;142307;142300;26-411;277;229;228;208;20
7;142307;142300;26-411;278;210;207;173;34
8;142307;142300;26-411;222;170;168;145;23
9;142307;142300;26-411;234;185;185;168;17
10;142307;142300;26-411;196;150;148;140;8
1;142308;142300;26-432;1295;994;985;732;253
2;142308;142300;26-432;185;138;136;116;20
3;142308;142300;26-432;273;210;208;179;29
4;142308;142300;26-432;779;574;569;488;81
5;142308;142300;26-432;183;129;129;113;16
6;142308;142300;26-432;175;139;137;99;38
7;142308;142300;26-432;240;176;176;162;14
8;142308;142300;26-432;493;390;390;335;55
9;142308;142300;26-432;184;132;129;105;24
10;142308;142300;26-432;184;119;117;101;16
1;142401;142400;06-126;867;596;591;468;123
2;142401;142400;06-126;1053;745;737;558;179
3;142401;142400;06-126;830;564;560;457;103
4;142401;142400;06-126;89;49;45;19;26
5;142401;142400;06-120;72;18;17;11;6
1;142402;142400;07-215;1148;840;832;663;169
2;142402;142400;07-215;413;307;304;258;46
3;142402;142400;07-215;499;378;377;310;67
4;142402;142400;07-215;660;491;491;388;103
5;142402;142400;07-215;494;367;367;262;105
6;142402;142400;07-215;210;181;178;69;109
7;142402;142400;07-215;279;189;188;147;41
1;142403;142400;06-114;778;602;602;396;206
2;142403;142400;06-114;285;226;226;142;84
3;142403;142400;06-121;609;429;422;330;92
4;142403;142400;06-121;882;618;607;472;135
5;142403;142400;06-114;580;426;425;312;113
6;142403;142400;06-114;237;168;166;125;41
7;142403;142400;06-114;321;245;243;163;80
8;142403;142400;06-121;433;300;299;217;82
1;142404;142400;06-100;702;492;483;251;232
2;142404;142400;06-100;747;515;511;386;125
3;142404;142400;06-100;579;417;416;284;132
4;142404;142400;06-100;781;556;543;422;121
5;142404;142400;06-100;498;353;352;245;107
6;142404;142400;06-100;1566;1037;1030;599;431
7;142404;142400;06-100;722;541;537;297;240
8;142404;142400;06-100;1261;810;804;453;351
9;142404;142400;06-100;1120;660;654;425;229
10;142404;142400;06-100;1354;1012;999;556;443
11;142404;142400;06-100;448;325;324;167;157
12;142404;142400;06-100;1151;752;749;402;347
13;142404;142400;06-100;711;516;511;229;282
14;142404;142400;06-100;845;590;584;306;278
15;142404;142400;06-100;1083;823;816;399;417
16;142404;142400;06-100;2425;1712;1699;933;766
17;142404;142400;06-100;1396;912;904;500;404
18;142404;142400;06-100;154;119;117;87;30
19;142404;142400;06-100;269;192;192;100;92
20;142404;142400;06-100;224;176;175;144;31
21;142404;142400;06-100;92;30;30;19;11
22;142404;142400;06-100;68;50;49;28;21
23;142404;142400;06-100;39;28;28;20;8
1;142405;142400;06-150;921;680;675;471;204
2;142405;142400;06-150;846;581;575;428;147
3;142405;142400;06-150;809;521;520;400;120
4;142405;142400;06-150;607;406;401;255;146
5;142405;142400;06-150;507;338;334;242;92
1;142406;142400;06-120;630;437;431;333;98
2;142406;142400;06-120;564;420;410;350;60
3;142406;142400;06-120;871;598;596;450;146
4;142406;142400;06-120;1066;786;776;528;248
1;142407;142400;07-217;830;617;617;422;195
2;142407;142400;07-217;788;562;557;369;188
3;142407;142400;07-217;270;213;212;144;68
4;142407;142400;07-217;447;328;327;274;53
5;142407;142400;07-214;1009;763;760;620;140
6;142407;142400;07-214;568;409;406;338;68
1;142501;142500;26-670;782;552;547;284;263
2;142501;142500;26-670;718;492;487;257;230
3;142501;142500;26-670;914;613;607;359;248
4;142501;142500;26-670;761;516;513;284;229
5;142501;142500;26-670;808;549;545;311;234
6;142501;142500;26-670;772;483;478;286;192
7;142501;142500;26-670;799;555;549;303;246
8;142501;142500;26-670;802;552;548;309;239
9;142501;142500;26-670;863;582;578;315;263
10;142501;142500;26-670;790;478;476;293;183
11;142501;142500;26-670;941;660;653;371;282
12;142501;142500;26-670;822;558;551;355;196
13;142501;142500;26-670;902;666;661;360;301
14;142501;142500;26-670;960;693;685;403;282
15;142501;142500;26-670;833;600;596;297;299
16;142501;142500;26-670;137;42;42;21;21
1;142502;142500;26-634;1580;1142;1132;932;200
2;142502;142500;26-634;612;477;475;431;44
3;142502;142500;26-634;1154;864;861;743;118
4;142502;142500;26-634;1171;886;878;706;172
5;142502;142500;26-634;716;498;494;414;80
6;142502;142500;26-634;1838;1450;1442;1110;332
1;142503;142500;27-100;863;596;591;330;261
2;142503;142500;27-100;1137;770;765;464;301
3;142503;142500;27-100;725;470;467;275;192
4;142503;142500;27-100;559;363;361;274;87
5;142503;142500;27-100;305;201;201;156;45
6;142503;142500;27-100;465;311;308;243;65
7;142503;142500;27-100;941;606;603;473;130
8;142503;142500;27-100;1068;678;667;493;174
9;142503;142500;27-100;625;334;332;233;99
10;142503;142500;27-100;403;293;288;217;71
11;142503;142500;27-100;709;484;484;388;96
12;142503;142500;27-100;360;211;210;160;50
13;142503;142500;27-100;252;165;162;129;33
14;142503;142500;27-100;334;235;235;187;48
15;142503;142500;27-100;741;532;528;263;265
16;142503;142500;27-100;414;258;255;196;59
17;142503;142500;27-100;271;194;194;138;56
18;142503;142500;27-100;235;143;141;113;28
19;142503;142500;27-100;192;111;108;87;21
20;142503;142500;27-100;213;165;163;105;58
21;142503;142500;27-100;10;10;10;9;1
1;142504;142500;26-631;532;419;417;292;125
2;142504;142500;26-631;436;338;338;238;100
3;142504;142500;26-631;418;317;312;255;57
4;142504;142500;26-631;559;409;409;331;78
5;142504;142500;26-613;680;539;533;454;79
6;142504;142500;26-631;886;627;623;499;124
7;142504;142500;26-631;621;448;444;329;115
8;142504;142500;26-631;1236;942;932;746;186
1;142505;142500;26-660;1624;1206;1194;803;391
2;142505;142500;26-660;904;701;697;604;93
3;142505;142500;26-660;1029;730;725;595;130
4;142505;142500;26-660;1277;947;942;793;149
5;142505;142500;26-660;1804;1276;1265;968;297
6;142505;142500;26-660;764;569;559;500;59
7;142505;142500;26-660;712;503;503;430;73
8;142505;142500;26-660;2045;1513;1494;1076;418
9;142505;142500;26-660;819;609;605;431;174
1;142506;142500;26-630;1858;1344;1334;955;379
2;142506;142500;26-630;768;549;545;454;91
3;142506;142500;26-613;1691;1340;1326;916;410
4;142506;142500;26-630;1297;978;969;581;388
5;142506;142500;26-630;1212;933;926;668;258
6;142506;142500;26-630;434;320;317;281;36
7;142506;142500;26-630;1976;1473;1454;841;613
8;142506;142500;26-630;945;718;715;557;158
1;142507;142500;26-624;1091;818;810;600;210
2;142507;142500;26-624;890;632;624;452;172
3;142507;142500;26-624;1699;1271;1259;882;377
4;142507;142500;26-624;1353;1003;995;779;216
5;142507;142500;26-624;523;396;395;328;67
6;142507;142500;26-624;1529;1121;1115;829;286
7;142507;142500;26-624;1183;901;898;639;259
8;142507;142500;26-600;920;709;704;548;156
1;142508;142500;26-670;1360;917;909;704;205
2;142508;142500;26-670;451;300;297;231;66
3;142508;142500;26-670;414;276;272;193;79
4;142508;142500;26-670;849;545;540;414;126
5;142508;142500;26-670;1973;1429;1417;1099;318
6;142508;142500;26-670;519;377;372;323;49
7;142508;142500;26-670;1355;920;911;577;334
8;142508;142500;26-670;730;491;486;366;120
9;142508;142500;26-670;132;132;129;14;115
1;142509;142500;26-650;1425;1077;1073;869;204
2;142509;142500;26-650;1127;818;811;653;158
3;142509;142500;26-650;741;551;547;495;52
4;142509;142500;26-650;957;729;722;651;71
5;142509;142500;26-650;820;577;575;516;59
6;142509;142500;26-650;450;362;361;307;54
1;142510;142500;26-640;1898;1395;1379;1039;340
2;142510;142500;26-640;1556;1215;1209;920;289
3;142510;142500;26-640;1856;1468;1466;1126;340
4;142510;142500;26-640;960;745;742;626;116
5;142510;142500;26-640;878;653;649;562;87
6;142510;142500;26-640;544;377;373;333;40
7;142510;142500;26-640;592;443;440;371;69
8;142510;142500;26-640;657;505;496;388;108
9;142510;142500;26-640;482;357;356;302;54
10;142510;142500;26-640;158;117;116;102;14
11;142510;142500;26-640;329;259;259;212;47
12;142510;142500;26-640;557;454;450;300;150
13;142510;142500;26-640;155;134;134;127;7
14;142510;142500;26-640;162;114;114;98;16
15;142510;142500;26-640;526;387;386;350;36
1;142511;142500;26-680;1153;820;814;601;213
2;142511;142500;26-680;1365;868;859;551;308
3;142511;142500;26-680;1127;720;710;525;185
4;142511;142500;26-680;747;495;493;432;61
5;142511;142500;26-680;594;412;408;311;97
6;142511;142500;26-680;790;584;581;503;78
7;142511;142500;26-680;702;521;520;402;118
8;142511;142500;26-680;345;237;236;197;39
9;142511;142500;26-680;168;131;130;128;2
1;142512;142500;26-625;1543;1149;1137;878;259
2;142512;142500;26-625;811;634;631;483;148
3;142512;142500;26-625;1559;1117;1110;869;241
4;142512;142500;26-625;443;324;324;253;71
5;142512;142500;26-625;487;349;342;262;80
6;142512;142500;26-625;789;492;491;412;79
7;142512;142500;26-625;613;492;484;420;64
8;142512;142500;26-625;315;228;225;177;48
9;142512;142500;26-625;149;112;112;94;18
10;142512;142500;26-625;164;124;123;106;17
1;142513;142500;26-652;637;466;463;386;77
2;142513;142500;26-652;1064;831;826;698;128
3;142513;142500;26-652;1062;818;807;707;100
4;142513;142500;26-652;1495;1176;1168;852;316
5;142513;142500;26-652;896;714;706;614;92
6;142513;142500;26-600;1823;1399;1382;953;429
7;142513;142500;26-652;913;703;698;490;208
8;142513;142500;26-652;1297;1038;1030;768;262
9;142513;142500;26-652;586;454;447;341;106
10;142513;142500;26-652;510;415;411;350;61
1;142601;142600;08-113;570;420;415;340;75
2;142601;142600;08-113;285;215;214;151;63
3;142601;142600;08-113;698;521;519;467;52
4;142601;142600;08-113;389;280;279;247;32
1;142602;142600;08-108;489;301;300;247;53
2;142602;142600;08-108;312;204;202;155;47
3;142602;142600;08-108;735;491;484;314;170
4;142602;142600;08-108;466;319;318;250;68
1;142603;142600;08-130;1777;1275;1262;870;392
2;142603;142600;08-130;1139;841;838;731;107
3;142603;142600;08-130;847;598;590;410;180
4;142603;142600;08-130;863;613;610;490;120
5;142603;142600;08-130;598;423;421;334;87
6;142603;142600;08-130;801;566;557;380;177
7;142603;142600;08-130;396;320;319;264;55
1;142604;142600;08-124;1219;865;865;685;180
2;142604;142600;08-124;873;653;647;522;125
3;142604;142600;08-124;1294;997;990;909;81
4;142604;142600;08-124;386;298;296;273;23
1;142605;142600;08-140;1310;845;838;566;272
2;142605;142600;08-140;557;434;430;363;67
3;142605;142600;08-140;621;409;405;310;95
4;142605;142600;08-140;672;457;452;412;40
5;142605;142600;08-140;519;400;391;360;31
6;142605;142600;08-140;604;448;445;380;65
1;142606;142600;08-107;1081;859;850;771;79
2;142606;142600;08-107;848;650;644;540;104
1;142607;142600;08-109;374;250;249;211;38
2;142607;142600;08-109;333;213;213;186;27
3;142607;142600;08-109;457;295;293;217;76
4;142607;142600;08-109;860;652;650;585;65
5;142607;142600;08-109;356;280;279;259;20
1;142608;142600;08-110;1187;870;865;623;242
2;142608;142600;08-110;2287;1681;1669;1201;468
3;142608;142600;08-110;596;448;447;322;125
4;142608;142600;08-110;1332;1033;1021;734;287
5;142608;142600;08-103;1093;853;841;544;297
6;142608;142600;08-103;893;723;716;535;181
7;142608;142600;08-119;2052;1567;1554;1110;444
8;142608;142600;08-110;918;711;699;514;185
9;142608;142600;08-110;682;510;507;407;100
10;142608;142600;08-103;727;547;542;375;167
11;142608;142600;08-110;578;406;404;299;105
12;142608;142600;08-110;782;587;579;469;110
13;142608;142600;08-103;319;249;247;180;67
14;142608;142600;08-110;748;594;590;470;120
1;142609;142600;08-114;902;675;673;553;120
2;142609;142600;08-114;270;220;219;202;17
3;142609;142600;08-114;541;423;421;341;80
4;142609;142600;08-114;506;411;410;364;46
5;142609;142600;08-114;943;729;717;568;149
6;142609;142600;08-114;434;326;326;289;37
7;142609;142600;08-114;307;232;232;218;14
8;142609;142600;08-114;301;218;218;171;47
9;142609;142600;08-114;291;211;210;176;34
10;142609;142600;08-114;443;315;313;256;57
11;142609;142600;08-114;346;262;262;171;91
12;142609;142600;08-114;307;216;215;194;21
13;142609;142600;08-114;325;247;245;223;22
14;142609;142600;08-114;196;151;149;128;21
1;142610;142600;08-125;1824;1332;1321;1065;256
2;142610;142600;08-125;547;401;400;340;60
3;142610;142600;08-125;581;421;412;307;105
4;142610;142600;08-125;700;480;477;374;103
1;142611;142600;08-112;775;550;546;472;74
2;142611;142600;08-112;756;605;601;524;77
3;142611;142600;08-112;1196;915;914;729;185
4;142611;142600;08-112;534;415;413;386;27
5;142611;142600;08-112;513;420;419;387;32
6;142611;142600;08-112;167;140;139;136;3
7;142611;142600;08-112;309;247;243;231;12
8;142611;142600;08-112;211;161;159;137;22
1;142612;142600;08-117;659;485;481;416;65
2;142612;142600;08-117;353;241;236;209;27
3;142612;142600;08-116;753;543;539;458;81
4;142612;142600;08-116;234;161;158;148;10
5;142612;142600;08-117;469;352;350;307;43
6;142612;142600;08-117;356;266;265;234;31
7;142612;142600;08-116;158;118;117;112;5
8;142612;142600;08-117;304;228;225;174;51
1;142613;142600;08-106;1489;1135;1113;897;216
2;142613;142600;08-106;595;460;458;420;38
3;142613;142600;08-106;848;664;658;562;96
4;142613;142600;08-106;567;449;444;409;35
5;142613;142600;08-111;300;213;211;188;23
6;142613;142600;08-111;685;467;465;386;79
7;142613;142600;08-111;426;329;327;278;49
8;142613;142600;08-106;532;404;400;355;45
9;142613;142600;08-106;226;191;188;167;21
10;142613;142600;08-106;268;200;198;178;20
11;142613;142600;08-106;336;278;276;251;25
12;142613;142600;08-106;153;112;112;95;17
13;142613;142600;08-106;357;286;286;250;36
14;142613;142600;08-106;334;255;251;222;29
15;142613;142600;08-106;164;122;120;111;9
16;142613;142600;08-106;180;138;137;125;12
1;142701;142700;09-200;780;514;510;315;195
2;142701;142700;09-200;754;498;498;289;209
3;142701;142700;09-200;1024;709;705;438;267
4;142701;142700;09-200;819;612;606;299;307
5;142701;142700;09-200;912;638;635;322;313
6;142701;142700;09-200;933;610;604;340;264
7;142701;142700;09-200;894;591;585;323;262
8;142701;142700;09-200;791;562;555;296;259
9;142701;142700;09-200;696;440;438;230;208
10;142701;142700;09-200;782;534;529;298;231
11;142701;142700;09-200;729;492;487;292;195
12;142701;142700;09-200;754;486;479;256;223
13;142701;142700;09-200;1014;718;706;425;281
14;142701;142700;09-200;802;562;558;327;231
15;142701;142700;09-200;850;615;614;339;275
16;142701;142700;09-200;89;58;57;35;22
1;142702;142700;09-213;242;156;156;133;23
2;142702;142700;09-213;626;398;397;321;76
3;142702;142700;09-213;563;376;374;293;81
4;142702;142700;09-213;807;558;556;365;191
5;142702;142700;09-213;797;510;507;386;121
6;142702;142700;09-213;690;429;427;339;88
7;142702;142700;09-213;620;399;398;323;75
8;142702;142700;09-213;63;12;12;11;1
1;142703;142700;09-215;689;445;437;343;94
2;142703;142700;09-215;608;388;385;332;53
3;142703;142700;09-214;783;540;538;411;127
4;142703;142700;09-214;652;382;379;277;102
5;142703;142700;09-228;861;561;558;441;117
6;142703;142700;09-228;900;567;561;453;108
1;142704;142700;09-204;630;432;427;311;116
2;142704;142700;09-204;648;399;394;319;75
3;142704;142700;09-204;632;437;436;352;84
4;142704;142700;09-204;555;364;361;304;57
5;142704;142700;09-204;532;367;365;315;50
1;142705;142700;09-200;1072;706;704;506;198
2;142705;142700;09-200;1310;853;846;606;240
3;142705;142700;09-200;1009;645;640;460;180
4;142705;142700;09-200;562;363;360;289;71
5;142705;142700;09-200;724;490;489;330;159
6;142705;142700;09-200;496;324;321;232;89
1;142706;142700;09-227;461;293;293;241;52
2;142706;142700;09-227;910;588;584;463;121
3;142706;142700;09-227;538;387;384;228;156
4;142706;142700;09-227;640;419;411;270;141
5;142706;142700;09-227;413;287;285;246;39
6;142706;142700;09-227;246;185;184;149;35
7;142706;142700;09-227;70;29;27;12;15
1;142707;142700;09-226;939;683;682;483;199
2;142707;142700;09-226;938;599;597;470;127
3;142707;142700;09-226;1337;860;853;688;165
4;142707;142700;09-226;649;434;432;317;115
5;142707;142700;09-226;1044;653;647;510;137
1;142801;142800;96-500;1402;1038;1028;585;443
2;142801;142800;96-500;1379;1013;1003;504;499
3;142801;142800;96-500;983;752;748;378;370
4;142801;142800;96-500;965;695;689;348;341
5;142801;142800;96-500;1102;815;808;373;435
6;142801;142800;96-500;1424;1078;1068;558;510
7;142801;142800;96-500;1439;1095;1091;577;514
8;142801;142800;96-500;1217;930;924;408;516
9;142801;142800;96-500;1034;773;768;393;375
10;142801;142800;96-500;1227;917;911;440;471
11;142801;142800;96-500;1075;746;739;327;412
12;142801;142800;96-500;1048;700;696;380;316
13;142801;142800;96-500;1251;960;950;411;539
14;142801;142800;96-500;1240;989;983;443;540
15;142801;142800;96-500;1234;948;936;457;479
16;142801;142800;96-500;1188;913;902;394;508
17;142801;142800;96-500;1134;813;807;427;380
18;142801;142800;96-500;1330;976;966;538;428
19;142801;142800;96-500;1040;692;689;336;353
20;142801;142800;96-500;1254;891;883;499;384
21;142801;142800;96-500;1164;796;787;505;282
22;142801;142800;96-500;52;26;26;17;9
23;142801;142800;96-500;34;34;34;34;0
1;142802;142800;05-088;625;457;451;296;155
2;142802;142800;05-088;868;614;608;455;153
3;142802;142800;05-088;1052;747;741;465;276
4;142802;142800;05-088;1010;721;716;499;217
1;142803;142800;96-520;910;650;648;524;124
2;142803;142800;96-520;1155;831;825;570;255
3;142803;142800;96-521;638;437;434;350;84
4;142803;142800;96-521;732;515;512;353;159
5;142803;142800;96-521;555;373;368;324;44
6;142803;142800;96-521;639;435;430;347;83
1;142804;142800;96-512;957;658;651;514;137
2;142804;142800;96-512;1003;694;685;482;203
3;142804;142800;96-512;1050;715;711;590;121
4;142804;142800;96-512;713;475;474;334;140
5;142804;142800;96-512;621;404;402;255;147
6;142804;142800;96-512;91;80;80;64;16
1;142805;142800;96-513;902;642;633;489;144
2;142805;142800;96-513;1412;1110;1099;598;501
3;142805;142800;96-513;960;654;650;450;200
4;142805;142800;96-513;1142;793;787;510;277
5;142805;142800;96-513;881;625;621;479;142
1;142806;142800;96-514;741;507;506;393;113
2;142806;142800;96-514;658;469;467;367;100
3;142806;142800;96-514;742;557;551;423;128
4;142806;142800;96-514;499;342;339;263;76
1;142807;142800;96-500;741;567;561;363;198
2;142807;142800;96-500;772;568;564;377;187
3;142807;142800;96-500;956;645;638;423;215
4;142807;142800;96-500;1186;890;879;540;339
5;142807;142800;96-500;1524;1137;1118;666;452
6;142807;142800;96-500;732;554;548;286;262
7;142807;142800;96-500;743;528;524;352;172
8;142807;142800;96-500;897;711;705;347;358
9;142807;142800;96-500;541;377;373;229;144
10;142807;142800;96-500;675;474;468;312;156
1;142808;142800;96-515;1037;793;789;411;378
2;142808;142800;96-515;1124;892;881;510;371
3;142808;142800;96-515;547;410;407;260;147
4;142808;142800;96-516;910;611;605;415;190
5;142808;142800;96-516;860;594;592;415;177
6;142808;142800;96-515;1376;1064;1056;677;379
7;142808;142800;96-515;1225;905;899;603;296
8;142808;142800;96-515;1186;852;848;553;295
9;142808;142800;96-515;599;496;493;246;247
1;142901;142900;08-300;1620;1108;1104;750;354
2;142901;142900;08-300;2076;1566;1558;1029;529
3;142901;142900;08-300;1934;1455;1442;891;551
4;142901;142900;08-300;1497;1064;1054;650;404
5;142901;142900;08-300;2214;1643;1621;921;700
6;142901;142900;08-300;1532;1092;1082;635;447
7;142901;142900;08-300;1022;729;725;467;258
8;142901;142900;08-300;1793;1297;1285;837;448
9;142901;142900;08-300;145;61;61;44;17
1;142902;142900;08-311;943;755;749;665;84
2;142902;142900;08-311;600;439;434;386;48
3;142902;142900;08-311;891;692;682;588;94
4;142902;142900;08-311;276;218;216;192;24
1;142903;142900;08-322;741;513;505;398;107
2;142903;142900;08-322;457;325;323;298;25
3;142903;142900;08-322;398;290;287;242;45
1;142904;142900;08-304;399;314;312;279;33
2;142904;142900;08-304;421;310;308;248;60
3;142904;142900;08-304;576;369;368;295;73
4;142904;142900;08-304;608;402;401;321;80
5;142904;142900;08-304;1343;992;981;726;255
1;142905;142900;08-330;1200;858;847;609;238
2;142905;142900;08-330;968;704;698;528;170
3;142905;142900;08-330;645;425;421;362;59
4;142905;142900;08-330;394;266;263;216;47
5;142905;142900;08-330;577;445;444;416;28
6;142905;142900;08-330;485;340;339;288;51
7;142905;142900;08-330;257;195;195;182;13
1;142906;142900;08-307;978;740;733;595;138
2;142906;142900;08-307;445;303;303;226;77
3;142906;142900;08-307;1021;725;718;550;168
4;142906;142900;08-307;642;529;528;469;59
5;142906;142900;08-307;458;369;363;312;51
6;142906;142900;08-307;224;164;164;125;39
7;142906;142900;08-307;47;26;24;22;2
1;142907;142900;08-331;383;266;265;209;56
2;142907;142900;08-331;699;482;476;362;114
3;142907;142900;08-331;945;631;623;468;155
4;142907;142900;08-331;384;282;281;222;59
5;142907;142900;08-331;292;202;201;146;55
1;142908;142900;08-300;614;434;428;321;107
2;142908;142900;08-300;367;242;237;183;54
3;142908;142900;08-300;727;530;525;380;145
4;142908;142900;08-300;338;259;258;227;31
5;142908;142900;08-300;723;528;528;370;158
6;142908;142900;08-300;512;356;355;281;74
7;142908;142900;08-300;585;437;436;356;80
8;142908;142900;08-300;435;330;330;245;85
9;142908;142900;08-300;318;246;244;228;16
1;142909;142900;08-320;825;590;584;414;170
2;142909;142900;08-320;617;409;407;300;107
3;142909;142900;08-320;464;346;342;295;47
4;142909;142900;08-320;482;355;355;245;110
5;142909;142900;08-320;359;253;252;217;35
6;142909;142900;08-320;184;143;142;111;31
1;143001;143000;26-510;1317;839;832;583;249
2;143001;143000;26-510;439;278;276;232;44
3;143001;143000;26-510;201;128;126;83;43
4;143001;143000;26-510;597;397;396;352;44
5;143001;143000;26-510;599;399;395;287;108
6;143001;143000;26-500;488;300;300;272;28
7;143001;143000;26-510;588;405;401;344;57
8;143001;143000;26-510;338;220;216;174;42
1;143002;143000;26-502;1395;1033;1025;822;203
2;143002;143000;26-502;886;645;640;523;117
3;143002;143000;26-502;635;444;441;347;94
4;143002;143000;26-502;300;237;237;183;54
5;143002;143000;26-502;542;418;412;354;58
6;143002;143000;26-502;165;118;118;96;22
1;143003;143000;26-503;1236;883;875;791;84
2;143003;143000;26-503;527;374;369;309;60
3;143003;143000;26-503;1099;728;723;623;100
1;143004;143000;26-505;1431;1020;1014;715;299
2;143004;143000;26-505;615;397;390;303;87
3;143004;143000;26-505;558;402;401;349;52
4;143004;143000;26-505;336;248;244;179;65
5;143004;143000;26-505;376;272;268;229;39
6;143004;143000;26-505;456;340;339;289;50
7;143004;143000;26-505;391;295;294;242;52
8;143004;143000;26-505;428;303;300;245;55
1;143005;143000;26-500;1639;1140;1132;675;457
2;143005;143000;26-500;1618;1067;1055;755;300
3;143005;143000;26-500;1684;1157;1138;767;371
4;143005;143000;26-500;1487;1013;1003;583;420
5;143005;143000;26-500;1325;893;881;612;269
6;143005;143000;26-500;1507;1033;1026;699;327
7;143005;143000;26-500;682;467;462;324;138
8;143005;143000;26-500;797;569;565;490;75
9;143005;143000;26-500;675;449;445;333;112
10;143005;143000;26-500;898;576;574;480;94
11;143005;143000;26-500;1230;847;843;701;142
1;143201;143200;05-870;1919;1528;1520;672;848
2;143201;143200;05-870;1352;1047;1038;503;535
3;143201;143200;05-870;1318;921;909;430;479
4;143201;143200;05-870;1377;1085;1072;481;591
5;143201;143200;05-870;1429;1158;1151;524;627
6;143201;143200;05-870;1120;843;841;341;500
7;143201;143200;05-870;1854;1492;1478;700;778
8;143201;143200;05-870;1027;809;800;447;353
9;143201;143200;05-870;1655;1332;1319;607;712
10;143201;143200;05-870;1359;1049;1036;597;439
11;143201;143200;05-870;1287;955;942;562;380
12;143201;143200;05-870;977;769;766;425;341
13;143201;143200;05-870;28;10;10;5;5
1;143202;143200;05-080;1948;1609;1596;819;777
2;143202;143200;05-080;875;721;714;285;429
3;143202;143200;05-080;1600;1365;1350;488;862
4;143202;143200;05-080;2180;1865;1846;750;1096
5;143202;143200;05-080;1742;1389;1377;748;629
1;143203;143200;05-085;2091;1635;1625;921;704
2;143203;143200;05-085;1459;1103;1094;732;362
1;143204;143200;05-084;1487;1076;1069;531;538
2;143204;143200;05-084;1433;1091;1084;495;589
3;143204;143200;05-084;401;302;295;151;144
4;143204;143200;05-084;1759;1397;1377;591;786
5;143204;143200;05-083;988;799;793;342;451
6;143204;143200;05-083;2013;1576;1566;729;837
7;143204;143200;05-085;243;167;165;108;57
1;143205;143200;05-092;1184;960;951;413;538
2;143205;143200;05-092;2255;1916;1900;650;1250
3;143205;143200;05-092;1954;1643;1625;561;1064
4;143205;143200;05-092;2129;1760;1740;718;1022
5;143205;143200;05-092;1574;1328;1318;451;867
6;143205;143200;05-092;1986;1757;1743;582;1161
7;143205;143200;05-092;1187;947;940;488;452
8;143205;143200;05-092;1640;1364;1346;559;787
9;143205;143200;05-092;2938;2611;2588;702;1886
10;143205;143200;05-092;1730;1480;1458;516;942
11;143205;143200;05-092;2018;1682;1665;685;980
12;143205;143200;05-092;1362;1078;1061;471;590
13;143205;143200;05-092;742;581;572;268;304
1;143206;143200;05-850;932;794;780;280;500
2;143206;143200;05-850;570;419;416;220;196
3;143206;143200;05-850;667;517;513;247;266
4;143206;143200;05-850;1609;1408;1397;506;891
5;143206;143200;05-850;2157;1843;1813;678;1135
6;143206;143200;05-850;1004;788;782;387;395
7;143206;143200;05-850;547;449;443;188;255
8;143206;143200;05-850;1044;872;868;396;472
9;143206;143200;05-850;1187;981;968;470;498
10;143206;143200;05-850;866;662;654;387;267
11;143206;143200;05-850;1362;1162;1144;426;718
12;143206;143200;05-850;804;650;645;350;295
13;143206;143200;05-850;1151;928;908;396;512
14;143206;143200;05-850;967;767;757;380;377
15;143206;143200;05-850;2138;1752;1736;726;1010
16;143206;143200;05-860;1061;857;848;437;411
17;143206;143200;05-860;721;544;537;325;212
18;143206;143200;05-860;465;335;332;192;140
19;143206;143200;05-860;335;218;216;148;68
20;143206;143200;05-860;847;662;656;324;332
21;143206;143200;05-860;1248;937;927;474;453
1;143207;143200;05-082;1817;1552;1536;575;961
2;143207;143200;05-082;1462;1207;1199;445;754
3;143207;143200;05-082;1258;1097;1090;366;724
4;143207;143200;05-082;2374;1992;1970;733;1237
5;143207;143200;05-082;1462;1228;1217;445;772
6;143207;143200;05-080;2157;1885;1858;789;1069
7;143207;143200;05-083;1657;1303;1288;697;591
8;143207;143200;05-083;1835;1456;1446;713;733
9;143207;143200;05-082;1140;1024;1008;285;723
10;143207;143200;05-082;1237;1078;1066;326;740
1;143301;143300;07-100;1521;1064;1057;556;501
2;143301;143300;07-100;1496;1139;1130;579;551
3;143301;143300;07-100;2293;1709;1690;1031;659
4;143301;143300;07-100;1964;1502;1478;867;611
5;143301;143300;07-100;1939;1428;1419;771;648
6;143301;143300;07-100;32;27;27;23;4
1;143302;143300;07-110;1088;769;758;559;199
2;143302;143300;07-110;1036;713;709;579;130
3;143302;143300;07-110;1130;760;756;656;100
4;143302;143300;07-110;160;127;126;84;42
1;143303;143300;07-120;1632;1209;1201;978;223
2;143303;143300;07-120;660;474;470;372;98
3;143303;143300;07-120;621;408;404;349;55
4;143303;143300;07-120;1147;884;881;765;116
5;143303;143300;07-120;525;325;320;254;66
1;143304;143300;07-100;890;717;712;621;91
2;143304;143300;07-100;550;409;404;319;85
3;143304;143300;07-100;1273;845;837;595;242
4;143304;143300;07-100;474;359;358;233;125
5;143304;143300;07-100;604;432;427;350;77
6;143304;143300;07-100;407;302;299;186;113
7;143304;143300;07-100;278;249;243;117;126
8;143304;143300;07-100;161;107;106;83;23
9;143304;143300;07-100;483;343;340;236;104
10;143304;143300;07-100;209;149;148;118;30
11;143304;143300;07-100;275;212;208;125;83
1;143305;143300;07-130;999;759;753;607;146
2;143305;143300;07-130;714;523;517;423;94
3;143305;143300;07-132;450;347;342;288;54
4;143305;143300;07-132;1187;906;898;632;266
5;143305;143300;07-132;556;447;446;391;55
6;143305;143300;07-130;488;373;368;235;133
7;143305;143300;07-130;493;381;379;292;87
8;143305;143300;07-130;836;582;581;409;172
9;143305;143300;07-130;620;413;409;275;134
10;143305;143300;07-130;695;512;507;298;209
11;143305;143300;07-130;883;617;610;438;172
12;143305;143300;07-130;1198;912;906;588;318
13;143305;143300;07-130;951;686;671;415;256
14;143305;143300;07-130;713;574;568;373;195
15;143305;143300;07-130;997;761;755;439;316
16;143305;143300;07-130;420;305;300;263;37
17;143305;143300;07-130;346;261;260;196;64
18;143305;143300;07-130;388;291;290;204;86
19;143305;143300;07-130;290;225;221;109;112
20;143305;143300;07-130;246;183;182;119;63
21;143305;143300;07-130;285;216;216;156;60
22;143305;143300;07-132;29;21;21;17;4
1;143306;143300;07-106;895;659;650;438;212
2;143306;143300;07-106;412;323;323;289;34
3;143306;143300;07-106;544;397;395;328;67
4;143306;143300;07-106;557;403;402;318;84
5;143306;143300;07-106;487;344;337;258;79
1;143307;143300;07-140;978;728;722;471;251
2;143307;143300;07-140;1040;732;725;534;191
3;143307;143300;07-140;716;507;505;412;93
4;143307;143300;07-140;639;461;458;376;82
5;143307;143300;07-140;642;476;472;380;92
6;143307;143300;07-140;470;314;310;256;54
1;143308;143300;07-104;489;360;357;283;74
2;143308;143300;07-104;591;404;400;328;72
3;143308;143300;07-104;515;340;337;277;60
4;143308;143300;07-104;1012;723;717;565;152
5;143308;143300;07-104;404;297;295;216;79
6;143308;143300;07-104;222;168;168;138;30
7;143308;143300;07-104;291;216;216;145;71
8;143308;143300;07-104;224;165;164;136;28
9;143308;143300;07-104;19;17;17;14;3
1;143309;143300;07-111;475;362;361;277;84
2;143309;143300;07-111;506;383;381;337;44
3;143309;143300;07-111;575;396;396;287;109
4;143309;143300;07-111;536;376;375;325;50
1;143401;143400;05-230;1521;1164;1153;575;578
2;143401;143400;05-230;1777;1446;1431;749;682
3;143401;143400;05-230;1708;1414;1399;583;816
4;143401;143400;05-230;1511;1276;1259;598;661
5;143401;143400;05-230;1461;1217;1205;620;585
6;143401;143400;05-230;789;617;614;350;264
7;143401;143400;05-230;787;615;609;353;256
8;143401;143400;05-230;1384;1153;1141;664;477
9;143401;143400;05-230;1527;1272;1253;659;594
10;143401;143400;05-230;749;617;609;314;295
11;143401;143400;05-230;2058;1648;1630;873;757
12;143401;143400;05-230;1124;885;878;507;371
13;143401;143400;05-230;985;794;787;416;371
14;143401;143400;05-230;840;667;659;335;324
15;143401;143400;05-230;881;723;720;326;394
16;143401;143400;05-230;567;445;439;239;200
1;143402;143400;05-270;2259;1803;1788;747;1041
2;143402;143400;05-270;2375;1870;1857;947;910
3;143402;143400;05-270;1551;1193;1176;587;589
4;143402;143400;05-270;1689;1345;1334;705;629
5;143402;143400;05-270;1140;905;899;383;516
6;143402;143400;05-270;1800;1300;1279;623;656
7;143402;143400;05-270;2029;1546;1533;803;730
8;143402;143400;05-270;1768;1464;1451;647;804
9;143402;143400;05-270;1500;1183;1171;596;575
10;143402;143400;05-270;2168;1747;1735;760;975
11;143402;143400;05-270;2039;1691;1673;757;916
12;143402;143400;05-270;2256;1765;1755;848;907
13;143402;143400;05-270;1341;1079;1068;546;522
14;143402;143400;05-270;2202;1727;1710;853;857
15;143402;143400;05-270;1731;1433;1420;578;842
16;143402;143400;05-270;2308;1844;1822;820;1002
1;143403;143400;05-091;1908;1608;1589;794;795
2;143403;143400;05-091;2213;1791;1779;940;839
3;143403;143400;05-091;1556;1254;1246;638;608
4;143403;143400;05-091;2313;1888;1862;1067;795
5;143403;143400;05-091;2709;2091;2071;1110;961
6;143403;143400;05-091;1836;1500;1484;704;780
7;143403;143400;05-091;2166;1695;1671;851;820
8;143403;143400;05-091;1670;1332;1321;509;812
9;143403;143400;05-091;1792;1469;1456;653;803
10;143403;143400;05-091;1878;1545;1526;614;912
11;143403;143400;05-091;1629;1315;1302;505;797
12;143403;143400;05-091;2139;1769;1741;683;1058
13;143403;143400;05-091;2379;1939;1916;782;1134
14;143403;143400;05-091;2358;1934;1919;750;1169
15;143403;143400;05-091;109;88;83;40;43
1;143404;143400;05-220;1185;958;950;348;602
2;143404;143400;05-220;960;794;786;322;464
3;143404;143400;05-220;970;801;793;432;361
4;143404;143400;05-220;792;651;647;355;292
5;143404;143400;05-220;702;576;570;322;248
6;143404;143400;05-220;788;632;619;385;234
7;143404;143400;05-220;1211;990;976;497;479
8;143404;143400;05-220;1245;1091;1079;485;594
9;143404;143400;05-220;841;695;691;343;348
10;143404;143400;05-220;798;632;625;275;350
11;143404;143400;05-220;714;560;551;261;290
12;143404;143400;05-220;820;628;620;316;304
13;143404;143400;05-220;681;581;575;287;288
14;143404;143400;05-220;865;700;694;382;312
15;143404;143400;05-220;1113;877;871;458;413
16;143404;143400;05-220;57;32;32;17;15
1;143405;143400;05-252;1314;1070;1060;810;250
2;143405;143400;05-252;445;370;368;268;100
3;143405;143400;05-254;552;453;449;306;143
4;143405;143400;05-254;505;391;388;222;166
5;143405;143400;05-252;491;361;357;275;82
6;143405;143400;05-252;299;227;227;183;44
7;143405;143400;05-252;891;721;715;573;142
8;143405;143400;05-254;489;383;381;285;96
9;143405;143400;05-254;478;378;377;257;120
10;143405;143400;05-252;411;327;325;214;111
11;143405;143400;05-252;424;344;343;259;84
12;143405;143400;05-252;386;326;323;245;78
1;143406;143400;05-280;716;489;483;302;181
2;143406;143400;05-280;710;488;485;378;107
3;143406;143400;05-280;684;438;429;308;121
4;143406;143400;05-280;439;332;332;201;131
5;143406;143400;05-281;1000;757;749;463;286
6;143406;143400;05-281;723;552;548;342;206
7;143406;143400;05-280;428;272;268;201;67
8;143406;143400;05-281;526;392;387;271;116
9;143406;143400;05-281;411;306;302;214;88
10;143406;143400;05-280;392;261;258;188;70
1;143407;143400;05-205;1336;1012;1001;653;348
2;143407;143400;05-205;1560;1253;1236;737;499
3;143407;143400;05-205;857;599;596;447;149
4;143407;143400;05-205;1447;1107;1096;724;372
5;143407;143400;05-205;599;472;469;324;145
6;143407;143400;05-205;1170;922;912;650;262
7;143407;143400;05-240;519;411;407;319;88
8;143407;143400;05-205;248;210;208;180;28
9;143407;143400;05-205;509;435;434;251;183
10;143407;143400;05-205;278;212;209;174;35
11;143407;143400;05-205;118;64;63;37;26
12;143407;143400;05-205;70;34;34;11;23
1;143408;143400;05-326;579;400;399;350;49
2;143408;143400;05-326;1003;724;719;592;127
3;143408;143400;05-326;702;563;559;443;116
4;143408;143400;05-326;790;607;604;512;92
5;143408;143400;05-079;877;654;649;483;166
6;143408;143400;05-326;888;685;682;541;141
7;143408;143400;05-326;223;184;183;155;28
1;143409;143400;05-250;1692;1283;1269;707;562
2;143409;143400;05-250;2449;1890;1874;1046;828
3;143409;143400;05-250;2560;2085;2078;1146;932
4;143409;143400;05-250;2249;1812;1793;902;891
5;143409;143400;05-250;1827;1440;1431;779;652
6;143409;143400;05-250;1978;1581;1569;1141;428
7;143409;143400;05-250;1771;1325;1313;889;424
8;143409;143400;05-255;2351;1962;1943;1199;744
9;143409;143400;05-250;2076;1667;1655;949;706
10;143409;143400;05-250;2250;1805;1793;1052;741
11;143409;143400;05-270;1665;1402;1390;956;434
12;143409;143400;05-250;79;43;40;28;12
13;143409;143400;05-250;28;14;14;9;5
1;143410;143400;05-282;334;242;240;201;39
2;143410;143400;05-282;602;423;420;339;81
3;143410;143400;05-282;324;225;222;147;75
4;143410;143400;05-282;477;351;347;257;90
5;143410;143400;05-282;372;237;235;197;38
1;143411;143400;05-240;1171;898;890;492;398
2;143411;143400;05-240;580;406;403;262;141
3;143411;143400;05-240;1222;985;978;600;378
4;143411;143400;05-240;1311;1033;1026;635;391
5;143411;143400;05-240;894;678;674;419;255
6;143411;143400;05-240;984;742;734;433;301
7;143411;143400;05-240;1261;949;942;692;250
8;143411;143400;05-240;1392;1023;1014;720;294
9;143411;143400;05-240;993;710;698;574;124
10;143411;143400;05-240;797;597;592;478;114
11;143411;143400;05-240;776;586;578;428;150
12;143411;143400;05-240;841;636;629;476;153
13;143411;143400;05-240;839;605;599;425;174
14;143411;143400;05-240;970;734;725;517;208
15;143411;143400;05-240;844;577;574;418;156
16;143411;143400;05-240;580;433;430;279;151
1;143412;143400;05-200;1240;1000;995;601;394
2;143412;143400;05-230;981;768;762;504;258
3;143412;143400;05-200;1039;803;797;510;287
4;143412;143400;05-200;1787;1450;1435;924;511
5;143412;143400;05-200;890;725;720;481;239
6;143412;143400;05-200;579;471;469;354;115
7;143412;143400;05-200;291;247;246;197;49
8;143412;143400;05-200;1097;868;852;557;295
9;143412;143400;05-200;1120;861;857;539;318
10;143412;143400;05-200;548;403;401;237;164
11;143412;143400;05-200;1102;862;855;523;332
12;143412;143400;05-200;889;709;701;451;250
13;143412;143400;05-200;1606;1253;1243;622;621
14;143412;143400;05-200;1460;1137;1127;539;588
15;143412;143400;05-200;1587;1293;1274;674;600
16;143412;143400;05-200;2290;1834;1817;1020;797
17;143412;143400;05-200;847;640;636;306;330
18;143412;143400;05-200;839;651;648;356;292
19;143412;143400;05-200;837;558;551;313;238
20;143412;143400;05-200;1200;959;953;477;476
21;143412;143400;05-200;1432;1108;1098;565;533
22;143412;143400;05-200;1863;1394;1382;739;643
23;143412;143400;05-200;1499;1123;1109;594;515
24;143412;143400;05-200;1652;1295;1287;690;597
25;143412;143400;05-200;1572;1270;1254;653;601
26;143412;143400;05-200;1355;1098;1079;549;530
27;143412;143400;05-200;1594;1180;1165;638;527
28;143412;143400;05-200;1131;896;885;516;369
29;143412;143400;05-200;1246;1035;1021;513;508
30;143412;143400;05-200;1901;1512;1503;818;685
31;143412;143400;05-200;790;632;623;317;306
32;143412;143400;05-200;112;49;49;32;17
1;143501;143500;07-221;1527;1154;1147;777;370
2;143501;143500;07-221;517;363;361;283;78
3;143501;143500;07-221;879;632;627;500;127
4;143501;143500;07-221;572;414;411;338;73
5;143501;143500;07-210;926;644;642;470;172
6;143501;143500;07-308;1033;771;766;574;192
7;143501;143500;07-221;362;249;248;199;49
8;143501;143500;07-221;240;183;183;137;46
9;143501;143500;07-308;282;218;218;134;84
10;143501;143500;07-221;139;43;38;25;13
11;143501;143500;07-221;55;37;37;34;3
1;143502;143500;07-210;2010;1433;1423;1022;401
2;143502;143500;07-210;896;634;626;542;84
3;143502;143500;07-210;983;718;716;488;228
4;143502;143500;07-211;419;298;293;272;21
5;143502;143500;07-211;745;527;522;440;82
6;143502;143500;07-210;880;639;638;491;147
1;143503;143500;07-205;1347;1041;1029;810;219
2;143503;143500;07-205;587;475;471;408;63
3;143503;143500;07-205;504;365;363;293;70
4;143503;143500;07-205;566;425;420;362;58
5;143503;143500;07-207;619;439;437;325;112
6;143503;143500;07-207;687;526;524;408;116
7;143503;143500;07-200;419;301;298;239;59
8;143503;143500;07-205;390;292;290;241;49
9;143503;143500;07-207;305;208;208;187;21
1;143504;143500;07-203;1145;838;834;650;184
2;143504;143500;07-200;265;199;198;137;61
3;143504;143500;07-203;1125;869;860;446;414
4;143504;143500;07-203;600;441;436;376;60
5;143504;143500;07-206;428;301;300;258;42
6;143504;143500;07-206;963;661;658;528;130
7;143504;143500;07-203;113;111;108;25;83
1;143505;143500;07-200;963;755;748;383;365
2;143505;143500;07-200;1550;1262;1253;776;477
3;143505;143500;07-200;1759;1402;1387;854;533
4;143505;143500;07-200;1207;892;886;533;353
5;143505;143500;07-200;1364;964;949;585;364
6;143505;143500;07-202;1227;900;889;496;393
7;143505;143500;07-200;1264;919;912;596;316
8;143505;143500;07-200;837;595;589;402;187
9;143505;143500;07-202;1265;886;879;496;383
10;143505;143500;07-202;1327;935;931;512;419
11;143505;143500;07-202;1103;714;710;403;307
12;143505;143500;07-202;1195;919;914;516;398
13;143505;143500;07-200;1159;881;872;519;353
14;143505;143500;07-200;1325;1017;1007;551;456
15;143505;143500;07-201;1210;892;886;496;390
16;143505;143500;07-202;976;808;803;401;402
17;143505;143500;07-201;558;391;387;256;131
18;143505;143500;07-201;735;502;496;362;134
19;143505;143500;07-201;706;507;500;352;148
20;143505;143500;07-201;562;409;400;304;96
21;143505;143500;07-200;1212;956;945;521;424
22;143505;143500;07-200;545;442;439;279;160
23;143505;143500;07-200;1120;830;822;637;185
24;143505;143500;07-202;1085;784;773;645;128
25;143505;143500;07-200;532;412;410;319;91
26;143505;143500;07-200;407;302;298;265;33
27;143505;143500;07-202;1475;1116;1108;737;371
28;143505;143500;07-201;415;311;309;243;66
29;143505;143500;07-200;994;723;709;406;303
30;143505;143500;07-200;93;43;42;26;16
1;143506;143500;07-230;1272;990;986;723;263
2;143506;143500;07-230;1099;865;861;616;245
3;143506;143500;07-230;883;654;650;478;172
4;143506;143500;07-230;727;540;538;325;213
5;143506;143500;07-230;766;487;478;381;97
1;143601;143600;26-713;935;696;689;485;204
2;143601;143600;26-713;751;527;522;437;85
3;143601;143600;26-713;587;423;421;357;64
4;143601;143600;26-713;281;181;180;147;33
5;143601;143600;26-713;398;280;280;251;29
6;143601;143600;26-713;224;143;141;109;32
7;143601;143600;26-713;255;185;184;152;32
1;143602;143600;26-720;1645;1070;1056;805;251
2;143602;143600;26-720;718;501;499;365;134
3;143602;143600;26-720;235;139;138;96;42
4;143602;143600;26-720;459;309;306;247;59
5;143602;143600;26-720;555;383;382;308;74
6;143602;143600;26-720;293;211;208;176;32
7;143602;143600;26-720;338;233;231;183;48
1;143603;143600;26-704;486;302;297;232;65
2;143603;143600;26-704;335;228;226;176;50
3;143603;143600;26-704;327;207;207;165;42
4;143603;143600;26-704;379;279;276;216;60
5;143603;143600;26-704;704;481;476;378;98
6;143603;143600;26-704;840;564;563;477;86
7;143603;143600;26-704;240;141;141;111;30
8;143603;143600;26-704;204;160;159;137;22
9;143603;143600;26-704;198;154;153;117;36
10;143603;143600;26-704;357;253;252;202;50
11;143603;143600;26-704;590;397;396;338;58
1;143604;143600;26-706;1365;985;970;827;143
2;143604;143600;26-706;720;495;493;385;108
3;143604;143600;26-706;370;259;255;181;74
4;143604;143600;26-706;737;523;518;456;62
5;143604;143600;26-706;477;311;309;257;52
1;143605;143600;26-700;1684;1134;1124;693;431
2;143605;143600;26-700;2223;1588;1581;1027;554
3;143605;143600;26-700;1324;932;922;594;328
4;143605;143600;26-700;1491;1087;1076;633;443
5;143605;143600;26-700;429;325;325;279;46
6;143605;143600;26-700;597;395;393;322;71
7;143605;143600;26-700;271;195;193;170;23
8;143605;143600;26-700;553;389;386;314;72
9;143605;143600;26-700;736;528;528;454;74
10;143605;143600;26-700;579;411;409;306;103
11;143605;143600;26-700;351;287;286;237;49
12;143605;143600;26-700;491;323;322;262;60
13;143605;143600;26-700;348;227;224;186;38
14;143605;143600;26-700;54;13;13;9;4
1;143701;143700;09-320;1301;853;845;540;305
2;143701;143700;09-320;1425;945;943;729;214
3;143701;143700;09-320;877;586;582;500;82
1;143702;143700;09-310;910;594;585;383;202
2;143702;143700;09-310;1196;763;760;498;262
3;143702;143700;09-310;801;461;458;370;88
4;143702;143700;09-310;495;319;319;251;68
1;143703;143700;09-304;1287;935;932;572;360
2;143703;143700;09-304;732;454;451;325;126
3;143703;143700;09-304;1217;793;785;543;242
4;143703;143700;09-303;1688;1087;1082;783;299
5;143703;143700;09-304;42;13;13;7;6
1;143704;143700;09-317;1118;743;738;585;153
2;143704;143700;09-317;703;458;457;344;113
3;143704;143700;09-317;756;412;407;293;114
4;143704;143700;09-317;387;258;255;226;29
5;143704;143700;09-317;187;121;121;81;40
1;143705;143700;09-135;721;476;472;414;58
2;143705;143700;09-135;791;501;501;375;126
3;143705;143700;09-135;631;380;378;305;73
4;143705;143700;09-135;216;154;154;115;39
5;143705;143700;09-135;187;128;128;109;19
1;143706;143700;09-300;1401;1024;1016;475;541
2;143706;143700;09-300;1233;779;774;412;362
3;143706;143700;09-300;1349;933;928;482;446
4;143706;143700;09-300;1494;1133;1121;506;615
5;143706;143700;09-300;928;630;629;472;157
6;143706;143700;09-300;775;500;494;303;191
7;143706;143700;09-300;329;221;221;163;58
8;143706;143700;09-300;690;446;440;299;141
9;143706;143700;09-300;302;194;194;132;62
10;143706;143700;09-300;212;164;162;120;42
11;143706;143700;09-300;185;132;131;106;25
12;143706;143700;09-300;165;133;132;91;41
13;143706;143700;09-300;305;216;215;150;65
14;143706;143700;09-300;871;621;614;293;321
15;143706;143700;09-300;115;56;51;34;17
1;143801;143800;96-300;1585;1276;1267;570;697
2;143801;143800;96-300;1254;907;894;422;472
3;143801;143800;96-300;1056;783;772;363;409
4;143801;143800;96-300;925;720;710;317;393
5;143801;143800;96-300;1162;909;905;443;462
6;143801;143800;96-300;1045;738;731;355;376
7;143801;143800;96-300;1767;1366;1358;676;682
8;143801;143800;96-300;1509;1077;1064;492;572
9;143801;143800;96-300;1524;991;981;484;497
10;143801;143800;96-300;1391;818;811;440;371
11;143801;143800;96-300;1997;1503;1486;662;824
12;143801;143800;96-300;1555;1215;1195;554;641
13;143801;143800;96-300;1146;913;904;417;487
14;143801;143800;96-300;1430;1119;1113;475;638
15;143801;143800;96-300;1301;1036;1025;394;631
16;143801;143800;96-300;1508;1187;1170;521;649
17;143801;143800;96-300;1081;688;681;371;310
18;143801;143800;96-300;1477;1086;1075;449;626
19;143801;143800;96-300;1213;880;872;416;456
20;143801;143800;96-300;1094;873;865;492;373
21;143801;143800;96-300;1230;992;980;463;517
22;143801;143800;96-300;169;70;69;47;22
23;143801;143800;96-300;54;28;27;15;12
24;143801;143800;96-300;61;37;32;22;10
1;143802;143800;96-320;486;363;358;215;143
2;143802;143800;96-320;641;502;500;327;173
3;143802;143800;96-320;732;545;543;334;209
4;143802;143800;96-320;790;581;579;330;249
5;143802;143800;96-320;534;405;405;221;184
6;143802;143800;96-320;472;337;331;201;130
7;143802;143800;96-320;434;335;334;213;121
8;143802;143800;96-320;598;421;419;247;172
9;143802;143800;96-320;759;522;517;317;200
10;143802;143800;96-323;695;475;473;296;177
11;143802;143800;96-323;577;426;424;316;108
12;143802;143800;96-323;584;424;424;363;61
13;143802;143800;96-320;729;531;519;351;168
14;143802;143800;96-323;721;501;498;350;148
1;143803;143800;96-330;1625;1166;1158;666;492
2;143803;143800;96-330;784;559;554;359;195
3;143803;143800;96-330;366;249;247;175;72
4;143803;143800;96-330;275;182;182;97;85
5;143803;143800;96-330;446;322;319;200;119
6;143803;143800;96-330;1035;802;793;506;287
7;143803;143800;96-332;1525;1117;1107;702;405
8;143803;143800;96-332;740;557;551;352;199
9;143803;143800;96-330;111;24;23;10;13
1;143804;143800;96-325;1508;1213;1207;576;631
2;143804;143800;96-325;969;782;776;447;329
3;143804;143800;96-300;1069;818;808;408;400
4;143804;143800;96-300;633;460;457;295;162
5;143804;143800;96-325;828;672;666;387;279
6;143804;143800;96-325;42;17;17;9;8
1;143805;143800;96-315;370;289;287;189;98
2;143805;143800;96-315;479;349;346;220;126
3;143805;143800;96-315;1107;821;809;508;301
4;143805;143800;96-315;939;655;647;419;228
5;143805;143800;96-317;1025;693;690;537;153
6;143805;143800;96-315;1067;728;720;569;151
7;143805;143800;96-315;386;212;208;138;70
8;143805;143800;96-315;778;620;610;283;327
9;143805;143800;96-315;1092;774;771;481;290
10;143805;143800;96-317;208;166;165;129;36
11;143805;143800;96-315;212;165;165;135;30
1;146101;146100;07-410;1941;1290;1273;800;473
2;146101;146100;07-410;895;633;626;343;283
3;146101;146100;07-410;1505;1050;1037;627;410
4;146101;146100;07-410;1577;1113;1104;636;468
5;146101;146100;07-410;1354;883;874;552;322
6;146101;146100;07-410;1430;859;845;537;308
7;146101;146100;07-410;1352;867;863;564;299
8;146101;146100;07-410;1401;952;947;573;374
9;146101;146100;07-410;996;719;711;381;330
10;146101;146100;07-410;1530;967;957;647;310
11;146101;146100;07-410;1155;743;741;429;312
12;146101;146100;07-410;634;390;383;231;152
13;146101;146100;07-410;1338;948;937;503;434
14;146101;146100;07-410;1546;1142;1127;648;479
15;146101;146100;07-410;1602;1140;1122;625;497
16;146101;146100;07-410;1922;1512;1504;801;703
17;146101;146100;07-410;1563;1146;1135;642;493
18;146101;146100;07-410;1989;1531;1518;815;703
19;146101;146100;07-410;1989;1512;1500;853;647
20;146101;146100;07-410;1625;1141;1133;649;484
21;146101;146100;07-410;1666;1201;1193;811;382
22;146101;146100;07-410;1253;948;935;617;318
23;146101;146100;07-410;1137;868;855;412;443
24;146101;146100;07-410;588;441;436;270;166
25;146101;146100;07-410;1745;1349;1336;760;576
26;146101;146100;07-410;145;99;94;48;46
27;146101;146100;07-410;12;12;12;10;2
28;146101;146100;07-410;211;172;171;125;46
29;146101;146100;07-410;24;5;5;4;1
1;146201;146200;09-400;1428;1122;1114;443;671
2;146201;146200;09-400;657;412;408;254;154
3;146201;146200;09-400;1014;649;642;317;325
4;146201;146200;09-400;1761;1222;1217;656;561
5;146201;146200;09-400;994;682;678;348;330
6;146201;146200;09-400;1116;716;710;368;342
7;146201;146200;09-400;1153;686;684;390;294
8;146201;146200;09-400;1350;812;808;408;400
9;146201;146200;09-400;901;508;506;245;261
10;146201;146200;09-400;627;424;421;234;187
11;146201;146200;09-400;967;561;555;347;208
12;146201;146200;09-400;831;580;575;289;286
13;146201;146200;09-400;1269;918;910;477;433
14;146201;146200;09-400;1330;961;951;457;494
15;146201;146200;09-400;1204;855;849;415;434
16;146201;146200;09-400;1186;876;870;442;428
17;146201;146200;09-400;1307;942;935;400;535
18;146201;146200;09-400;945;668;663;348;315
19;146201;146200;09-400;414;303;302;159;143
20;146201;146200;09-400;984;760;754;295;459
21;146201;146200;09-400;941;630;625;315;310
22;146201;146200;09-400;1319;954;948;462;486
23;146201;146200;09-402;219;142;140;100;40
24;146201;146200;09-400;879;566;555;247;308
25;146201;146200;09-400;950;607;603;261;342
26;146201;146200;09-402;534;333;329;151;178
27;146201;146200;09-402;967;726;717;338;379
28;146201;146200;09-402;1103;728;719;331;388
29;146201;146200;09-402;1025;716;705;344;361
30;146201;146200;09-402;1580;1087;1076;537;539
31;146201;146200;09-400;677;447;440;190;250
32;146201;146200;09-400;988;711;707;310;397
33;146201;146200;09-402;1671;1229;1218;622;596
34;146201;146200;09-400;1051;759;753;367;386
35;146201;146200;09-402;1572;1131;1122;489;633
36;146201;146200;09-402;882;654;650;311;339
37;146201;146200;09-402;942;675;667;336;331
38;146201;146200;09-402;1330;995;982;513;469
39;146201;146200;09-402;1207;861;856;462;394
40;146201;146200;09-402;1823;1352;1342;582;760
41;146201;146200;09-402;1194;862;856;404;452
42;146201;146200;09-407;1461;1076;1069;562;507
43;146201;146200;09-402;2070;1606;1591;774;817
44;146201;146200;09-407;1464;1115;1111;481;630
45;146201;146200;09-407;1086;825;816;378;438
46;146201;146200;09-407;1022;769;764;363;401
47;146201;146200;09-407;1015;750;737;358;379
48;146201;146200;09-407;932;642;636;321;315
49;146201;146200;09-410;1212;856;846;407;439
50;146201;146200;09-410;1864;1401;1389;516;873
51;146201;146200;09-410;1748;1361;1352;572;780
52;146201;146200;09-410;2092;1711;1692;590;1102
53;146201;146200;09-410;1666;1363;1353;533;820
54;146201;146200;09-410;1626;1194;1191;554;637
55;146201;146200;09-410;1269;1002;997;502;495
56;146201;146200;09-410;1990;1319;1306;630;676
57;146201;146200;09-410;2022;1608;1598;728;870
58;146201;146200;09-408;1579;1136;1127;607;520
59;146201;146200;09-408;1283;1010;1001;455;546
60;146201;146200;09-401;1444;977;968;590;378
61;146201;146200;09-402;1387;972;965;645;320
62;146201;146200;09-402;1398;1035;1024;563;461
63;146201;146200;09-402;1116;859;848;477;371
64;146201;146200;09-410;893;658;653;347;306
65;146201;146200;09-410;2078;1629;1616;751;865
66;146201;146200;09-410;1312;1042;1035;414;621
67;146201;146200;09-400;1152;711;708;449;259
68;146201;146200;09-403;937;774;768;281;487
69;146201;146200;09-402;99;71;69;43;26
70;146201;146200;09-400;249;163;162;89;73
71;146201;146200;09-402;625;509;497;79;418
1;146301;146300;26-600;742;452;444;251;193
2;146301;146300;26-600;791;519;513;269;244
3;146301;146300;26-600;976;689;685;361;324
4;146301;146300;26-600;1002;728;721;363;358
5;146301;146300;26-600;883;594;589;309;280
6;146301;146300;26-600;821;563;559;305;254
7;146301;146300;26-600;553;379;374;185;189
8;146301;146300;26-600;565;370;367;209;158
9;146301;146300;26-600;531;363;361;192;169
10;146301;146300;26-600;1529;1072;1059;518;541
11;146301;146300;26-600;653;490;486;237;249
12;146301;146300;26-600;490;337;335;179;156
13;146301;146300;26-600;1246;882;867;520;347
14;146301;146300;26-600;1839;1404;1388;636;752
15;146301;146300;26-600;850;597;591;303;288
16;146301;146300;26-600;1403;1010;1002;495;507
17;146301;146300;26-600;832;590;586;309;277
18;146301;146300;26-600;1390;910;908;518;390
19;146301;146300;26-600;1139;776;768;447;321
20;146301;146300;26-600;818;491;487;249;238
21;146301;146300;26-600;846;565;563;296;267
22;146301;146300;26-600;670;453;451;228;223
23;146301;146300;26-600;1364;978;966;500;466
24;146301;146300;26-600;1510;1152;1145;540;605
25;146301;146300;26-600;1408;980;974;499;475
26;146301;146300;26-600;1307;867;861;465;396
27;146301;146300;26-600;1110;741;737;392;345
28;146301;146300;26-600;1799;1398;1384;635;749
29;146301;146300;26-600;1441;1118;1109;670;439
30;146301;146300;26-600;1915;1487;1478;751;727
31;146301;146300;26-600;1526;1132;1126;601;525
32;146301;146300;26-600;1070;806;801;449;352
33;146301;146300;26-600;1653;1206;1201;582;619
34;146301;146300;26-600;1091;762;757;406;351
35;146301;146300;26-600;1060;721;716;400;316
36;146301;146300;26-600;1724;1239;1225;641;584
37;146301;146300;26-600;133;82;79;51;28
38;146301;146300;26-600;2205;1659;1648;891;757
39;146301;146300;26-600;1352;991;986;807;179
40;146301;146300;26-600;1535;1163;1153;554;599
41;146301;146300;26-600;1256;923;914;515;399
42;146301;146300;26-600;1282;854;849;528;321
43;146301;146300;26-600;1602;1205;1194;766;428
44;146301;146300;26-600;1054;725;718;415;303
45;146301;146300;26-600;813;562;557;282;275
46;146301;146300;26-600;1640;1211;1206;717;489
47;146301;146300;26-600;1945;1425;1413;945;468
48;146301;146300;26-600;2453;1909;1891;1065;826
49;146301;146300;26-600;1839;1367;1354;853;501
50;146301;146300;26-600;2128;1656;1644;1113;531
51;146301;146300;26-600;1204;890;883;413;470
52;146301;146300;26-600;792;560;551;273;278
53;146301;146300;26-600;1372;1041;1034;498;536
54;146301;146300;26-600;1008;760;755;371;384
55;146301;146300;26-600;1371;1022;1008;501;507
56;146301;146300;26-600;1232;956;949;484;465
57;146301;146300;26-600;1116;833;828;440;388
58;146301;146300;26-600;1398;1017;1011;544;467
59;146301;146300;26-600;862;656;651;320;331
60;146301;146300;26-600;1446;1048;1034;557;477
61;146301;146300;26-600;1903;1425;1410;956;454
62;146301;146300;26-600;1505;1143;1135;619;516
63;146301;146300;26-600;1905;1391;1374;806;568
64;146301;146300;26-600;2071;1579;1561;923;638
65;146301;146300;26-600;1459;1066;1052;606;446
66;146301;146300;26-600;1490;1141;1130;617;513
67;146301;146300;26-600;1712;1292;1277;736;541
68;146301;146300;26-600;1552;1149;1139;667;472
69;146301;146300;26-600;1824;1362;1350;711;639
70;146301;146300;26-600;1596;1202;1193;711;482
71;146301;146300;26-600;1356;979;970;557;413
72;146301;146300;26-600;1037;751;743;485;258
73;146301;146300;26-600;1197;870;866;446;420
74;146301;146300;26-600;1063;776;773;365;408
75;146301;146300;26-600;957;658;652;351;301
76;146301;146300;26-600;986;659;655;365;290
77;146301;146300;26-600;1139;766;759;449;310
78;146301;146300;26-600;1357;946;940;605;335
79;146301;146300;26-600;1607;1137;1127;645;482
80;146301;146300;26-600;1262;911;904;431;473
81;146301;146300;26-600;1176;926;917;432;485
82;146301;146300;26-600;869;654;649;326;323
83;146301;146300;26-600;1891;1440;1427;734;693
84;146301;146300;26-600;1678;1245;1235;668;567
85;146301;146300;26-600;1368;1029;1022;642;380
86;146301;146300;26-600;1115;787;781;510;271
87;146301;146300;26-600;1290;1008;1001;615;386
88;146301;146300;26-600;1105;795;784;476;308
89;146301;146300;26-600;1118;880;873;452;421
90;146301;146300;26-600;2002;1556;1543;821;722
91;146301;146300;26-600;1692;1250;1240;739;501
92;146301;146300;26-600;1132;822;815;531;284
93;146301;146300;26-600;1011;737;729;393;336
94;146301;146300;26-600;1068;826;818;491;327
95;146301;146300;26-600;1696;1302;1287;689;598
96;146301;146300;26-600;1391;1102;1097;494;603
97;146301;146300;26-600;1347;1055;1043;534;509
98;146301;146300;26-600;1748;1329;1320;766;554
99;146301;146300;26-600;1696;1314;1299;701;598
100;146301;146300;26-600;1496;1107;1095;630;465
101;146301;146300;26-600;1910;1503;1492;825;667
102;146301;146300;26-600;2016;1560;1550;869;681
103;146301;146300;26-600;2130;1553;1540;937;603
104;146301;146300;26-600;1224;853;849;547;302
105;146301;146300;26-600;1154;849;844;571;273
106;146301;146300;26-600;2230;1759;1747;774;973
107;146301;146300;26-600;783;559;555;326;229
108;146301;146300;26-600;804;593;591;377;214
109;146301;146300;26-600;1359;976;965;596;369
110;146301;146300;26-610;122;97;96;53;43
111;146301;146300;26-607;115;107;106;79;27
112;146301;146300;26-600;876;656;643;113;530
113;146301;146300;26-613;238;191;188;124;64
114;146301;146300;26-600;48;41;41;27;14
1;146401;146400;08-110;1387;1009;1001;562;439
2;146401;146400;08-110;1312;972;965;534;431
3;146401;146400;08-110;1407;1069;1061;598;463
4;146401;146400;08-110;1688;1344;1333;755;578
5;146401;146400;08-110;927;670;664;419;245
6;146401;146400;08-110;1375;1089;1079;628;451
7;146401;146400;08-110;1627;1179;1169;698;471
8;146401;146400;08-110;1557;1225;1217;706;511
9;146401;146400;08-110;1796;1407;1392;800;592
10;146401;146400;08-110;1599;1171;1162;759;403
11;146401;146400;08-110;1383;1081;1067;662;405
12;146401;146400;08-110;1416;1047;1040;577;463
13;146401;146400;08-110;1435;1117;1108;602;506
14;146401;146400;08-110;1038;669;669;388;281
15;146401;146400;08-110;1394;1008;1004;553;451
16;146401;146400;08-110;1511;1097;1091;644;447
17;146401;146400;08-110;1536;1030;1025;615;410
18;146401;146400;08-110;1257;984;975;642;333
19;146401;146400;08-110;1285;909;903;572;331
20;146401;146400;08-110;1260;959;951;566;385
21;146401;146400;08-110;1262;950;945;572;373
22;146401;146400;08-110;1170;858;853;500;353
23;146401;146400;08-110;1067;865;857;523;334
24;146401;146400;08-110;1327;1007;1001;565;436
25;146401;146400;08-110;1503;1160;1147;762;385
26;146401;146400;08-110;1609;1240;1225;667;558
27;146401;146400;08-110;1695;1322;1310;751;559
28;146401;146400;08-110;1404;1093;1079;604;475
29;146401;146400;08-110;1668;1250;1242;773;469
30;146401;146400;08-110;1254;967;957;628;329
31;146401;146400;08-110;1440;1109;1103;677;426
32;146401;146400;08-110;1602;1199;1191;743;448
33;146401;146400;08-110;1355;1079;1074;626;448
34;146401;146400;08-110;1410;1101;1088;581;507
35;146401;146400;08-110;1492;1136;1125;659;466
36;146401;146400;08-110;1398;1073;1064;652;412
37;146401;146400;08-110;1564;1176;1167;691;476
38;146401;146400;08-110;1771;1390;1380;833;547
39;146401;146400;08-110;409;160;158;110;48
40;146401;146400;08-110;203;85;84;52;32
41;146401;146400;08-110;101;19;19;12;7
42;146401;146400;08-110;96;63;61;39;22
43;146401;146400;08-110;707;558;552;62;490
711;146502;146501;01-491;1330;1126;1123;401;722
712;146502;146501;01-491;1957;1737;1721;413;1308
713;146502;146501;01-495;1065;926;917;196;721
714;146502;146501;01-495;2578;2236;2214;517;1697
715;146502;146501;01-495;2502;2125;2109;477;1632
716;146502;146501;01-495;1262;1114;1100;227;873
717;146502;146501;01-480;1514;1388;1375;317;1058
718;146502;146501;01-476;2303;1963;1937;714;1223
719;146502;146501;01-485;2608;2153;2126;660;1466
720;146502;146501;01-493;2592;2126;2111;704;1407
721;146502;146501;01-493;2296;1974;1954;644;1310
722;146502;146501;01-494;2345;1983;1964;698;1266
723;146502;146501;01-494;1662;1399;1384;441;943
724;146502;146501;01-494;1233;1027;1022;385;637
725;146502;146501;01-494;1956;1631;1620;558;1062
726;146502;146501;01-494;1475;1355;1339;249;1090
727;146502;146501;01-494;1328;1200;1174;255;919
728;146502;146501;01-464;2201;1939;1928;517;1411
729;146502;146501;01-464;1629;1428;1411;399;1012
730;146502;146501;01-464;1753;1498;1478;458;1020
731;146502;146501;01-464;1776;1466;1451;464;987
732;146502;146501;01-471;2190;1865;1850;503;1347
733;146502;146501;01-471;2069;1810;1791;434;1357
734;146502;146501;01-471;2551;2111;2087;737;1350
735;146502;146501;01-471;2360;2050;2021;507;1514
736;146502;146501;01-315;2516;2265;2237;588;1649
737;146502;146501;01-355;796;640;633;225;408
738;146502;146501;01-381;1630;1420;1399;450;949
739;146502;146501;01-355;2509;2019;1992;738;1254
740;146502;146501;01-355;2216;1885;1864;616;1248
741;146502;146501;01-318;1697;1372;1359;519;840
742;146502;146501;01-318;2899;2397;2379;834;1545
743;146502;146501;01-317;1940;1607;1590;529;1061
744;146502;146501;01-317;1947;1568;1548;552;996
745;146502;146501;01-317;1012;829;818;256;562
746;146502;146501;01-391;1569;1258;1247;561;686
747;146502;146501;01-391;1649;1369;1350;475;875
748;146502;146501;01-384;1476;1191;1184;434;750
749;146502;146501;01-384;1800;1471;1457;506;951
750;146502;146501;01-384;1805;1462;1449;494;955
751;146502;146501;01-346;1202;1007;993;368;625
752;146502;146501;01-494;1328;1165;1156;293;863
753;146502;146501;01-310;2232;1928;1914;528;1386
754;146502;146501;01-310;1570;1283;1273;461;812
755;146502;146501;01-310;2661;2196;2164;692;1472
756;146502;146501;01-310;1230;1022;1013;320;693
757;146502;146501;01-494;263;249;245;52;193
758;146502;146501;01-471;2406;2136;2116;550;1566
759;146502;146501;01-307;2415;2171;2149;641;1508
760;146502;146501;01-315;1171;1025;1017;304;713
761;146502;146501;01-494;1520;1257;1238;391;847
1144;146502;146501;01-350;200;89;85;47;38
1145;146502;146501;01-493;103;94;94;25;69
838;146503;146501;03-289;1186;1003;995;396;599
839;146503;146501;03-289;1491;1300;1281;428;853
840;146503;146501;03-126;1404;1272;1258;381;877
841;146503;146501;03-287;1563;1371;1353;387;966
842;146503;146501;03-257;1316;1137;1124;425;699
843;146503;146501;03-044;1852;1583;1568;631;937
844;146503;146501;03-185;2141;1851;1822;564;1258
845;146503;146501;03-197;2474;2017;2006;767;1239
846;146503;146501;03-111;1970;1703;1681;587;1094
847;146503;146501;03-142;1701;1519;1503;515;988
848;146503;146501;03-257;2074;1836;1812;663;1149
849;146503;146501;03-289;1220;1001;983;354;629
850;146503;146501;03-287;1442;1247;1233;397;836
851;146503;146501;03-185;2004;1729;1718;573;1145
852;146503;146501;03-188;793;648;643;252;391
853;146503;146501;03-188;1976;1647;1637;596;1041
854;146503;146501;03-187;1411;1231;1218;355;863
855;146503;146501;03-188;1568;1282;1270;429;841
856;146503;146501;03-188;1105;924;915;351;564
857;146503;146501;03-188;916;729;721;309;412
858;146503;146501;03-188;920;773;769;307;462
859;146503;146501;03-044;1761;1534;1518;478;1040
860;146503;146501;03-257;1445;1324;1312;384;928
861;146503;146501;03-287;2009;1727;1703;556;1147
862;146503;146501;03-197;2704;2286;2259;694;1565
863;146503;146501;03-289;2209;1891;1866;679;1187
864;146503;146501;03-188;1099;888;883;334;549
865;146503;146501;03-185;1468;1264;1257;401;856
866;146503;146501;03-187;779;643;640;281;359
867;146503;146501;03-187;1378;1164;1153;416;737
868;146503;146501;03-185;1318;1080;1069;393;676
869;146503;146501;03-185;1444;1196;1179;470;709
870;146503;146501;03-126;2137;1889;1865;568;1297
871;146503;146501;03-111;1742;1536;1519;468;1051
872;146503;146501;03-083;1552;1391;1379;311;1068
873;146503;146501;03-007;1850;1559;1539;547;992
874;146503;146501;03-007;1678;1466;1454;539;915
875;146503;146501;03-042;734;633;629;181;448
876;146503;146501;03-138;1924;1596;1581;466;1115
877;146503;146501;03-138;2121;1808;1789;543;1246
878;146503;146501;03-138;1612;1347;1335;407;928
879;146503;146501;03-138;1877;1609;1595;443;1152
880;146503;146501;03-138;2387;2135;2110;592;1518
881;146503;146501;03-147;1912;1547;1538;554;984
882;146503;146501;03-138;1444;1278;1268;362;906
883;146503;146501;03-142;2736;2323;2290;711;1579
884;146503;146501;03-138;1593;1376;1364;420;944
885;146503;146501;03-147;2301;1869;1853;646;1207
886;146503;146501;03-111;931;799;787;283;504
887;146503;146501;03-257;1729;1507;1491;471;1020
888;146503;146501;03-287;1997;1732;1713;540;1173
889;146503;146501;03-287;1750;1483;1464;340;1124
890;146503;146501;03-138;1571;1375;1366;390;976
891;146503;146501;03-142;1848;1558;1547;472;1075
892;146503;146501;03-185;1108;941;930;330;600
893;146503;146501;03-142;2325;2032;2010;659;1351
894;146503;146501;03-289;2113;1782;1761;562;1199
895;146503;146501;03-044;1483;1260;1241;420;821
896;146503;146501;03-289;1350;1188;1173;294;879
897;146503;146501;03-138;1433;1213;1201;332;869
898;146503;146501;03-138;1447;1253;1247;418;829
899;146503;146501;03-289;2173;1808;1791;580;1211
900;146503;146501;03-042;2344;2005;1984;739;1245
1147;146503;146501;03-016;1230;1072;1049;103;946
1148;146503;146501;03-131;609;150;149;81;68
1149;146503;146501;03-007;72;42;40;23;17
1150;146503;146501;03-159;107;60;60;24;36
771;146504;146501;01-651;1570;1402;1383;418;965
772;146504;146501;01-689;1453;1253;1240;425;815
773;146504;146501;01-682;1671;1435;1424;471;953
774;146504;146501;01-689;1483;1263;1254;383;871
775;146504;146501;01-813;981;803;790;268;522
776;146504;146501;01-870;1760;1436;1420;498;922
777;146504;146501;01-806;2723;2189;2165;723;1442
778;146504;146501;01-831;2378;2019;1995;680;1315
779;146504;146501;01-823;2598;2078;2051;694;1357
780;146504;146501;01-891;1447;1169;1155;394;761
781;146504;146501;01-891;1486;1209;1199;400;799
782;146504;146501;01-874;880;714;706;241;465
783;146504;146501;01-883;1954;1579;1576;596;980
784;146504;146501;01-884;1463;1201;1192;409;783
785;146504;146501;01-835;1247;980;976;390;586
786;146504;146501;01-849;2590;2109;2082;659;1423
787;146504;146501;01-864;2146;1801;1781;596;1185
788;146504;146501;01-864;2160;1714;1692;600;1092
789;146504;146501;01-864;2182;1816;1792;588;1204
790;146504;146501;01-876;2541;2004;1985;715;1270
791;146504;146501;01-876;2236;1926;1912;661;1251
792;146504;146501;01-864;2218;1982;1959;555;1404
793;146504;146501;01-904;2589;2174;2146;828;1318
794;146504;146501;01-922;1678;1400;1389;515;874
795;146504;146501;01-926;2825;2437;2410;786;1624
796;146504;146501;01-922;1123;910;902;317;585
797;146504;146501;01-922;1738;1475;1468;449;1019
798;146504;146501;01-929;2684;2265;2237;767;1470
799;146504;146501;01-957;1434;1124;1103;452;651
800;146504;146501;01-957;1590;1298;1287;476;811
801;146504;146501;01-952;1593;1327;1315;461;854
802;146504;146501;01-952;1145;895;887;316;571
803;146504;146501;01-951;1446;1126;1119;529;590
804;146504;146501;01-963;1970;1452;1442;649;793
805;146504;146501;01-963;1922;1497;1481;545;936
806;146504;146501;01-944;1313;1036;1025;454;571
807;146504;146501;01-980;1667;1419;1405;442;963
808;146504;146501;01-980;2010;1764;1742;466;1276
809;146504;146501;01-893;1770;1514;1499;469;1030
810;146504;146501;01-911;1940;1715;1690;559;1131
811;146504;146501;01-913;1580;1294;1280;431;849
812;146504;146501;01-840;1190;1016;1006;346;660
813;146504;146501;01-910;2355;1983;1969;599;1370
814;146504;146501;01-910;2203;1835;1808;579;1229
815;146504;146501;01-923;1695;1389;1370;473;897
816;146504;146501;01-923;2052;1757;1736;519;1217
817;146504;146501;01-923;2284;1945;1929;609;1320
818;146504;146501;01-934;2379;2018;1997;696;1301
819;146504;146501;01-689;1771;1575;1554;380;1174
820;146504;146501;01-891;1585;1358;1339;382;957
821;146504;146501;01-952;1524;1122;1111;454;657
822;146504;146501;01-944;1627;1201;1193;563;630
823;146504;146501;01-910;2097;1873;1850;467;1383
1146;146504;146501;01-809;386;254;253;111;142
81;146505;146501;02-594;2029;1733;1720;374;1346
82;146505;146501;02-594;2421;2151;2125;374;1751
83;146505;146501;00-793;1569;1289;1273;304;969
84;146505;146501;00-785;1558;1198;1184;353;831
85;146505;146501;02-589;1165;900;886;269;617
86;146505;146501;02-543;1070;921;910;237;673
87;146505;146501;02-502;2469;2094;2069;499;1570
88;146505;146501;02-513;1814;1543;1524;343;1181
89;146505;146501;02-513;1510;1284;1274;277;997
90;146505;146501;02-541;2450;1939;1930;547;1383
91;146505;146501;02-524;1428;1188;1178;261;917
92;146505;146501;02-701;647;514;510;113;397
93;146505;146501;02-519;944;811;800;238;562
94;146505;146501;02-569;2226;1801;1780;510;1270
95;146505;146501;02-587;1500;1224;1209;325;884
96;146505;146501;02-582;1194;1004;994;272;722
97;146505;146501;02-575;1567;1226;1210;351;859
98;146505;146501;02-536;1026;837;825;263;562
99;146505;146501;02-653;2517;2143;2112;616;1496
100;146505;146501;02-653;2413;1955;1934;493;1441
101;146505;146501;02-653;3325;2893;2857;710;2147
102;146505;146501;02-638;1434;1282;1259;320;939
103;146505;146501;02-650;1427;1123;1110;326;784
104;146505;146501;02-645;1674;1344;1323;431;892
105;146505;146501;02-672;1966;1739;1722;465;1257
106;146505;146501;02-672;2000;1678;1660;505;1155
107;146505;146501;02-645;1560;1239;1227;305;922
108;146505;146501;02-610;932;741;738;180;558
109;146505;146501;02-646;1602;1312;1300;399;901
110;146505;146501;02-646;1676;1359;1344;428;916
111;146505;146501;02-614;1425;1190;1183;278;905
112;146505;146501;02-640;1618;1319;1303;430;873
113;146505;146501;02-637;2191;1931;1910;136;1774
114;146505;146501;02-637;1604;1352;1343;310;1033
115;146505;146501;02-621;1177;977;968;258;710
116;146505;146501;02-682;1781;1436;1420;445;975
117;146505;146501;02-682;1824;1569;1555;370;1185
118;146505;146501;02-685;1849;1392;1382;492;890
119;146505;146501;02-693;1897;1667;1656;339;1317
120;146505;146501;02-660;2861;2279;2254;678;1576
121;146505;146501;02-698;1670;1338;1321;396;925
122;146505;146501;02-698;1688;1326;1316;499;817
123;146505;146501;02-697;1445;1106;1100;407;693
124;146505;146501;02-732;2767;2356;2334;615;1719
125;146505;146501;02-743;1804;1543;1527;457;1070
126;146505;146501;02-697;3103;2531;2504;771;1733
127;146505;146501;02-697;2911;2308;2286;722;1564
128;146505;146501;02-637;1631;1360;1344;367;977
129;146505;146501;02-744;2291;1919;1891;560;1331
130;146505;146501;02-739;2287;1912;1899;583;1316
131;146505;146501;02-787;2877;2455;2430;712;1718
132;146505;146501;02-911;768;630;627;248;379
133;146505;146501;02-904;2130;1853;1836;431;1405
134;146505;146501;00-724;2051;1720;1699;450;1249
135;146505;146501;02-716;2968;2629;2601;453;2148
136;146505;146501;02-716;2664;2283;2255;473;1782
137;146505;146501;00-714;1802;1488;1476;428;1048
138;146505;146501;00-774;1889;1562;1551;422;1129
139;146505;146501;05-077;3033;2694;2657;698;1959
140;146505;146501;05-077;2835;2539;2511;613;1898
141;146505;146501;02-911;1215;1053;1042;239;803
142;146505;146501;00-734;1858;1558;1532;495;1037
143;146505;146501;02-943;2515;1997;1985;598;1387
144;146505;146501;00-743;1586;1288;1270;355;915
145;146505;146501;00-765;1723;1352;1338;390;948
146;146505;146501;00-765;1264;1083;1073;331;742
147;146505;146501;00-770;894;703;697;234;463
148;146505;146501;00-722;1561;1246;1226;425;801
149;146505;146501;00-722;1811;1447;1425;393;1032
150;146505;146501;00-737;2384;2033;2008;527;1481
151;146505;146501;00-717;1496;1178;1162;410;752
152;146505;146501;00-719;2177;1801;1780;589;1191
153;146505;146501;02-701;1763;1409;1400;414;986
154;146505;146501;02-747;1516;1308;1296;452;844
155;146505;146501;02-762;2211;1839;1823;551;1272
156;146505;146501;02-762;1902;1580;1567;462;1105
157;146505;146501;02-762;1046;935;932;135;797
158;146505;146501;02-914;2292;1978;1953;593;1360
159;146505;146501;02-758;2630;2301;2275;638;1637
160;146505;146501;02-758;2075;1799;1782;542;1240
161;146505;146501;02-760;1688;1400;1385;446;939
162;146505;146501;02-760;1371;1109;1100;398;702
163;146505;146501;02-933;1954;1709;1693;387;1306
164;146505;146501;02-764;1694;1385;1369;413;956
165;146505;146501;02-942;1638;1342;1330;432;898
166;146505;146501;02-943;2721;2322;2295;680;1615
167;146505;146501;02-930;1507;1204;1195;402;793
168;146505;146501;02-930;1539;1205;1195;384;811
169;146505;146501;02-930;1571;1328;1313;395;918
170;146505;146501;02-589;1098;907;899;232;667
171;146505;146501;02-693;1112;875;863;297;566
172;146505;146501;02-524;1392;1144;1136;268;868
1108;146505;146501;02-730;81;34;31;21;10
1109;146505;146501;02-507;77;65;64;23;41
1110;146505;146501;00-739;115;111;111;47;64
1111;146505;146501;02-957;391;215;211;85;126
1112;146505;146501;02-507;435;343;336;155;181
1113;146505;146501;02-544;56;56;56;23;33
1114;146505;146501;02-637;128;107;104;48;56
1155;146505;146501;00-727;194;76;71;25;46
201;146506;146501;02-315;1238;999;990;330;660
202;146506;146501;02-315;1021;804;794;227;567
203;146506;146501;02-021;1283;1034;1025;295;730
204;146506;146501;02-302;1641;1313;1298;373;925
205;146506;146501;02-302;1172;1172;1157;343;814
206;146506;146501;02-023;846;638;635;231;404
207;146506;146501;02-302;1256;1034;1014;259;755
208;146506;146501;02-034;2091;1807;1785;447;1338
209;146506;146501;02-093;820;639;634;231;403
210;146506;146501;02-094;1008;884;871;319;552
211;146506;146501;02-017;1205;944;935;330;605
212;146506;146501;02-010;1005;833;821;175;646
213;146506;146501;02-067;1210;1025;1013;232;781
214;146506;146501;02-384;1877;1657;1642;358;1284
215;146506;146501;02-384;2220;2004;1978;408;1570
216;146506;146501;02-353;1300;1148;1143;224;919
217;146506;146501;02-353;1830;1548;1536;453;1083
218;146506;146501;02-353;1764;1479;1460;363;1097
219;146506;146501;02-353;1205;987;977;275;702
220;146506;146501;02-340;1658;1288;1273;468;805
221;146506;146501;02-340;2037;1615;1604;495;1109
222;146506;146501;02-365;1412;1102;1086;377;709
223;146506;146501;02-348;1175;916;906;307;599
224;146506;146501;02-381;1726;1414;1401;458;943
225;146506;146501;02-377;903;732;726;271;455
226;146506;146501;02-377;748;608;601;205;396
227;146506;146501;02-381;1169;940;932;318;614
228;146506;146501;02-397;1059;840;832;290;542
229;146506;146501;02-130;1338;1111;1100;375;725
230;146506;146501;02-130;1585;1269;1252;375;877
231;146506;146501;02-106;1875;1501;1484;382;1102
232;146506;146501;02-397;2152;1872;1849;354;1495
233;146506;146501;02-104;1441;1128;1111;461;650
234;146506;146501;02-398;1121;881;869;372;497
235;146506;146501;02-104;1872;1478;1461;518;943
236;146506;146501;02-128;654;559;553;190;363
237;146506;146501;02-106;1466;1160;1149;439;710
238;146506;146501;02-109;1556;1275;1246;383;863
239;146506;146501;02-128;1412;1189;1173;359;814
240;146506;146501;02-128;1548;1305;1291;378;913
241;146506;146501;02-130;1510;1116;1097;316;781
242;146506;146501;02-128;1151;901;893;297;596
243;146506;146501;02-397;1242;1021;1013;259;754
1115;146506;146501;02-034;42;36;36;18;18
1116;146506;146501;02-013;213;156;155;65;90
1117;146506;146501;02-097;305;214;213;97;116
1118;146506;146501;02-315;35;25;25;13;12
1119;146506;146501;02-015;17;13;13;7;6
1120;146506;146501;02-121;88;63;62;30;32
1153;146506;146501;02-097;297;179;177;88;89
401;146507;146501;03-838;1355;1091;1080;401;679
402;146507;146501;03-806;1849;1512;1497;447;1050
403;146507;146501;03-805;2008;1683;1663;490;1173
404;146507;146501;03-836;2827;2441;2407;644;1763
405;146507;146501;04-014;1460;1225;1216;378;838
406;146507;146501;04-393;2527;2127;2106;684;1422
407;146507;146501;04-395;2064;1552;1531;605;926
408;146507;146501;04-386;1635;1272;1266;425;841
409;146507;146501;04-386;2074;1671;1651;582;1069
410;146507;146501;04-386;1555;1233;1224;435;789
411;146507;146501;04-349;1523;1223;1209;429;780
412;146507;146501;04-359;1478;1177;1160;454;706
413;146507;146501;04-359;1303;1093;1084;413;671
414;146507;146501;04-349;1460;1176;1163;447;716
415;146507;146501;04-351;1487;1175;1160;430;730
416;146507;146501;04-349;1859;1552;1534;577;957
417;146507;146501;04-349;1302;1045;1035;375;660
418;146507;146501;04-330;1922;1560;1543;524;1019
419;146507;146501;04-309;1645;1371;1360;515;845
420;146507;146501;04-303;1387;1072;1063;377;686
421;146507;146501;04-294;1492;1313;1299;392;907
422;146507;146501;04-309;1770;1527;1509;469;1040
423;146507;146501;04-205;2180;1840;1818;607;1211
424;146507;146501;04-171;2077;1802;1781;625;1156
425;146507;146501;04-174;1743;1421;1412;552;860
426;146507;146501;04-174;1645;1382;1365;536;829
427;146507;146501;04-173;1552;1144;1131;422;709
428;146507;146501;04-161;1912;1557;1541;540;1001
429;146507;146501;04-173;2295;1929;1912;566;1346
430;146507;146501;04-161;1937;1572;1557;516;1041
431;146507;146501;03-982;1679;1478;1466;358;1108
432;146507;146501;04-110;1809;1449;1437;487;950
433;146507;146501;04-110;1574;1332;1323;457;866
434;146507;146501;04-089;1792;1474;1460;438;1022
435;146507;146501;04-089;1202;992;982;354;628
436;146507;146501;04-063;1554;1255;1240;434;806
437;146507;146501;04-010;1858;1452;1436;511;925
438;146507;146501;04-014;1656;1274;1257;458;799
439;146507;146501;04-062;1614;1286;1267;399;868
440;146507;146501;04-036;2492;2037;2013;707;1306
441;146507;146501;04-022;1195;922;916;318;598
442;146507;146501;04-010;1037;821;809;303;506
443;146507;146501;04-010;1169;883;872;376;496
444;146507;146501;04-044;2213;1942;1928;536;1392
445;146507;146501;04-044;1661;1346;1333;462;871
446;146507;146501;04-044;1595;1286;1277;453;824
447;146507;146501;03-936;918;798;790;173;617
448;146507;146501;03-913;1459;1211;1197;340;857
449;146507;146501;03-914;1454;1142;1132;371;761
450;146507;146501;03-914;1524;1265;1257;346;911
451;146507;146501;03-936;2094;1738;1719;442;1277
452;146507;146501;03-938;1424;1194;1176;352;824
453;146507;146501;03-938;1567;1273;1257;384;873
454;146507;146501;03-913;1059;864;857;236;621
455;146507;146501;03-914;1694;1470;1451;372;1079
456;146507;146501;03-914;1388;1126;1113;351;762
457;146507;146501;03-347;970;751;742;245;497
458;146507;146501;03-973;2158;1830;1809;473;1336
459;146507;146501;03-966;1979;1681;1665;491;1174
460;146507;146501;03-964;1791;1486;1467;470;997
461;146507;146501;03-966;1575;1425;1412;297;1115
462;146507;146501;03-966;1457;1190;1172;380;792
463;146507;146501;03-973;1341;1184;1178;312;866
464;146507;146501;03-983;2044;1731;1720;564;1156
465;146507;146501;03-982;1520;1342;1330;432;898
466;146507;146501;03-982;1830;1584;1572;465;1107
467;146507;146501;03-982;1124;930;922;229;693
468;146507;146501;03-982;1547;1324;1312;462;850
469;146507;146501;03-982;1188;1014;999;285;714
470;146507;146501;03-982;1525;1312;1296;402;894
471;146507;146501;03-982;1336;1104;1096;383;713
472;146507;146501;03-984;1731;1473;1461;469;992
473;146507;146501;03-984;2014;1749;1735;535;1200
474;146507;146501;03-984;1780;1511;1496;459;1037
475;146507;146501;03-980;1885;1656;1645;415;1230
476;146507;146501;03-980;1450;1190;1171;401;770
477;146507;146501;03-982;1411;1208;1197;475;722
478;146507;146501;03-982;1354;1122;1107;306;801
479;146507;146501;03-982;2071;1755;1740;370;1370
480;146507;146501;03-982;1610;1313;1303;447;856
481;146507;146501;03-982;1444;1167;1161;457;704
482;146507;146501;03-982;1071;969;965;219;746
483;146507;146501;03-838;1722;1477;1468;389;1079
484;146507;146501;04-386;1792;1576;1556;436;1120
485;146507;146501;03-982;1455;1299;1283;317;966
1130;146507;146501;04-314;516;423;416;81;335
1131;146507;146501;04-349;834;394;390;183;207
1132;146507;146501;04-073;207;95;95;45;50
1133;146507;146501;03-977;82;44;40;21;19
361;146508;146501;03-301;2328;1849;1824;624;1200
362;146508;146501;03-480;2084;1672;1653;651;1002
363;146508;146501;03-481;1795;1462;1447;553;894
364;146508;146501;03-481;1933;1462;1453;550;903
365;146508;146501;03-473;1209;1013;1005;329;676
366;146508;146501;03-454;1060;829;819;289;530
367;146508;146501;03-438;1335;1053;1047;422;625
368;146508;146501;03-438;1825;1407;1390;469;921
369;146508;146501;03-433;1328;1022;1013;399;614
370;146508;146501;03-454;1748;1271;1259;547;712
371;146508;146501;03-470;1195;952;943;331;612
372;146508;146501;03-450;1337;1022;1009;387;622
373;146508;146501;03-474;754;531;528;216;312
374;146508;146501;03-734;1288;909;898;383;515
375;146508;146501;03-438;1293;912;906;329;577
376;146508;146501;03-418;1448;1205;1194;448;746
377;146508;146501;03-746;1902;1525;1521;637;884
378;146508;146501;03-713;1840;1462;1454;458;996
379;146508;146501;03-719;1231;984;979;356;623
380;146508;146501;03-721;1693;1421;1396;361;1035
381;146508;146501;03-721;1447;1133;1120;411;709
382;146508;146501;03-772;2267;1725;1706;658;1048
383;146508;146501;03-772;1543;1190;1178;487;691
384;146508;146501;03-775;1544;1068;1054;475;579
385;146508;146501;03-746;1178;929;924;378;546
386;146508;146501;03-759;1437;1069;1061;489;572
387;146508;146501;03-759;1439;1025;1010;448;562
388;146508;146501;03-775;1198;892;881;376;505
389;146508;146501;03-741;1764;1347;1330;545;785
390;146508;146501;03-733;1663;1223;1209;466;743
1129;146508;146501;03-401;250;114;113;56;57
971;146509;146501;04-256;1471;1240;1226;542;684
972;146509;146501;04-462;1410;1144;1136;489;647
973;146509;146501;04-450;1692;1370;1355;504;851
974;146509;146501;04-421;1862;1529;1512;652;860
975;146509;146501;04-450;1678;1412;1393;503;890
976;146509;146501;04-421;1081;900;890;320;570
977;146509;146501;00-910;1304;1128;1120;309;811
978;146509;146501;04-408;1613;1324;1308;388;920
979;146509;146501;04-404;748;616;612;233;379
980;146509;146501;04-401;875;698;689;326;363
981;146509;146501;04-485;1335;1089;1082;477;605
982;146509;146501;04-491;1333;1038;1025;394;631
983;146509;146501;04-491;1036;847;836;421;415
984;146509;146501;04-421;1228;1025;1013;407;606
1;146510;146501;00-178;2268;2003;1986;357;1629
2;146510;146501;00-178;1688;1435;1423;317;1106
3;146510;146501;00-179;1615;1306;1297;422;875
4;146510;146501;00-190;2766;2175;2156;691;1465
5;146510;146501;00-201;2771;2184;2164;633;1531
6;146510;146501;00-236;1461;1147;1126;325;801
7;146510;146501;00-217;1439;1075;1059;409;650
8;146510;146501;00-238;1610;1278;1263;424;839
9;146510;146501;00-277;1751;1400;1390;530;860
10;146510;146501;00-163;2524;1980;1959;641;1318
11;146510;146501;00-150;2162;1673;1650;601;1049
12;146510;146501;00-139;2469;1971;1949;591;1358
13;146510;146501;00-133;2422;1914;1889;465;1424
14;146510;146501;00-098;1452;1224;1208;359;849
15;146510;146501;00-318;1679;1368;1346;494;852
16;146510;146501;00-335;1594;1287;1279;411;868
17;146510;146501;00-345;2069;1769;1753;450;1303
18;146510;146501;00-105;2940;2276;2256;700;1556
19;146510;146501;00-052;1480;1131;1113;362;751
20;146510;146501;00-110;3453;2743;2710;839;1871
21;146510;146501;00-519;1881;1431;1418;457;961
22;146510;146501;00-682;1822;1398;1391;482;909
23;146510;146501;00-679;1338;1169;1159;361;798
24;146510;146501;00-546;2641;2160;2138;696;1442
25;146510;146501;00-029;1627;1279;1265;370;895
26;146510;146501;00-375;1781;1374;1364;440;924
27;146510;146501;00-380;2167;1799;1780;482;1298
28;146510;146501;00-458;2133;1673;1655;517;1138
29;146510;146501;00-402;1890;1537;1521;424;1097
30;146510;146501;00-406;2571;2182;2163;624;1539
31;146510;146501;00-459;1785;1484;1473;415;1058
32;146510;146501;00-446;2808;2300;2282;668;1614
33;146510;146501;00-528;2380;1855;1832;587;1245
34;146510;146501;00-665;2642;2103;2085;661;1424
35;146510;146501;00-574;1995;1612;1601;461;1140
36;146510;146501;00-550;2525;1998;1968;560;1408
37;146510;146501;00-625;1907;1581;1555;448;1107
38;146510;146501;00-591;1646;1320;1300;401;899
39;146510;146501;00-464;2703;2138;2118;605;1513
1100;146510;146501;00-224;94;41;37;20;17
1101;146510;146501;00-322;99;26;26;14;12
1102;146510;146501;00-394;70;40;38;23;15
1103;146510;146501;00-315;41;38;36;17;19
1104;146510;146501;00-189;16;16;16;6;10
1105;146510;146501;00-665;201;93;89;42;47
1106;146510;146501;00-416;111;111;107;59;48
1107;146510;146501;00-152;76;51;51;33;18
901;146511;146501;03-592;1781;1485;1476;547;929
902;146511;146501;03-611;2375;2048;2009;709;1300
903;146511;146501;03-611;2318;1862;1846;818;1028
904;146511;146501;03-611;2198;1871;1858;627;1231
905;146511;146501;03-886;2653;2214;2191;761;1430
906;146511;146501;03-611;1989;1636;1625;714;911
907;146511;146501;03-592;1430;1182;1173;461;712
908;146511;146501;03-563;2118;1697;1672;692;980
909;146511;146501;03-563;2453;1896;1876;725;1151
910;146511;146501;03-535;1441;1166;1161;407;754
911;146511;146501;03-550;2081;1687;1671;620;1051
912;146511;146501;03-536;1338;1030;1022;376;646
913;146511;146501;03-550;2202;1721;1706;632;1074
914;146511;146501;03-503;2086;1616;1594;629;965
915;146511;146501;03-503;2231;1691;1670;610;1060
916;146511;146501;03-550;2242;1680;1668;641;1027
917;146511;146501;03-358;1176;938;930;431;499
918;146511;146501;03-358;2196;1718;1706;715;991
919;146511;146501;03-390;2572;1994;1977;824;1153
920;146511;146501;03-371;1553;1205;1193;538;655
921;146511;146501;03-358;1965;1534;1521;642;879
922;146511;146501;03-243;2048;1520;1506;643;863
923;146511;146501;03-243;1999;1565;1550;644;906
924;146511;146501;03-358;1537;1230;1219;462;757
925;146511;146501;03-379;1521;1278;1269;407;862
926;146511;146501;03-390;705;570;566;206;360
927;146511;146501;03-358;2152;1781;1762;650;1112
928;146511;146501;03-329;1528;1189;1178;467;711
929;146511;146501;03-291;1946;1408;1390;638;752
930;146511;146501;03-329;1513;1182;1171;440;731
931;146511;146501;03-329;1587;1245;1234;538;696
932;146511;146501;03-341;1514;1219;1203;480;723
933;146511;146501;03-379;1682;1307;1299;491;808
934;146511;146501;03-341;1862;1657;1631;417;1214
935;146511;146501;03-531;1422;1154;1149;396;753
936;146511;146501;03-254;1710;1319;1307;571;736
937;146511;146501;03-252;1600;1221;1214;503;711
938;146511;146501;03-254;1764;1424;1414;564;850
939;146511;146501;03-254;2131;1692;1679;706;973
940;146511;146501;03-254;1474;1210;1200;499;701
941;146511;146501;03-254;2005;1482;1469;650;819
942;146511;146501;03-252;1495;1181;1170;463;707
943;146511;146501;03-397;1721;1420;1403;492;911
944;146511;146501;03-531;1887;1704;1687;463;1224
945;146511;146501;03-886;2024;1739;1709;545;1164
946;146511;146501;03-592;1305;1109;1100;358;742
947;146511;146501;03-535;1311;1037;1028;371;657
948;146511;146501;03-536;1294;1042;1031;393;638
949;146511;146501;03-358;1410;1119;1108;453;655
950;146511;146501;03-379;1755;1434;1416;494;922
951;146511;146501;03-531;1532;1354;1339;348;991
952;146511;146501;03-252;1197;952;943;392;551
1151;146511;146501;03-242;446;149;146;72;74
681;146512;146501;02-495;1788;1429;1411;623;788
682;146512;146501;02-495;2148;1814;1793;656;1137
683;146512;146501;02-495;1302;1006;1000;464;536
684;146512;146501;02-495;683;557;553;268;285
685;146512;146501;02-495;1471;1253;1241;588;653
686;146512;146501;02-496;2056;1754;1736;710;1026
687;146512;146501;02-495;1097;900;888;351;537
688;146512;146501;02-495;1802;1436;1421;566;855
689;146512;146501;02-495;1517;1176;1162;480;682
690;146512;146501;02-495;985;738;727;318;409
691;146512;146501;02-495;1953;1630;1609;528;1081
692;146512;146501;02-495;2178;1804;1782;785;997
693;146512;146501;02-495;1963;1628;1613;662;951
694;146512;146501;02-495;2015;1611;1598;646;952
695;146512;146501;02-495;1780;1573;1555;401;1154
696;146512;146501;02-495;2494;2166;2145;577;1568
697;146512;146501;02-495;1320;1127;1112;359;753
698;146512;146501;02-495;1544;1209;1199;567;632
699;146512;146501;02-495;1897;1625;1607;531;1076
700;146512;146501;02-496;1835;1596;1581;618;963
701;146512;146501;02-495;2024;1790;1771;536;1235
702;146512;146501;02-495;2144;1787;1770;579;1191
703;146512;146501;02-496;3005;2647;2610;788;1822
704;146512;146501;02-495;1263;1103;1092;346;746
705;146512;146501;02-495;1112;958;947;264;683
706;146512;146501;02-495;2076;1858;1839;459;1380
707;146512;146501;02-495;1478;1161;1148;569;579
708;146512;146501;02-495;1471;1173;1159;488;671
709;146512;146501;02-496;2074;1779;1748;572;1176
571;146513;146501;02-787;1953;1625;1609;395;1214
572;146513;146501;02-787;1687;1452;1434;376;1058
573;146513;146501;02-787;2518;2215;2184;607;1577
574;146513;146501;02-785;1378;1227;1209;352;857
575;146513;146501;02-785;1703;1435;1423;416;1007
576;146513;146501;02-785;1462;1238;1223;383;840
577;146513;146501;02-784;1149;938;925;301;624
578;146513;146501;02-787;1821;1581;1567;372;1195
579;146513;146501;02-787;1208;1002;992;320;672
580;146513;146501;02-786;1547;1316;1303;365;938
581;146513;146501;02-784;1558;1326;1312;434;878
582;146513;146501;02-784;1583;1353;1342;394;948
583;146513;146501;02-784;1974;1677;1659;491;1168
584;146513;146501;02-784;1459;1258;1247;324;923
585;146513;146501;02-784;1644;1429;1416;423;993
586;146513;146501;02-786;1172;989;983;340;643
587;146513;146501;02-786;763;644;640;182;458
588;146513;146501;02-784;1798;1594;1583;374;1209
589;146513;146501;02-776;1958;1698;1677;352;1325
590;146513;146501;02-776;1658;1449;1432;441;991
591;146513;146501;02-776;1683;1395;1385;453;932
592;146513;146501;02-776;1602;1330;1312;415;897
593;146513;146501;02-777;1196;1003;995;311;684
594;146513;146501;02-777;1634;1360;1347;428;919
595;146513;146501;02-777;2033;1773;1752;497;1255
596;146513;146501;02-777;2298;2177;2149;512;1637
597;146513;146501;02-776;1929;1665;1651;481;1170
598;146513;146501;02-776;1813;1584;1563;449;1114
599;146513;146501;02-776;1904;1722;1712;551;1161
600;146513;146501;02-777;1180;1008;998;279;719
601;146513;146501;02-777;1483;1268;1253;387;866
602;146513;146501;02-777;1391;1156;1147;342;805
603;146513;146501;02-777;1317;1144;1132;327;805
604;146513;146501;02-793;1880;1645;1614;456;1158
605;146513;146501;02-791;1779;1562;1546;394;1152
606;146513;146501;02-791;1994;1706;1687;504;1183
607;146513;146501;02-791;1920;1647;1630;342;1288
608;146513;146501;02-791;1510;1303;1283;300;983
609;146513;146501;02-796;2138;1883;1865;440;1425
610;146513;146501;02-796;1621;1382;1370;394;976
611;146513;146501;02-796;1452;1273;1259;279;980
612;146513;146501;02-796;1582;1364;1346;313;1033
613;146513;146501;02-793;1379;1284;1271;223;1048
614;146513;146501;02-793;1854;1627;1605;440;1165
615;146513;146501;02-793;1569;1367;1347;369;978
616;146513;146501;02-793;2092;1837;1825;508;1317
617;146513;146501;02-793;2269;2044;2029;511;1518
618;146513;146501;02-793;1680;1497;1482;313;1169
619;146513;146501;02-793;2510;2250;2227;462;1765
620;146513;146501;02-793;2022;1735;1724;498;1226
621;146513;146501;02-798;1956;1799;1763;422;1341
622;146513;146501;02-798;1908;1696;1679;367;1312
623;146513;146501;02-798;2106;1907;1882;446;1436
624;146513;146501;02-796;2317;2070;2047;467;1580
625;146513;146501;02-796;2115;1931;1911;459;1452
626;146513;146501;02-868;2357;2040;2018;617;1401
627;146513;146501;02-838;2078;1770;1755;551;1204
628;146513;146501;02-829;1372;1211;1204;275;929
629;146513;146501;02-829;2920;2387;2366;681;1685
630;146513;146501;02-793;2143;1943;1925;415;1510
631;146513;146501;02-838;1814;1553;1536;460;1076
632;146513;146501;02-776;1118;1014;999;190;809
633;146513;146501;02-829;1566;1308;1294;403;891
634;146513;146501;02-699;1978;1754;1736;484;1252
635;146513;146501;02-699;1062;961;948;245;703
1138;146513;146501;02-776;85;69;69;32;37
1139;146513;146501;02-781;244;195;194;81;113
1140;146513;146501;02-699;776;623;611;97;514
1141;146513;146501;02-781;113;88;88;26;62
1142;146513;146501;02-781;30;13;13;4;9
501;146514;146501;04-551;1899;1590;1570;551;1019
502;146514;146501;04-551;1907;1491;1475;631;844
503;146514;146501;04-526;2128;1698;1674;698;976
504;146514;146501;04-501;1644;1397;1382;509;873
505;146514;146501;04-564;1620;1327;1318;586;732
506;146514;146501;04-539;1385;1199;1185;508;677
507;146514;146501;03-987;1712;1522;1505;486;1019
508;146514;146501;04-760;1995;1717;1695;688;1007
509;146514;146501;04-648;1330;1141;1129;391;738
510;146514;146501;04-686;2005;1688;1667;613;1054
511;146514;146501;04-687;1526;1308;1296;505;791
512;146514;146501;03-991;1060;929;921;281;640
513;146514;146501;03-991;1678;1479;1465;499;966
514;146514;146501;04-870;2588;2228;2204;719;1485
515;146514;146501;04-870;2385;2102;2084;648;1436
516;146514;146501;04-621;1026;878;867;294;573
517;146514;146501;04-628;984;858;851;286;565
518;146514;146501;04-760;2019;1720;1703;648;1055
519;146514;146501;04-703;1614;1435;1417;534;883
520;146514;146501;04-703;1464;1221;1213;427;786
521;146514;146501;04-855;1569;1397;1384;564;820
522;146514;146501;04-814;717;626;616;194;422
523;146514;146501;04-831;1905;1670;1651;538;1113
524;146514;146501;04-840;1779;1449;1433;519;914
525;146514;146501;04-961;1215;1034;1021;444;577
526;146514;146501;04-908;1309;1096;1086;404;682
527;146514;146501;04-908;1214;1025;1009;359;650
528;146514;146501;04-965;2388;2083;2057;887;1170
529;146514;146501;04-984;1616;1371;1360;510;850
530;146514;146501;04-984;1669;1389;1376;581;795
531;146514;146501;04-923;1307;1111;1097;419;678
532;146514;146501;03-987;1711;1496;1483;514;969
533;146514;146501;03-991;1499;1308;1299;481;818
534;146514;146501;03-994;1707;1496;1476;441;1035
535;146514;146501;04-621;1133;951;948;342;606
536;146514;146501;04-628;1141;924;911;304;607
537;146514;146501;04-719;1469;1228;1213;496;717
538;146514;146501;04-860;1286;1109;1101;460;641
539;146514;146501;04-921;793;660;650;247;403
540;146514;146501;04-961;1116;949;939;342;597
1134;146514;146501;04-628;228;151;147;70;77
1135;146514;146501;04-749;223;117;116;52;64
1136;146514;146501;04-837;153;45;45;34;11
1154;146514;146501;04-697;140;125;123;59;64
1001;146515;146501;05-075;1289;1098;1089;354;735
1002;146515;146501;05-075;1343;1149;1137;456;681
1003;146515;146501;05-075;1708;1431;1414;599;815
1004;146515;146501;05-075;1420;1222;1202;496;706
1005;146515;146501;05-075;1372;1149;1133;459;674
1006;146515;146501;05-075;1168;985;976;392;584
1007;146515;146501;05-077;1254;1085;1074;405;669
1008;146515;146501;05-077;1102;935;920;319;601
1009;146515;146501;05-077;1879;1618;1590;588;1002
1010;146515;146501;05-077;1428;1272;1255;385;870
1011;146515;146501;05-075;1567;1272;1264;520;744
1012;146515;146501;05-077;1227;1091;1084;347;737
1013;146515;146501;05-077;1172;1038;1027;339;688
1014;146515;146501;05-077;1657;1439;1431;446;985
1152;146515;146501;05-075;39;26;26;10;16
550;146516;146501;02-972;1101;1009;1000;174;826
551;146516;146501;02-990;1291;1162;1154;216;938
552;146516;146501;02-956;932;783;778;247;531
553;146516;146501;02-956;1115;919;910;272;638
554;146516;146501;02-956;1487;1296;1290;255;1035
555;146516;146501;02-952;1691;1434;1423;435;988
556;146516;146501;02-987;1793;1613;1600;357;1243
557;146516;146501;02-968;1301;1148;1138;316;822
558;146516;146501;02-797;2172;1957;1941;301;1640
559;146516;146501;02-967;761;640;637;272;365
560;146516;146501;02-972;1899;1703;1692;315;1377
561;146516;146501;02-972;2518;2243;2227;432;1795
562;146516;146501;02-972;1558;1415;1399;201;1198
563;146516;146501;02-990;1553;1407;1401;369;1032
564;146516;146501;02-956;1484;1259;1250;350;900
565;146516;146501;02-968;1297;1161;1154;356;798
566;146516;146501;02-972;1231;1114;1108;177;931
567;146516;146501;02-972;1149;1034;1026;251;775
568;146516;146501;02-972;2363;2125;2108;405;1703
569;146516;146501;02-972;1940;1752;1738;325;1413
570;146516;146501;02-972;1854;1670;1654;345;1309
1137;146516;146501;02-972;44;34;34;14;20
651;146517;146501;02-441;1529;1308;1295;407;888
652;146517;146501;02-421;885;736;731;262;469
653;146517;146501;02-428;896;712;708;272;436
654;146517;146501;02-407;1756;1468;1444;454;990
655;146517;146501;02-421;1685;1409;1396;488;908
656;146517;146501;02-482;1397;1204;1182;338;844
657;146517;146501;02-479;1337;1337;1320;394;926
658;146517;146501;02-479;1645;1418;1396;340;1056
659;146517;146501;02-462;1788;1521;1507;506;1001
660;146517;146501;02-463;2149;1836;1823;594;1229
661;146517;146501;02-492;1570;1330;1315;399;916
662;146517;146501;02-492;1496;1267;1247;342;905
663;146517;146501;02-133;3683;3223;3180;993;2187
664;146517;146501;02-266;762;622;613;257;356
665;146517;146501;02-272;1174;968;954;418;536
666;146517;146501;02-272;754;650;641;293;348
667;146517;146501;02-172;664;548;540;203;337
668;146517;146501;02-154;921;744;737;279;458
669;146517;146501;02-154;1395;1147;1137;393;744
670;146517;146501;02-172;1229;966;954;371;583
671;146517;146501;02-156;722;568;561;226;335
672;146517;146501;02-137;1059;906;894;274;620
673;146517;146501;02-137;872;680;675;252;423
674;146517;146501;02-139;1292;1068;1054;313;741
675;146517;146501;02-134;1363;1053;1035;407;628
676;146517;146501;02-237;2643;2318;2283;627;1656
261;146518;146501;01-423;1405;1049;1042;433;609
262;146518;146501;01-423;1552;1199;1187;429;758
263;146518;146501;01-451;1998;1654;1635;569;1066
264;146518;146501;01-407;1708;1381;1375;496;879
265;146518;146501;01-409;2615;2097;2078;753;1325
266;146518;146501;01-451;1741;1266;1251;499;752
267;146518;146501;01-423;984;770;762;269;493
268;146518;146501;01-111;2467;2004;1984;674;1310
269;146518;146501;01-111;2630;2225;2194;653;1541
270;146518;146501;01-112;1236;997;984;381;603
271;146518;146501;01-111;1193;921;914;379;535
272;146518;146501;01-122;1885;1430;1420;533;887
273;146518;146501;01-128;1400;1031;1025;403;622
274;146518;146501;01-111;1684;1348;1335;454;881
275;146518;146501;01-106;2252;1831;1814;549;1265
276;146518;146501;01-236;2678;2245;2221;853;1368
277;146518;146501;01-106;1957;1704;1685;473;1212
278;146518;146501;01-122;1904;1495;1480;465;1015
279;146518;146501;01-250;2778;1882;1860;432;1428
280;146518;146501;01-248;3355;2938;2906;727;2179
281;146518;146501;01-226;1751;1427;1412;449;963
282;146518;146501;01-141;1397;1135;1121;376;745
283;146518;146501;01-167;2755;2537;2503;547;1956
284;146518;146501;01-167;2449;2000;1978;651;1327
285;146518;146501;01-154;1682;1314;1301;489;812
286;146518;146501;01-154;1653;1274;1262;474;788
287;146518;146501;01-163;1428;1078;1071;369;702
288;146518;146501;01-183;1443;1110;1094;406;688
289;146518;146501;01-148;1418;1080;1067;372;695
290;146518;146501;01-132;1961;1589;1577;449;1128
291;146518;146501;01-132;1592;1321;1302;541;761
292;146518;146501;01-184;1652;1294;1280;464;816
293;146518;146501;01-211;1579;1297;1286;428;858
294;146518;146501;01-206;3184;2739;2704;659;2045
295;146518;146501;01-043;2937;2325;2304;703;1601
296;146518;146501;01-172;1848;1317;1309;488;821
297;146518;146501;01-181;1477;1104;1095;340;755
298;146518;146501;01-038;1622;1308;1295;434;861
299;146518;146501;00-049;2633;2096;2076;651;1425
300;146518;146501;01-051;1382;1115;1106;333;773
301;146518;146501;01-049;1765;1424;1406;470;936
302;146518;146501;01-051;1882;1444;1432;493;939
303;146518;146501;01-018;1825;1474;1461;467;994
304;146518;146501;01-018;1911;1613;1597;527;1070
305;146518;146501;01-211;2514;2071;2049;518;1531
306;146518;146501;01-197;1244;987;976;268;708
307;146518;146501;00-871;1824;1475;1467;391;1076
308;146518;146501;00-876;1618;1249;1233;425;808
309;146518;146501;00-876;1414;1113;1098;362;736
310;146518;146501;00-896;1439;1166;1159;361;798
311;146518;146501;00-855;2100;1640;1627;507;1120
312;146518;146501;00-855;1950;1543;1525;452;1073
313;146518;146501;00-808;2386;1894;1869;647;1222
314;146518;146501;00-814;1687;1258;1248;440;808
315;146518;146501;00-814;1498;1188;1178;418;760
316;146518;146501;01-262;2278;2015;1997;484;1513
317;146518;146501;01-262;2106;1850;1829;428;1401
318;146518;146501;01-248;1687;1506;1486;387;1099
1121;146518;146501;01-128;56;36;34;15;19
1122;146518;146501;01-119;48;38;38;22;16
1123;146518;146501;01-155;129;55;54;29;25
1124;146518;146501;01-138;184;130;128;49;79
1125;146518;146501;01-201;71;62;60;21;39
1126;146518;146501;01-211;278;155;151;64;87
1127;146518;146501;01-004;55;51;51;24;27
1128;146518;146501;01-401;41;32;30;22;8
331;146519;146501;01-641;1807;1443;1428;440;988
332;146519;146501;01-647;2137;1870;1850;548;1302
333;146519;146501;01-630;1876;1637;1622;517;1105
334;146519;146501;01-647;1851;1620;1608;340;1268
335;146519;146501;01-611;1939;1570;1550;440;1110
336;146519;146501;01-710;1562;1307;1290;388;902
337;146519;146501;01-773;2510;2083;2062;644;1418
338;146519;146501;01-582;2581;2219;2197;555;1642
339;146519;146501;01-786;1639;1303;1286;410;876
340;146519;146501;01-756;2640;2175;2146;686;1460
341;146519;146501;01-737;2653;2213;2188;726;1462
342;146519;146501;01-737;2386;2112;2095;458;1637
343;146519;146501;01-794;2434;2193;2167;458;1709
344;146519;146501;01-794;2087;1920;1895;327;1568
345;146519;146501;01-794;2139;2007;1992;315;1677
346;146519;146501;01-577;1038;858;851;273;578
347;146519;146501;01-530;1022;867;859;194;665
348;146519;146501;01-507;2338;1975;1956;594;1362
349;146519;146501;01-513;2354;1967;1940;500;1440
350;146519;146501;01-524;2101;1708;1684;571;1113
351;146519;146501;01-786;897;742;737;232;505
1000;;;;25;24;23;1;22
1001;;;;42;42;41;16;25
1002;;;;46;35;35;17;18
1003;;;;41;30;28;12;16
1004;;;;50;45;45;21;24
1;;;;1212;1027;1024;255;769
2;;;;69;60;59;17;42
3;;;;199;157;154;27;127
4;;;;238;179;179;67;112
5;;;;171;150;148;55;93
6;;;;183;162;162;47;115
7;;;;1887;1613;1607;457;1150
8;;;;341;294;294;120;174
9;;;;619;498;495;117;378
10;;;;68;60;60;15;45
11;;;;1147;1007;998;384;614
12;;;;584;505;501;170;331
13;;;;1804;1549;1544;553;991
14;;;;1684;1419;1410;540;870
15;;;;1822;1530;1522;545;977
16;;;;2085;2085;2070;729;1341
17;;;;1726;1432;1429;561;868
18;;;;2357;1987;1974;864;1110
19;;;;703;616;611;207;404
20;;;;896;738;733;232;501
21;;;;866;726;718;291;427
22;;;;805;694;690;168;522
23;;;;114;98;98;17;81
24;;;;1929;1719;1709;692;1017
25;;;;1597;1427;1420;471;949
26;;;;1195;1069;1064;224;840
27;;;;1209;1086;1078;237;841
28;;;;1162;1028;1019;243;776
29;;;;2185;1951;1944;1081;863
30;;;;1300;1144;1138;389;749
31;;;;1115;974;967;352;615
32;;;;2608;2134;2121;949;1172
33;;;;1944;1944;1936;954;982
34;;;;590;526;525;210;315
35;;;;3359;2561;2551;1190;1361
36;;;;2082;1678;1672;663;1009
37;;;;155;113;108;51;57
38;;;;372;372;370;199;171
39;;;;551;455;450;89;361
40;;;;1215;1086;1078;328;750
41;;;;48;44;44;19;25
42;;;;66;56;55;29;26
43;;;;114;87;87;20;67
44;;;;385;311;307;60;247
45;;;;290;239;236;33;203
46;;;;147;116;115;34;81
47;;;;439;343;342;64;278
48;;;;503;456;453;119;334
49;;;;1388;1291;1286;415;871
50;;;;950;762;760;174;586
51;;;;1358;1223;1216;321;895
52;;;;1917;1756;1748;340;1408
53;;;;136;111;109;29;80
54;;;;2404;1944;1930;411;1519
55;;;;791;659;655;154;501
56;;;;2311;2062;2041;340;1701
57;;;;1790;1790;1778;283;1495
58;;;;525;459;456;133;323
59;;;;2824;2240;2229;846;1383
60;;;;3344;2906;2892;455;2437
61;;;;1148;896;888;312;576
62;;;;2530;1936;1927;572;1355
63;;;;2157;1699;1696;570;1126
64;;;;1759;1384;1379;609;770
65;;;;113;105;102;38;64
66;;;;86;60;60;9;51
67;;;;254;216;213;51;162
68;;;;1431;1140;1137;246;891
69;;;;360;297;297;75;222
70;;;;390;350;344;88;256
71;;;;24;22;22;6;16
72;;;;113;93;93;28;65
73;;;;1135;966;961;182;779
74;;;;160;124;124;31;93
75;;;;435;365;362;116;246
76;;;;3195;2875;2860;879;1981
77;;;;2810;2399;2378;729;1649
78;;;;2469;2134;2125;748;1377
79;;;;2448;2069;2044;654;1390
80;;;;1075;913;909;439;470
81;;;;1328;1099;1094;678;416
82;;;;370;308;306;71;235
83;;;;1241;1071;1067;526;541
84;;;;387;324;322;132;190
85;;;;772;666;664;239;425
86;;;;1454;1236;1229;416;813
87;;;;247;198;198;64;134
88;;;;1739;1426;1382;395;987
89;;;;950;796;792;210;582
90;;;;209;177;174;54;120
91;;;;587;494;489;113;376
92;;;;251;210;208;39;169
93;;;;515;443;442;87;355
94;;;;1788;1524;1512;345;1167
95;;;;743;638;633;231;402
96;;;;2119;2119;2103;538;1565
97;;;;2249;1861;1855;363;1492
98;;;;2191;1929;1923;428;1495
99;;;;963;793;791;190;601
100;;;;457;392;386;90;296
101;;;;1063;959;952;360;592
102;;;;1232;1081;1074;225;849
103;;;;1473;1262;1254;355;899
104;;;;934;798;788;143;645
105;;;;1094;963;960;199;761
106;;;;978;843;840;162;678
107;;;;1676;1460;1452;218;1234
108;;;;1628;1432;1424;219;1205
109;;;;1598;1385;1374;193;1181
110;;;;451;361;361;69;292
111;;;;952;777;773;163;610
112;;;;1863;1597;1586;187;1399
113;;;;1982;1748;1740;223;1517
114;;;;1953;1705;1688;229;1459
115;;;;1792;1612;1605;229;1376
116;;;;1776;1602;1598;264;1334
117;;;;1736;1563;1549;239;1310
118;;;;2301;2300;2292;434;1858
119;;;;362;289;286;92;194
120;;;;2264;1985;1971;299;1672
121;;;;129;107;107;13;94
122;;;;67;54;54;8;46
123;;;;69;58;58;10;48
124;;;;564;435;434;33;401
125;;;;0;0;0;0;0
126;;;;37;34;34;6;28
127;;;;1179;1174;1167;382;785
128;;;;2262;1918;1907;613;1294
129;;;;2073;1704;1691;580;1111
130;;;;2556;2127;2110;873;1237
131;;;;2537;2113;2091;837;1254
132;;;;1281;1002;997;337;660
133;;;;1918;1562;1547;606;941
134;;;;2206;1788;1779;712;1067
135;;;;2168;1742;1719;679;1040
136;;;;2145;1768;1755;605;1150
137;;;;997;852;838;280;558
138;;;;2141;1759;1743;703;1040
139;;;;518;459;459;173;286
140;;;;2355;1944;1927;767;1160
141;;;;2484;1956;1943;809;1134
142;;;;2037;1627;1613;812;801
143;;;;646;492;489;177;312
144;;;;206;151;149;79;70
145;;;;1389;1150;1139;588;551
146;;;;463;347;344;90;254
147;;;;593;496;485;91;394
148;;;;1653;1388;1375;213;1162
149;;;;575;506;502;50;452
150;;;;191;155;153;43;110
151;;;;899;779;775;359;416
152;;;;1157;998;991;431;560
153;;;;132;105;102;33;69
154;;;;1344;1196;1186;706;480
155;;;;1333;1163;1150;670;480
156;;;;422;363;361;243;118
157;;;;992;874;867;583;284
158;;;;1018;891;888;586;302
159;;;;2265;2015;2005;1544;461
160;;;;2242;1975;1960;1442;518
161;;;;350;308;304;208;96
162;;;;292;246;246;149;97
163;;;;680;569;564;349;215
164;;;;872;712;707;283;424
165;;;;870;718;709;364;345
166;;;;790;679;674;417;257
167;;;;46;36;35;23;12
168;;;;277;243;242;43;199
169;;;;99;96;96;41;55
170;;;;120;113;111;40;71
171;;;;105;79;79;15;64
172;;;;92;71;69;26;43
173;;;;772;613;609;97;512
174;;;;319;302;297;221;76
175;;;;48;29;29;10;19
176;;;;109;96;95;13;82
177;;;40-215;115;105;104;35;69
178;;;;0;0;0;0;0
179;;;;791;791;785;275;510
180;;;;2056;1797;1788;430;1358
181;;;;2084;1802;1791;417;1374
182;;;;705;622;616;252;364
183;;;;149;135;134;25;109
184;;;;219;166;160;25;135
185;;;;3276;2852;2831;661;2170
186;;;;166;142;139;27;112
187;;;;423;389;388;52;336
188;;;;55;45;45;12;33
189;;;;326;256;255;37;218
190;;;;178;103;103;22;81
191;;;;225;189;185;59;126
192;;;;42;42;41;8;33
193;;;;141;115;115;15;100
194;;;;291;235;233;32;201
195;;;;2435;1876;1866;725;1141
196;;;;2421;1901;1886;709;1177
197;;;;2451;1906;1900;670;1230
198;;;;2513;1993;1976;738;1238
199;;;;2460;1882;1876;672;1204
200;;;;2776;2144;2130;564;1566
201;;;;2734;2112;2099;496;1603
202;;;;2696;2073;2061;547;1514
203;;;;2893;2256;2241;572;1669
204;;;;2745;2046;2032;853;1179
205;;;;2894;2093;2081;899;1182
206;;;;2766;2012;2001;839;1162
207;;;;2744;2002;1992;874;1118
208;;;;3354;2650;2638;999;1639
209;;;;2456;1789;1775;600;1175
210;;;;2196;1955;1948;358;1590
211;;;;2000;1727;1715;324;1391
212;;;;2054;1800;1792;265;1527
213;;;;2816;2413;2406;669;1737
214;;;;2000;1776;1766;195;1571
215;;;;1991;1699;1691;269;1422
216;;;;1832;1553;1549;357;1192
217;;;;1472;1056;1049;280;769
218;;;;1813;1813;1808;609;1199
219;;;;1444;1206;1201;346;855
220;;;;2060;1872;1864;612;1252
221;;;;2166;1796;1793;527;1266
222;;;;1172;1172;1168;380;788
223;;;;1507;1219;1212;370;842
224;;;;1879;1578;1573;587;986
225;;;;2065;1718;1708;623;1085
226;;;;1516;1516;1510;464;1046
227;;;;1347;1041;1040;463;577
228;;;;2222;1793;1786;592;1194
229;;;;2898;2347;2343;1038;1305
230;;;;1057;902;900;227;673
231;;;;1697;1697;1696;771;925
232;;;;2816;2331;2324;773;1551
233;;;;2711;2236;2227;716;1511
234;;;;2659;2182;2174;799;1375
235;;;;1957;1606;1597;667;930
236;;;;1946;1579;1575;673;902
237;;;;3245;2667;2661;1047;1614
238;;;;2477;2055;2052;788;1264
239;;;;2436;2001;1995;763;1232
240;;;;2955;2486;2475;898;1577
241;;;;2884;2381;2367;825;1542
242;;;;2062;1713;1707;675;1032
243;;;;1994;1738;1729;666;1063
244;;;;2362;1956;1955;563;1392
245;;;;2385;1962;1947;563;1384
246;;;;2974;2492;2486;1268;1218
247;;;;2016;1638;1633;663;970
248;;;;3606;2852;2837;1332;1505
249;;;;2073;1882;1876;739;1137
250;;;;2174;1833;1824;638;1186
251;;;;2074;1739;1733;758;975
252;;;;2313;1892;1887;780;1107
253;;;;2247;1841;1832;766;1066
254;;;;2162;1864;1859;730;1129
255;;;;2200;1776;1764;651;1113
256;;;;2238;1771;1762;565;1197
257;;;;2197;1731;1724;529;1195
258;;;;2278;1872;1870;675;1195
259;;;;2150;1732;1725;560;1165
260;;;;2281;1800;1792;692;1100
261;;;;2211;1746;1741;672;1069
262;;;;2674;2098;2085;753;1332
263;;;;2738;2186;2181;772;1409
264;;;;26;22;22;4;18
265;;;;2142;1778;1767;760;1007
266;;;;1869;1528;1524;540;984
267;;;;1859;1573;1563;508;1055
268;;;;1878;1563;1551;603;948
269;;;;2073;1744;1738;749;989
270;;;;1420;1234;1228;401;827
271;;;;416;338;332;117;215
272;;;;3687;3067;3054;1442;1612
273;;;;1253;1104;1098;490;608
274;;;;1272;1055;1050;367;683
275;;;;2899;2378;2361;1031;1330
276;;;;2598;2176;2159;938;1221
277;;;;2233;1924;1915;924;991
278;;;;2178;1800;1795;891;904
279;;;;1757;1443;1432;560;872
280;;;;675;553;546;190;356
281;;;;1961;1567;1561;642;919
282;;;;72;65;63;9;54
283;;;;64;49;47;14;33
284;;;44-000;34;29;28;4;24
285;;;;197;134;132;31;101
286;;;;346;279;275;127;148
287;;;;226;201;198;49;149
288;;;;2058;1810;1804;286;1518
289;;;;918;812;806;127;679
290;;;;1651;1492;1479;293;1186
291;;;;1532;1332;1323;273;1050
292;;;;169;132;127;46;81
293;;;;741;615;602;226;376
294;;;;38;34;34;13;21
295;;;;362;310;308;82;226
296;;;;490;425;421;61;360
297;;;;948;868;860;192;668
298;;;;797;726;719;133;586
299;;;;1376;1137;1135;285;850
300;;;;113;78;76;34;42
301;;;;969;829;826;483;343
302;;;;429;352;350;114;236
303;;;;885;780;776;312;464
304;;;;530;439;433;133;300
305;;;;131;111;107;28;79
306;;;;701;622;618;139;479
307;;;;804;730;728;635;93
308;;;;2196;1986;1972;1624;348
309;;;;497;421;415;251;164
310;;;;670;604;600;469;131
311;;;;1346;1203;1200;898;302
312;;;;1347;1183;1170;704;466
313;;;;1893;1685;1676;1357;319
314;;;;276;250;250;120;130
315;;;;1739;1571;1565;1187;378
316;;;;967;871;868;656;212
317;;;;2263;2012;2006;1456;550
318;;;;300;260;260;138;122
319;;;;218;190;189;60;129
320;;;;2153;1894;1877;1242;635
321;;;;211;175;175;136;39
322;;;;1581;1440;1438;999;439
323;;;;188;157;156;82;74
324;;;;1005;907;903;481;422
325;;;;1354;1238;1229;1116;113
326;;;;463;378;372;153;219
327;;;;367;282;276;98;178
328;;;;880;737;735;323;412
329;;;;835;696;690;252;438
330;;;;352;267;265;140;125
331;;;;388;292;290;94;196
332;;;;465;396;393;143;250
333;;;;1532;1189;1182;393;789
334;;;;585;476;472;178;294
335;;;;404;330;328;94;234
336;;;;542;412;410;220;190
337;;;;247;211;211;43;168
338;;;;461;390;389;111;278
339;;;;1481;1178;1166;221;945
340;;;;823;699;693;203;490
341;;;;2673;2177;2156;556;1600
342;;;;1725;1472;1462;881;581
343;;;;2055;1798;1780;1109;671
344;;;;2146;1862;1846;1178;668
345;;;;572;511;504;281;223
346;;;;1334;1120;1116;357;759
347;;;;232;199;198;81;117
348;;;;1183;996;992;530;462
349;;;;1131;1023;1018;573;445
350;;;;407;357;354;190;164
351;;;;1299;1155;1148;707;441
352;;;;2398;2150;2142;1306;836
353;;;;2394;2094;2083;1440;643
354;;;;865;748;743;379;364
355;;;;1325;1139;1137;697;440
356;;;;2733;2199;2177;914;1263
357;;;;2426;2001;1987;634;1353
358;;;;2674;2274;2261;446;1815
359;;;;2504;1996;1988;704;1284
360;;;;3206;2535;2520;733;1787
361;;;;3319;2747;2733;724;2009
362;;;;2610;2220;2211;555;1656
363;;;;2713;2277;2263;817;1446
364;;;;1965;1674;1659;508;1151
365;;;;1657;1401;1389;516;873
366;;;;2805;2405;2393;885;1508
367;;;;776;645;642;211;431
368;;;;598;498;498;208;290
369;;;;1810;1756;1749;529;1220
370;;;;1774;1486;1484;444;1040
371;;;;321;243;239;59;180
372;;;;592;445;440;86;354
373;;;;290;228;225;46;179
374;;;;105;77;75;25;50
375;;;;532;419;417;73;344
376;;;;160;134;133;41;92
377;;;;1561;1184;1178;235;943
378;;;;2473;2112;2110;566;1544
379;;;;537;442;441;83;358
380;;;;552;391;388;106;282
381;;;;183;162;161;40;121
382;;;;50;44;44;13;31
383;;;;2289;2068;2052;582;1470
384;;;;1736;1508;1504;217;1287
385;;;;1893;1626;1610;273;1337
386;;;;1875;1672;1664;369;1295
387;;;;1247;1073;1072;369;703
388;;;;1271;1086;1080;347;733
389;;;;2063;1776;1764;741;1023
390;;;;2053;1764;1752;771;981
391;;;;3015;2611;2578;1299;1279
392;;;;1438;1229;1223;377;846
393;;;;1407;1237;1224;420;804
394;;;;1459;1250;1238;431;807
395;;;;1465;1260;1249;419;830
396;;;;2823;2446;2427;978;1449
397;;;;1574;1309;1304;508;796
398;;;;2373;2095;2080;663;1417
399;;;;2212;1927;1919;520;1399
400;;;;1234;1087;1078;385;693
401;;;;1154;993;992;484;508
402;;;;897;717;710;245;465
403;;;;883;731;728;276;452
404;;;;1656;1407;1400;560;840
405;;;;1314;1118;1113;360;753
406;;;;1383;1194;1179;196;983
407;;;;1350;1174;1170;196;974
408;;;;1785;1580;1572;620;952
409;;;;1640;1408;1397;558;839
410;;;;1633;1473;1467;552;915
411;;;;1646;1386;1373;556;817
412;;;;1880;1605;1591;604;987
413;;;;701;600;597;275;322
414;;;;2381;1951;1936;835;1101
415;;;;1565;1284;1268;521;747
416;;;;1547;1269;1264;515;749
417;;;;1373;1141;1131;511;620
418;;;;2276;1908;1891;999;892
419;;;;2636;2170;2151;816;1335
420;;;;2127;1744;1726;613;1113
421;;;;2122;1727;1712;633;1079
422;;;;2890;2439;2415;815;1600
423;;;;2454;2034;2023;846;1177
424;;;;2083;1675;1660;826;834
425;;;;2146;1745;1730;812;918
426;;;;1986;1651;1633;752;881
427;;;;1937;1645;1629;720;909
428;;;;1606;1322;1316;497;819
429;;;;2782;2282;2262;764;1498
430;;;;1498;1269;1259;497;762
431;;;;3075;2523;2506;1247;1259
432;;;;1561;1330;1319;458;861
433;;;;1285;1087;1076;331;745
434;;;;1281;1075;1066;344;722
435;;;;1590;1297;1281;509;772
436;;;;1640;1389;1379;673;706
437;;;;1052;866;858;298;560
438;;;;2980;2491;2479;993;1486
439;;;;2353;2000;1988;884;1104
440;;;;2349;1996;1981;858;1123
441;;;;2501;2081;2058;875;1183
442;;;;2482;2041;2025;864;1161
443;;;;1675;1357;1344;575;769
444;;;;1430;1232;1229;445;784
445;;;;1849;1564;1547;645;902
446;;;;1430;1210;1199;517;682
447;;;;856;740;733;283;450
448;;;;794;697;690;255;435
449;;;;186;159;156;62;94
450;;;;926;791;783;306;477
451;;;;349;289;286;101;185
452;;;;1830;1589;1578;403;1175
453;;;;1274;1112;1105;318;787
454;;;;1280;1100;1093;404;689
455;;;;1556;1408;1392;483;909
456;;;;1445;1076;1069;405;664
457;;;;1500;1252;1243;535;708
458;;;;202;202;201;63;138
459;;;;2326;1999;1989;684;1305
460;;;;2371;1979;1970;767;1203
461;;;;945;813;809;296;513
462;;;;1079;921;910;391;519
463;;;;1634;1403;1385;550;835
464;;;;150;130;129;38;91
465;;;;1226;1049;1043;380;663
466;;;;2631;2081;2068;577;1491
467;;;;1877;1581;1566;727;839
468;;;;1341;1078;1069;442;627
469;;;;976;762;750;302;448
470;;;;1130;874;872;353;519
471;;;;2050;1723;1714;851;863
472;;;;1324;1079;1070;510;560
473;;;;2038;1702;1683;768;915
474;;;;1967;1651;1640;575;1065
475;;;;728;618;614;227;387
476;;;;252;203;203;78;125
477;;;;2691;2140;2118;999;1119
478;;;;2555;2030;2011;894;1117
479;;;;2516;2098;2082;874;1208
480;;;;2785;2274;2247;1061;1186
481;;;;1573;1229;1226;500;726
482;;;;1585;1311;1301;511;790
483;;;;1487;1226;1215;586;629
484;;;;2332;1958;1948;638;1310
485;;;;830;694;690;300;390
486;;;;3177;3001;2984;1343;1641
487;;;;2984;2293;2276;1021;1255
488;;;;925;789;783;450;333
489;;;;1477;1157;1156;563;593
490;;;;874;736;729;312;417
491;;;;1647;1324;1314;569;745
492;;;;188;152;152;14;138
493;;;;186;150;148;13;135
494;;;;1980;1980;1968;750;1218
495;;;;4443;3849;3826;1873;1953
496;;;;1791;1648;1635;268;1367
497;;;;1167;976;970;142;828
498;;;;185;155;155;45;110
499;;;;2080;1857;1851;313;1538
500;;;;1382;1159;1152;203;949
501;;;;1779;1485;1475;213;1262
502;;;;2587;2249;2243;480;1763
503;;;;2146;1787;1780;347;1433
504;;;;2034;1711;1702;381;1321
505;;;;698;608;604;116;488
506;;;;2063;1840;1834;321;1513
507;;;;433;352;349;49;300
508;;;;1775;1481;1470;251;1219
509;;;;343;286;286;88;198
510;;;;504;418;416;110;306
511;;;;0;0;0;0;0
1;160101;160100;49-300;1039;640;632;345;287
2;160101;160100;49-300;1047;626;624;327;297
3;160101;160100;49-300;1131;651;644;353;291
4;160101;160100;49-300;921;587;580;285;295
5;160101;160100;49-300;1711;1264;1256;493;763
6;160101;160100;49-300;1500;985;979;529;450
7;160101;160100;49-300;1205;779;774;405;369
8;160101;160100;49-300;696;429;426;209;217
9;160101;160100;49-300;837;620;616;280;336
10;160101;160100;49-300;1599;1122;1112;471;641
11;160101;160100;49-300;1321;982;977;483;494
12;160101;160100;49-300;1157;822;814;414;400
13;160101;160100;49-300;690;458;455;230;225
14;160101;160100;49-300;1561;1045;1037;530;507
15;160101;160100;49-300;1309;978;970;445;525
16;160101;160100;49-300;1068;793;782;332;450
17;160101;160100;49-300;1100;781;776;370;406
18;160101;160100;49-300;806;515;511;247;264
19;160101;160100;49-300;1378;1022;1014;479;535
20;160101;160100;49-300;1104;766;762;367;395
21;160101;160100;49-300;1362;938;926;475;451
22;160101;160100;49-300;337;288;280;17;263
23;160101;160100;49-300;131;31;31;16;15
24;160101;160100;49-300;24;6;6;4;2
1;160102;160100;49-300;403;260;260;197;63
2;160102;160100;49-300;353;243;243;172;71
3;160102;160100;49-300;346;259;255;152;103
4;160102;160100;49-305;737;609;604;288;316
5;160102;160100;49-318;371;287;286;119;167
6;160102;160100;49-318;172;127;125;77;48
7;160102;160100;49-318;1817;1313;1308;696;612
8;160102;160100;49-318;334;207;206;136;70
9;160102;160100;49-318;556;350;349;240;109
10;160102;160100;49-317;272;218;217;167;50
11;160102;160100;49-300;428;305;303;172;131
12;160102;160100;49-300;563;403;403;221;182
1;160103;160100;49-200;996;649;643;318;325
2;160103;160100;49-200;844;472;469;209;260
3;160103;160100;49-200;842;574;571;235;336
4;160103;160100;49-200;794;569;567;232;335
5;160103;160100;49-200;762;544;540;231;309
6;160103;160100;49-200;1236;769;764;360;404
7;160103;160100;49-200;494;307;306;141;165
8;160103;160100;49-200;622;397;392;203;189
9;160103;160100;49-200;186;134;134;103;31
10;160103;160100;49-200;490;339;336;181;155
11;160103;160100;49-200;312;195;191;128;63
12;160103;160100;49-200;380;231;231;146;85
13;160103;160100;49-200;405;244;242;148;94
14;160103;160100;49-200;592;377;375;243;132
15;160103;160100;49-200;735;405;401;294;107
16;160103;160100;49-200;453;241;240;151;89
17;160103;160100;49-200;613;370;363;237;126
18;160103;160100;49-200;268;178;177;107;70
19;160103;160100;49-200;322;206;204;148;56
20;160103;160100;49-200;179;126;126;96;30
21;160103;160100;49-200;254;151;151;89;62
22;160103;160100;49-200;205;124;124;87;37
23;160103;160100;49-200;251;165;165;103;62
24;160103;160100;49-200;376;235;234;162;72
25;160103;160100;49-200;264;197;196;136;60
26;160103;160100;49-200;206;154;153;88;65
27;160103;160100;49-200;169;121;120;61;59
28;160103;160100;49-200;224;138;137;82;55
29;160103;160100;49-200;254;158;157;121;36
30;160103;160100;49-200;50;30;29;12;17
31;160103;160100;49-200;92;65;65;3;62
1;160104;160100;49-340;1151;748;738;393;345
2;160104;160100;49-340;1655;1136;1123;604;519
3;160104;160100;49-340;1608;1040;1031;523;508
4;160104;160100;49-330;1074;706;698;416;282
5;160104;160100;49-345;784;482;480;275;205
6;160104;160100;49-345;411;254;252;130;122
7;160104;160100;49-340;556;343;339;208;131
8;160104;160100;49-345;369;208;206;106;100
9;160104;160100;49-345;206;133;131;69;62
10;160104;160100;49-340;315;206;203;105;98
11;160104;160100;49-345;381;191;189;113;76
12;160104;160100;49-340;193;135;133;97;36
13;160104;160100;49-340;249;180;176;91;85
14;160104;160100;49-330;221;151;151;91;60
15;160104;160100;49-330;268;157;154;121;33
1;160105;160100;49-313;1115;725;718;399;319
2;160105;160100;49-314;917;600;598;352;246
3;160105;160100;49-314;829;519;512;269;243
4;160105;160100;49-314;617;425;423;212;211
5;160105;160100;49-314;619;449;445;236;209
6;160105;160100;49-312;479;341;339;238;101
7;160105;160100;49-312;277;189;186;122;64
8;160105;160100;49-312;444;316;315;210;105
9;160105;160100;49-315;424;248;248;151;97
10;160105;160100;49-315;551;354;348;206;142
11;160105;160100;49-315;480;304;299;185;114
1;160106;160100;49-332;433;343;341;214;127
2;160106;160100;49-332;356;218;217;161;56
3;160106;160100;49-351;555;387;386;245;141
4;160106;160100;49-332;429;320;320;228;92
5;160106;160100;49-332;355;253;251;165;86
6;160106;160100;49-332;544;357;353;222;131
7;160106;160100;49-332;289;209;208;146;62
8;160106;160100;49-332;271;207;206;139;67
9;160106;160100;49-330;168;111;110;70;40
10;160106;160100;49-332;229;162;162;111;51
1;160201;160200;48-120;842;503;499;306;193
2;160201;160200;48-120;941;563;560;327;233
3;160201;160200;48-120;780;466;463;311;152
4;160201;160200;48-133;457;232;232;146;86
5;160201;160200;48-120;359;200;198;123;75
6;160201;160200;48-100;194;128;127;98;29
7;160201;160200;48-120;194;104;103;65;38
8;160201;160200;47-480;422;218;218;143;75
9;160201;160200;48-120;156;92;92;64;28
10;160201;160200;48-120;57;24;21;4;17
1;160202;160200;48-140;761;467;464;266;198
2;160202;160200;48-140;539;318;315;201;114
3;160202;160200;48-140;690;407;400;281;119
4;160202;160200;48-140;586;328;324;190;134
5;160202;160200;48-140;339;206;206;131;75
6;160202;160200;48-140;639;374;373;291;82
7;160202;160200;48-140;852;527;519;293;226
8;160202;160200;48-140;123;53;53;28;25
9;160202;160200;48-140;50;42;41;8;33
10;160202;160200;48-140;56;39;33;20;13
11;160202;160200;48-140;51;41;40;20;20
12;160202;160200;48-140;404;192;180;110;70
13;160202;160200;48-140;49;34;33;21;12
1;160203;160200;48-100;1006;663;658;341;317
2;160203;160200;48-100;1087;635;630;353;277
3;160203;160200;48-100;1723;1144;1127;617;510
4;160203;160200;48-100;692;484;482;255;227
5;160203;160200;48-100;1535;1059;1049;478;571
6;160203;160200;48-100;1312;893;884;449;435
7;160203;160200;48-100;937;560;556;312;244
8;160203;160200;48-100;501;378;376;259;117
9;160203;160200;48-100;496;354;353;266;87
10;160203;160200;48-100;535;308;308;223;85
11;160203;160200;48-100;672;403;400;249;151
12;160203;160200;48-100;413;290;289;213;76
13;160203;160200;48-100;491;332;328;221;107
14;160203;160200;48-100;576;366;362;233;129
15;160203;160200;48-100;436;302;301;184;117
16;160203;160200;48-100;454;289;287;174;113
17;160203;160200;48-100;828;537;535;357;178
18;160203;160200;48-100;506;349;347;227;120
19;160203;160200;48-100;352;186;184;147;37
20;160203;160200;48-100;285;185;183;118;65
21;160203;160200;48-100;262;162;162;106;56
22;160203;160200;48-145;169;99;99;74;25
23;160203;160200;48-118;74;47;46;14;32
24;160203;160200;48-100;46;37;37;11;26
25;160203;160200;48-100;38;17;17;7;10
26;160203;160200;48-100;122;30;30;20;10
27;160203;160200;48-100;211;169;169;30;139
28;160203;160200;48-100;26;24;24;7;17
1;160204;160200;48-130;1863;1152;1144;590;554
2;160204;160200;48-130;1449;881;873;478;395
3;160204;160200;48-130;867;580;578;352;226
4;160204;160200;48-130;661;432;427;328;99
5;160204;160200;48-130;270;184;182;107;75
6;160204;160200;48-130;469;301;298;174;124
7;160204;160200;48-130;347;174;174;101;73
8;160204;160200;48-130;496;309;308;162;146
9;160204;160200;48-130;508;325;324;240;84
10;160204;160200;48-130;307;166;166;104;62
11;160204;160200;48-130;270;172;171;109;62
12;160204;160200;48-130;250;151;150;111;39
13;160204;160200;48-130;58;41;41;28;13
1;160301;160300;47-200;948;543;541;261;280
2;160301;160300;47-200;1198;832;826;308;518
3;160301;160300;47-200;1159;823;814;273;541
4;160301;160300;47-200;1500;1005;996;434;562
5;160301;160300;47-200;1259;805;795;343;452
6;160301;160300;47-200;1595;984;979;342;637
7;160301;160300;47-206;1613;1099;1089;379;710
8;160301;160300;47-206;1392;799;793;283;510
9;160301;160300;47-224;1630;1025;1018;423;595
10;160301;160300;47-224;1569;1055;1043;423;620
11;160301;160300;47-224;1710;1101;1084;411;673
12;160301;160300;47-224;1562;1059;1051;395;656
13;160301;160300;47-224;1269;886;880;346;534
14;160301;160300;47-220;800;571;570;179;391
15;160301;160300;47-220;1491;903;896;342;554
16;160301;160300;47-220;1090;681;673;257;416
17;160301;160300;47-220;1751;1221;1210;483;727
18;160301;160300;47-220;1676;1108;1093;388;705
19;160301;160300;47-220;950;649;644;260;384
20;160301;160300;47-220;1277;852;844;325;519
21;160301;160300;47-232;1334;940;935;393;542
22;160301;160300;47-232;1090;743;736;290;446
23;160301;160300;47-232;1524;1101;1089;475;614
24;160301;160300;47-232;1771;1255;1245;474;771
25;160301;160300;47-223;1244;822;813;300;513
26;160301;160300;47-225;1744;1006;995;398;597
27;160301;160300;47-225;389;254;250;87;163
28;160301;160300;47-225;405;240;236;97;139
29;160301;160300;47-230;1458;845;832;401;431
30;160301;160300;47-230;274;155;153;85;68
31;160301;160300;47-230;1799;1047;1039;454;585
32;160301;160300;47-200;91;28;27;14;13
33;160301;160300;47-220;30;17;17;6;11
34;160301;160300;47-230;42;33;31;12;19
1;160302;160300;47-223;698;439;428;176;252
2;160302;160300;47-240;1407;832;822;371;451
3;160302;160300;47-244;402;228;226;96;130
4;160302;160300;47-244;1300;687;681;368;313
5;160302;160300;47-244;379;200;197;97;100
6;160302;160300;47-246;503;298;298;151;147
7;160302;160300;47-246;392;238;236;123;113
8;160302;160300;47-223;429;237;234;95;139
9;160302;160300;47-246;329;203;202;82;120
1;160303;160300;47-253;876;476;467;217;250
2;160303;160300;47-260;698;398;392;199;193
3;160303;160300;47-253;1414;691;681;387;294
4;160303;160300;47-253;382;183;183;98;85
5;160303;160300;47-253;799;455;451;195;256
1;160304;160300;47-280;1264;667;662;309;353
2;160304;160300;47-280;810;361;353;196;157
3;160304;160300;47-280;427;212;209;118;91
4;160304;160300;47-280;648;316;309;143;166
5;160304;160300;47-270;1067;594;588;376;212
6;160304;160300;47-270;433;246;242;140;102
7;160304;160300;47-270;252;151;150;97;53
8;160304;160300;47-280;302;187;186;110;76
9;160304;160300;47-270;356;147;146;75;71
10;160304;160300;47-280;45;34;32;16;16
1;160305;160300;47-260;963;502;496;216;280
2;160305;160300;47-260;454;236;233;116;117
3;160305;160300;47-260;690;326;319;194;125
4;160305;160300;47-260;515;248;244;142;102
5;160305;160300;47-260;391;217;215;117;98
1;160306;160300;47-214;742;401;397;175;222
2;160306;160300;47-208;629;322;320;117;203
3;160306;160300;47-208;1144;652;641;285;356
4;160306;160300;47-208;748;387;383;182;201
5;160306;160300;47-208;1169;668;662;295;367
6;160306;160300;47-208;1131;567;557;248;309
7;160306;160300;47-208;355;175;174;89;85
8;160306;160300;47-214;377;181;179;64;115
1;160401;160400;46-220;1066;678;675;350;325
2;160401;160400;46-220;528;329;326;160;166
3;160401;160400;46-220;982;715;712;343;369
4;160401;160400;46-220;223;124;119;82;37
5;160401;160400;46-220;465;218;218;162;56
6;160401;160400;46-220;503;256;253;149;104
7;160401;160400;46-220;262;177;176;100;76
8;160401;160400;46-220;380;249;246;132;114
9;160401;160400;46-220;714;413;409;248;161
10;160401;160400;46-220;204;126;125;79;46
11;160401;160400;46-262;196;116;116;65;51
12;160401;160400;46-220;179;130;129;110;19
13;160401;160400;46-220;284;185;182;124;58
14;160401;160400;46-220;188;105;105;51;54
15;160401;160400;46-220;204;117;117;73;44
16;160401;160400;46-262;245;145;142;111;31
1;160402;160400;46-200;750;426;424;198;226
2;160402;160400;46-200;1214;681;671;345;326
3;160402;160400;46-200;1420;1012;1004;477;527
4;160402;160400;46-200;825;503;499;251;248
5;160402;160400;46-200;1264;858;855;383;472
6;160402;160400;46-203;1059;756;749;270;479
7;160402;160400;46-203;1313;970;966;378;588
8;160402;160400;46-203;1652;1187;1181;456;725
9;160402;160400;46-203;1990;1441;1428;545;883
10;160402;160400;46-203;1486;1006;999;417;582
11;160402;160400;46-200;1782;1138;1135;507;628
12;160402;160400;46-200;1164;803;799;363;436
13;160402;160400;46-233;668;397;394;188;206
14;160402;160400;46-233;480;303;299;172;127
15;160402;160400;46-200;836;636;630;255;375
16;160402;160400;46-211;808;425;422;222;200
17;160402;160400;46-211;853;476;472;189;283
18;160402;160400;46-200;844;489;486;212;274
19;160402;160400;46-243;1514;770;762;364;398
20;160402;160400;46-243;622;273;270;104;166
21;160402;160400;46-243;556;249;246;144;102
22;160402;160400;46-200;432;240;238;129;109
23;160402;160400;46-200;476;290;289;175;114
24;160402;160400;46-200;759;449;446;273;173
25;160402;160400;46-211;515;347;344;170;174
26;160402;160400;46-200;108;30;30;20;10
27;160402;160400;46-200;23;15;15;8;7
28;160402;160400;46-200;398;291;285;35;250
29;160402;160400;46-200;92;34;34;4;30
1;160403;160400;46-280;846;378;376;189;187
2;160403;160400;46-280;180;88;87;53;34
3;160403;160400;46-280;474;199;194;116;78
4;160403;160400;46-280;363;235;231;140;91
5;160403;160400;46-280;640;315;311;158;153
6;160403;160400;46-282;200;108;108;65;43
7;160403;160400;46-282;651;222;219;121;98
8;160403;160400;46-282;813;451;446;208;238
9;160403;160400;46-280;552;261;259;114;145
10;160403;160400;46-275;322;146;145;55;90
1;160404;160400;46-250;1189;769;764;444;320
2;160404;160400;46-250;636;446;442;246;196
3;160404;160400;46-250;1444;885;877;450;427
4;160404;160400;46-250;1020;698;693;414;279
5;160404;160400;46-255;819;455;450;271;179
6;160404;160400;46-264;609;369;366;228;138
7;160404;160400;46-264;416;239;234;175;59
8;160404;160400;46-250;366;230;228;164;64
9;160404;160400;46-255;452;264;264;170;94
10;160404;160400;46-250;538;355;352;215;137
11;160404;160400;46-250;375;234;232;143;89
12;160404;160400;46-250;544;243;241;136;105
13;160404;160400;46-250;249;147;147;93;54
14;160404;160400;46-262;360;210;209;118;91
15;160404;160400;46-262;296;194;191;123;68
1;160501;160500;47-320;1811;1053;1046;417;629
2;160501;160500;47-320;1408;745;739;327;412
3;160501;160500;47-320;1180;741;727;227;500
4;160501;160500;47-316;612;349;349;159;190
5;160501;160500;47-316;524;268;264;91;173
6;160501;160500;47-330;473;238;238;107;131
7;160501;160500;47-325;993;568;564;165;399
8;160501;160500;47-325;497;248;244;139;105
9;160501;160500;47-320;380;210;208;80;128
10;160501;160500;47-316;473;267;266;96;170
11;160501;160500;47-320;612;300;298;143;155
12;160501;160500;47-316;438;235;235;97;138
1;160502;160500;47-303;1697;1091;1079;431;648
2;160502;160500;47-303;953;574;569;239;330
3;160502;160500;47-303;1439;844;837;316;521
4;160502;160500;47-303;1136;760;752;285;467
5;160502;160500;47-303;1059;660;654;278;376
6;160502;160500;47-300;1458;721;714;333;381
7;160502;160500;47-300;1522;902;894;326;568
8;160502;160500;47-300;1647;1011;1002;381;621
9;160502;160500;47-303;681;379;375;158;217
10;160502;160500;47-300;683;380;378;144;234
11;160502;160500;47-300;483;263;261;115;146
12;160502;160500;47-300;899;487;479;187;292
13;160502;160500;47-300;394;215;213;79;134
14;160502;160500;47-341;398;202;200;94;106
15;160502;160500;47-300;593;315;312;197;115
16;160502;160500;47-300;274;123;123;54;69
17;160502;160500;47-300;778;406;401;182;219
18;160502;160500;47-300;318;165;163;50;113
19;160502;160500;47-303;64;16;16;1;15
1;160503;160500;47-364;1208;674;671;282;389
2;160503;160500;47-370;1405;661;652;332;320
3;160503;160500;47-370;1271;688;683;317;366
4;160503;160500;47-364;853;414;410;178;232
5;160503;160500;47-364;607;311;306;137;169
6;160503;160500;47-364;314;147;143;67;76
7;160503;160500;47-370;103;90;89;36;53
1;160504;160500;47-344;709;351;347;168;179
2;160504;160500;47-341;618;316;313;150;163
3;160504;160500;47-344;376;164;163;69;94
4;160504;160500;47-341;645;331;326;128;198
5;160504;160500;47-344;338;123;122;58;64
6;160504;160500;47-344;863;446;441;201;240
7;160504;160500;47-344;267;132;130;62;68
8;160504;160500;47-344;325;194;188;71;117
1;160505;160500;47-330;1090;589;581;256;325
2;160505;160500;47-330;1537;909;903;341;562
3;160505;160500;47-330;1367;709;704;294;410
4;160505;160500;47-330;1336;859;855;329;526
5;160505;160500;47-330;1036;593;587;241;346
6;160505;160500;47-330;1127;693;691;302;389
7;160505;160500;47-330;782;453;447;194;253
8;160505;160500;47-330;665;338;337;132;205
9;160505;160500;47-330;750;435;425;149;276
10;160505;160500;47-330;551;271;271;113;158
11;160505;160500;47-330;299;150;150;76;74
1;160601;160600;46-146;765;536;533;281;252
2;160601;160600;46-146;219;149;149;101;48
3;160601;160600;46-146;502;342;341;208;133
4;160601;160600;46-146;152;99;98;55;43
5;160601;160600;46-146;221;152;152;94;58
6;160601;160600;46-146;298;209;207;133;74
7;160601;160600;46-146;276;181;177;129;48
8;160601;160600;46-146;233;136;134;104;30
1;160602;160600;46-100;816;541;537;256;281
2;160602;160600;46-100;679;421;417;192;225
3;160602;160600;46-100;761;447;443;272;171
4;160602;160600;46-100;1462;1075;1066;485;581
5;160602;160600;46-100;712;510;506;236;270
6;160602;160600;46-100;1320;982;977;464;513
7;160602;160600;46-100;841;573;568;286;282
8;160602;160600;46-100;654;444;442;207;235
9;160602;160600;46-100;556;401;399;206;193
10;160602;160600;46-100;790;576;572;283;289
11;160602;160600;46-100;878;643;641;299;342
12;160602;160600;46-100;1013;740;731;343;388
13;160602;160600;46-100;1551;1181;1171;433;738
14;160602;160600;46-100;686;503;503;277;226
15;160602;160600;46-100;518;340;334;218;116
16;160602;160600;46-100;631;388;386;266;120
17;160602;160600;46-100;278;174;174;107;67
18;160602;160600;46-100;503;295;293;188;105
19;160602;160600;46-100;473;307;298;171;127
20;160602;160600;46-100;365;222;221;163;58
21;160602;160600;46-100;241;176;174;98;76
22;160602;160600;46-100;257;187;187;104;83
23;160602;160600;46-100;439;284;284;197;87
24;160602;160600;46-100;270;150;150;86;64
25;160602;160600;46-100;162;116;115;74;41
26;160602;160600;46-100;205;136;134;94;40
27;160602;160600;46-100;292;201;195;154;41
28;160602;160600;46-100;247;158;156;98;58
29;160602;160600;46-100;260;175;172;127;45
30;160602;160600;46-100;245;160;159;103;56
31;160602;160600;46-100;307;212;211;147;64
32;160602;160600;46-100;317;198;194;99;95
33;160602;160600;46-100;147;105;103;81;22
34;160602;160600;46-100;315;180;178;104;74
35;160602;160600;46-100;157;103;103;67;36
36;160602;160600;46-100;69;9;9;7;2
37;160602;160600;46-100;80;47;46;29;17
38;160602;160600;46-100;43;24;23;14;9
1;160603;160600;46-034;370;186;183;109;74
2;160603;160600;46-034;541;346;344;118;226
3;160603;160600;46-034;527;345;343;143;200
4;160603;160600;46-034;466;207;204;117;87
5;160603;160600;46-034;298;162;162;85;77
6;160603;160600;46-034;355;188;188;118;70
7;160603;160600;46-034;444;284;279;140;139
8;160603;160600;46-034;392;176;174;81;93
9;160603;160600;46-034;237;164;164;70;94
10;160603;160600;46-034;189;84;83;37;46
11;160603;160600;46-034;66;62;61;44;17
1;160604;160600;46-112;590;365;362;216;146
2;160604;160600;46-112;374;268;266;135;131
3;160604;160600;46-112;489;289;287;187;100
4;160604;160600;46-112;347;208;207;115;92
5;160604;160600;46-112;289;197;196;109;87
6;160604;160600;46-112;187;120;120;68;52
7;160604;160600;46-112;233;149;149;91;58
1;160605;160600;46-113;491;324;324;230;94
2;160605;160600;46-113;378;239;236;158;78
3;160605;160600;46-113;665;415;409;231;178
4;160605;160600;46-113;163;105;105;66;39
5;160605;160600;46-113;436;253;253;143;110
6;160605;160600;46-113;915;580;574;322;252
7;160605;160600;46-113;226;132;130;83;47
1;160701;160700;48-340;1175;646;639;348;291
2;160701;160700;48-340;1662;902;899;449;450
3;160701;160700;48-340;1572;1026;1016;459;557
4;160701;160700;48-340;1985;1272;1261;565;696
5;160701;160700;48-340;1687;1124;1119;462;657
6;160701;160700;48-340;1362;759;757;397;360
7;160701;160700;48-340;847;505;502;254;248
8;160701;160700;48-340;612;361;360;204;156
9;160701;160700;48-355;489;277;276;131;145
10;160701;160700;48-355;573;320;318;179;139
11;160701;160700;48-330;569;382;378;271;107
12;160701;160700;48-330;610;370;369;261;108
13;160701;160700;48-340;662;397;390;192;198
14;160701;160700;48-340;1126;715;713;423;290
15;160701;160700;48-267;787;625;622;247;375
16;160701;160700;48-340;455;299;298;186;112
17;160701;160700;48-340;341;238;236;168;68
18;160701;160700;48-355;343;179;178;112;66
19;160701;160700;48-330;154;94;93;63;30
20;160701;160700;48-340;31;31;30;17;13
21;160701;160700;48-340;130;94;93;51;42
22;160701;160700;48-340;65;12;12;3;9
23;160701;160700;48-340;159;151;149;80;69
1;160702;160700;48-388;693;387;385;269;116
2;160702;160700;48-388;353;231;229;193;36
3;160702;160700;48-388;698;440;440;296;144
4;160702;160700;48-388;381;261;260;189;71
5;160702;160700;48-388;312;150;148;95;53
1;160703;160700;48-317;1359;895;890;544;346
2;160703;160700;48-317;606;347;347;283;64
3;160703;160700;48-317;295;146;145;97;48
4;160703;160700;48-317;557;246;245;150;95
5;160703;160700;48-317;412;202;197;112;85
6;160703;160700;48-325;391;222;220;158;62
7;160703;160700;48-325;495;268;268;169;99
8;160703;160700;48-325;440;208;208;145;63
9;160703;160700;48-317;530;340;332;267;65
10;160703;160700;48-317;175;84;84;57;27
11;160703;160700;48-325;218;143;140;102;38
12;160703;160700;48-317;282;186;185;133;52
13;160703;160700;48-317;269;143;142;95;47
14;160703;160700;48-325;298;166;164;122;42
15;160703;160700;48-317;306;151;150;109;41
16;160703;160700;48-317;55;30;27;18;9
17;160703;160700;48-317;104;104;104;44;60
1;160704;160700;48-316;1030;655;650;356;294
2;160704;160700;48-316;708;466;465;243;222
3;160704;160700;48-315;672;407;402;280;122
4;160704;160700;48-315;458;268;265;151;114
5;160704;160700;48-316;517;320;315;248;67
6;160704;160700;48-316;394;246;246;143;103
7;160704;160700;48-315;313;198;197;127;70
8;160704;160700;48-316;349;163;163;92;71
9;160704;160700;48-316;226;125;125;100;25
10;160704;160700;48-316;376;220;216;135;81
11;160704;160700;48-315;260;169;168;108;60
1;160705;160700;48-300;1684;1110;1104;533;571
2;160705;160700;48-300;1716;1125;1109;534;575
3;160705;160700;48-300;1702;1098;1091;435;656
4;160705;160700;48-300;1861;1135;1130;536;594
5;160705;160700;48-300;1468;948;943;419;524
6;160705;160700;48-303;1001;677;676;296;380
7;160705;160700;48-303;1990;1461;1454;660;794
8;160705;160700;48-303;1030;807;803;332;471
9;160705;160700;48-303;1640;1135;1125;546;579
10;160705;160700;48-303;1826;1318;1306;607;699
11;160705;160700;48-303;1766;1116;1113;479;634
12;160705;160700;48-303;1798;1281;1270;534;736
13;160705;160700;48-303;2079;1273;1262;641;621
14;160705;160700;48-303;845;555;550;245;305
15;160705;160700;48-300;848;560;557;257;300
16;160705;160700;48-300;2163;1471;1458;707;751
17;160705;160700;48-300;1611;1099;1097;526;571
18;160705;160700;48-300;1729;1071;1065;581;484
19;160705;160700;48-300;1938;1365;1360;602;758
20;160705;160700;48-303;776;520;518;275;243
21;160705;160700;48-303;566;313;310;207;103
22;160705;160700;48-303;536;350;345;180;165
23;160705;160700;48-303;450;280;280;213;67
24;160705;160700;48-303;409;256;256;129;127
25;160705;160700;48-303;474;295;293;214;79
26;160705;160700;48-303;637;451;447;242;205
27;160705;160700;48-303;340;228;225;161;64
28;160705;160700;48-303;339;202;199;144;55
29;160705;160700;48-300;955;616;610;388;222
30;160705;160700;48-300;1056;786;783;332;451
31;160705;160700;48-300;371;236;234;149;85
32;160705;160700;48-300;501;385;383;147;236
33;160705;160700;48-300;1174;694;692;465;227
34;160705;160700;48-303;165;107;105;77;28
35;160705;160700;48-303;258;182;182;96;86
36;160705;160700;48-303;288;189;187;136;51
37;160705;160700;48-303;248;153;153;87;66
38;160705;160700;48-303;434;297;293;198;95
39;160705;160700;48-303;206;129;125;70;55
40;160705;160700;48-300;101;52;52;35;17
41;160705;160700;48-300;618;510;502;48;454
1;160706;160700;48-385;655;480;476;232;244
2;160706;160700;48-385;733;532;531;292;239
3;160706;160700;48-385;529;305;303;167;136
4;160706;160700;48-385;858;574;570;343;227
5;160706;160700;48-385;680;447;441;238;203
6;160706;160700;48-385;818;550;548;303;245
7;160706;160700;48-385;608;417;410;253;157
8;160706;160700;48-385;849;513;511;371;140
9;160706;160700;48-385;432;204;203;119;84
10;160706;160700;48-385;912;543;538;348;190
11;160706;160700;48-364;579;374;372;255;117
12;160706;160700;48-385;404;245;244;173;71
13;160706;160700;48-385;613;359;354;237;117
14;160706;160700;48-385;676;432;429;284;145
15;160706;160700;48-385;645;423;419;331;88
1;160707;160700;48-370;1100;615;610;315;295
2;160707;160700;48-370;1132;634;628;365;263
3;160707;160700;48-370;1169;677;673;377;296
4;160707;160700;48-370;574;395;394;194;200
5;160707;160700;48-370;391;252;248;187;61
6;160707;160700;48-370;376;227;227;132;95
7;160707;160700;48-370;580;360;357;255;102
8;160707;160700;48-370;329;185;185;125;60
9;160707;160700;48-370;474;311;310;183;127
10;160707;160700;48-370;285;188;187;123;64
11;160707;160700;48-370;263;156;155;85;70
12;160707;160700;48-370;236;129;129;94;35
13;160707;160700;48-370;314;202;200;138;62
14;160707;160700;48-370;220;140;138;81;57
15;160707;160700;48-370;274;157;155;96;59
16;160707;160700;48-370;1153;751;748;370;378
17;160707;160700;48-370;59;50;49;27;22
1;160708;160700;48-314;513;390;387;234;153
2;160708;160700;48-314;415;253;251;178;73
3;160708;160700;48-314;586;363;357;236;121
4;160708;160700;48-314;520;336;334;216;118
5;160708;160700;48-314;271;167;167;130;37
6;160708;160700;48-314;309;210;208;162;46
1;160709;160700;48-320;612;416;409;300;109
2;160709;160700;48-320;779;441;435;245;190
3;160709;160700;48-320;825;550;546;421;125
4;160709;160700;48-320;398;248;246;165;81
5;160709;160700;48-320;378;236;235;119;116
6;160709;160700;48-320;1098;753;747;494;253
7;160709;160700;48-320;241;157;156;128;28
8;160709;160700;48-320;316;237;236;141;95
1;160801;160800;46-380;1224;636;635;276;359
2;160801;160800;46-380;1136;545;542;272;270
3;160801;160800;46-380;1356;752;744;310;434
4;160801;160800;46-375;997;513;510;324;186
5;160801;160800;46-380;594;283;283;121;162
6;160801;160800;46-380;728;351;347;207;140
7;160801;160800;46-380;717;331;327;179;148
8;160801;160800;46-375;568;243;243;122;121
1;160802;160800;46-310;386;186;184;126;58
2;160802;160800;46-310;932;553;542;278;264
3;160802;160800;46-310;933;543;536;279;257
4;160802;160800;46-310;470;207;206;127;79
5;160802;160800;46-310;508;298;294;187;107
6;160802;160800;46-310;633;287;285;164;121
7;160802;160800;46-310;987;502;495;315;180
8;160802;160800;46-310;261;128;126;60;66
9;160802;160800;46-310;312;145;145;70;75
10;160802;160800;46-310;33;33;30;8;22
1;160803;160800;46-300;1616;919;910;356;554
2;160803;160800;46-300;921;642;637;205;432
3;160803;160800;46-300;1644;1025;1015;637;378
4;160803;160800;46-300;1116;714;708;252;456
5;160803;160800;46-300;1488;882;871;309;562
6;160803;160800;46-312;743;359;353;280;73
7;160803;160800;46-300;826;465;459;260;199
8;160803;160800;46-300;363;194;193;140;53
9;160803;160800;46-300;501;315;311;150;161
10;160803;160800;46-300;350;145;143;91;52
11;160803;160800;46-300;474;229;226;117;109
12;160803;160800;46-300;199;115;110;51;59
13;160803;160800;46-300;347;168;165;115;50
14;160803;160800;46-300;631;326;324;147;177
15;160803;160800;46-300;393;213;213;124;89
16;160803;160800;46-300;348;175;172;79;93
17;160803;160800;46-300;200;118;115;53;62
18;160803;160800;46-300;188;98;96;38;58
19;160803;160800;46-300;188;86;86;40;46
20;160803;160800;46-312;204;128;125;66;59
21;160803;160800;46-300;185;98;98;44;54
22;160803;160800;46-300;228;112;112;60;52
23;160803;160800;46-300;93;29;29;11;18
24;160803;160800;46-300;25;18;18;2;16
1;160804;160800;46-320;1132;796;789;382;407
2;160804;160800;46-320;1622;1140;1128;551;577
3;160804;160800;46-320;1916;1460;1450;782;668
4;160804;160800;46-320;649;452;449;226;223
5;160804;160800;46-310;288;204;203;105;98
6;160804;160800;46-320;540;378;376;257;119
7;160804;160800;46-320;797;529;524;277;247
8;160804;160800;46-320;607;440;436;240;196
9;160804;160800;46-320;748;517;517;253;264
10;160804;160800;46-320;526;354;348;264;84
11;160804;160800;46-230;324;215;215;129;86
12;160804;160800;46-320;188;130;129;74;55
13;160804;160800;46-320;215;163;163;73;90
14;160804;160800;46-320;211;163;162;105;57
15;160804;160800;46-320;46;3;3;3;0
1;160805;160800;46-331;1297;642;634;386;248
2;160805;160800;46-333;870;440;432;228;204
3;160805;160800;46-324;1018;482;478;274;204
1;160806;160800;46-325;1073;648;640;418;222
2;160806;160800;46-325;1012;607;601;358;243
3;160806;160800;46-325;1491;1052;1030;576;454
4;160806;160800;46-325;1206;887;875;573;302
5;160806;160800;46-325;1334;858;848;522;326
1;160807;160800;46-048;859;441;436;236;200
2;160807;160800;46-048;477;228;221;140;81
3;160807;160800;46-048;726;323;321;196;125
4;160807;160800;46-048;630;304;299;150;149
1;160901;160900;46-053;1137;697;688;229;459
2;160901;160900;46-053;1215;733;728;219;509
3;160901;160900;46-053;847;466;459;190;269
4;160901;160900;46-053;1002;466;458;184;274
5;160901;160900;46-053;800;570;563;168;395
6;160901;160900;46-053;581;414;408;147;261
1;160902;160900;49-120;1104;778;773;320;453
2;160902;160900;46-073;1212;680;672;264;408
3;160902;160900;49-120;603;331;329;149;180
4;160902;160900;49-120;416;326;319;140;179
5;160902;160900;49-120;226;127;127;84;43
6;160902;160900;49-120;338;239;237;109;128
7;160902;160900;46-073;904;522;519;175;344
8;160902;160900;49-120;549;409;405;154;251
9;160902;160900;49-120;277;183;181;121;60
10;160902;160900;49-120;466;275;271;95;176
11;160902;160900;49-120;292;160;159;70;89
1;160903;160900;46-080;2125;1030;1021;301;720
2;160903;160900;46-081;604;362;359;125;234
3;160903;160900;46-081;1553;953;944;302;642
4;160903;160900;46-081;2052;1299;1284;472;812
5;160903;160900;46-082;879;492;483;171;312
6;160903;160900;46-082;73;42;41;23;18
1;160904;160900;46-070;2241;1338;1323;406;917
2;160904;160900;46-070;427;295;294;106;188
3;160904;160900;46-070;936;510;507;180;327
4;160904;160900;46-070;1003;552;536;217;319
5;160904;160900;46-070;1412;835;828;323;505
6;160904;160900;46-070;845;469;465;183;282
7;160904;160900;46-070;209;102;102;48;54
1;160905;160900;46-024;1004;507;502;182;320
2;160905;160900;46-024;1727;818;811;336;475
3;160905;160900;46-022;557;336;336;114;222
4;160905;160900;46-022;1193;830;825;248;577
5;160905;160900;46-024;432;261;257;81;176
6;160905;160900;46-024;1304;722;707;231;476
7;160905;160900;46-024;424;242;237;96;141
8;160905;160900;46-022;891;664;661;187;474
9;160905;160900;46-024;245;151;150;44;106
1;160906;160900;46-030;434;185;183;85;98
2;160906;160900;46-030;477;231;227;95;132
3;160906;160900;46-030;729;460;458;199;259
4;160906;160900;46-030;613;293;289;109;180
5;160906;160900;46-030;314;167;164;88;76
6;160906;160900;46-030;957;449;448;182;266
7;160906;160900;46-030;242;128;127;51;76
8;160906;160900;46-030;275;135;133;59;74
1;160907;160900;49-100;604;367;365;186;179
2;160907;160900;49-100;518;311;310;147;163
3;160907;160900;49-100;508;239;237;154;83
4;160907;160900;49-100;778;510;502;236;266
5;160907;160900;49-100;773;515;512;264;248
6;160907;160900;49-100;586;423;419;177;242
7;160907;160900;49-100;652;437;435;223;212
8;160907;160900;49-100;858;549;544;300;244
9;160907;160900;49-100;718;440;434;298;136
10;160907;160900;49-156;759;426;420;253;167
11;160907;160900;49-156;565;356;353;202;151
12;160907;160900;49-156;476;277;274;181;93
13;160907;160900;49-100;507;338;338;202;136
14;160907;160900;49-100;473;333;333;198;135
15;160907;160900;49-156;803;476;473;317;156
1;160908;160900;46-040;994;552;545;258;287
2;160908;160900;46-040;1031;554;549;235;314
3;160908;160900;46-040;886;549;545;207;338
4;160908;160900;46-040;1577;1098;1088;372;716
5;160908;160900;46-040;665;287;285;142;143
6;160908;160900;46-040;1017;515;509;199;310
7;160908;160900;46-043;499;186;184;78;106
8;160908;160900;46-043;973;434;430;164;266
9;160908;160900;46-040;1198;822;816;482;334
10;160908;160900;46-040;1509;705;697;247;450
11;160908;160900;46-040;710;358;357;168;189
12;160908;160900;46-042;1224;706;700;223;477
13;160908;160900;46-040;439;242;238;89;149
14;160908;160900;46-040;878;529;529;206;323
15;160908;160900;46-040;530;213;212;91;121
16;160908;160900;46-040;229;114;113;61;52
17;160908;160900;46-040;93;32;32;12;20
1;160909;160900;46-090;288;163;162;79;83
2;160909;160900;46-090;707;364;363;161;202
3;160909;160900;46-090;858;439;433;132;301
4;160909;160900;46-083;757;370;365;102;263
5;160909;160900;46-083;772;413;412;118;294
6;160909;160900;46-037;930;585;584;316;268
7;160909;160900;46-037;459;275;273;174;99
8;160909;160900;46-090;181;107;105;60;45
9;160909;160900;46-090;239;98;96;60;36
10;160909;160900;46-090;321;201;199;122;77
11;160909;160900;46-090;309;205;202;88;114
12;160909;160900;46-083;292;128;127;39;88
1;160910;160900;46-060;478;287;285;140;145
2;160910;160900;46-060;853;529;526;172;354
3;160910;160900;46-060;624;307;304;128;176
4;160910;160900;46-061;464;301;299;125;174
5;160910;160900;46-061;507;294;292;148;144
6;160910;160900;46-060;473;260;258;113;145
7;160910;160900;46-060;411;214;211;95;116
8;160910;160900;46-060;883;527;522;153;369
9;160910;160900;46-061;197;119;119;56;63
10;160910;160900;46-060;759;523;515;157;358
11;160910;160900;46-060;213;97;97;41;56
12;160910;160900;46-061;498;277;274;129;145
13;160910;160900;46-061;352;201;201;113;88
14;160910;160900;46-060;245;137;134;55;79
15;160910;160900;46-060;71;38;36;16;20
1;160911;160900;46-050;657;342;334;139;195
2;160911;160900;46-050;856;496;490;184;306
3;160911;160900;46-050;465;279;275;125;150
4;160911;160900;46-050;704;408;402;186;216
5;160911;160900;46-050;994;631;623;292;331
6;160911;160900;46-050;784;482;475;179;296
7;160911;160900;46-050;794;519;507;249;258
8;160911;160900;46-050;1120;594;586;238;348
9;160911;160900;46-050;600;303;301;129;172
10;160911;160900;46-050;236;187;186;66;120
1;160912;160900;49-130;330;216;215;102;113
2;160912;160900;49-130;162;120;120;65;55
3;160912;160900;49-130;218;145;144;98;46
4;160912;160900;49-130;1157;819;810;420;390
5;160912;160900;49-130;894;536;533;294;239
6;160912;160900;49-130;1068;730;727;382;345
1;160913;160900;46-046;729;312;304;145;159
2;160913;160900;46-046;406;182;180;95;85
3;160913;160900;46-045;788;528;523;140;383
4;160913;160900;46-046;540;221;219;106;113
5;160913;160900;46-023;1042;600;587;238;349
6;160913;160900;46-045;1140;796;791;207;584
7;160913;160900;46-046;503;198;197;123;74
8;160913;160900;46-022;1364;945;935;324;611
9;160913;160900;46-023;790;452;446;157;289
10;160913;160900;46-045;317;178;176;65;111
11;160913;160900;46-045;307;164;160;64;96
12;160913;160900;46-045;143;137;134;18;116
13;160913;160900;46-045;22;22;21;5;16
1;161001;161000;48-210;686;398;393;194;199
2;161001;161000;48-210;586;336;335;156;179
3;161001;161000;48-210;474;269;268;104;164
4;161001;161000;48-220;471;213;211;124;87
5;161001;161000;48-220;1104;577;575;302;273
6;161001;161000;48-220;536;239;233;134;99
7;161001;161000;48-210;456;209;207;133;74
8;161001;161000;48-210;375;166;165;118;47
9;161001;161000;48-210;348;188;187;101;86
10;161001;161000;48-210;323;154;152;80;72
11;161001;161000;48-210;320;173;173;54;119
12;161001;161000;48-210;283;142;141;65;76
13;161001;161000;48-210;471;219;215;112;103
14;161001;161000;48-210;247;158;156;85;71
15;161001;161000;48-210;220;114;114;67;47
16;161001;161000;48-210;339;194;193;127;66
17;161001;161000;48-220;331;151;150;86;64
18;161001;161000;48-210;301;123;123;75;48
19;161001;161000;48-210;73;52;52;34;18
1;161002;161000;48-250;831;408;404;195;209
2;161002;161000;48-250;1582;936;925;432;493
3;161002;161000;48-250;484;299;296;125;171
4;161002;161000;48-250;1039;570;565;272;293
5;161002;161000;48-250;960;577;573;333;240
6;161002;161000;48-250;268;122;121;77;44
7;161002;161000;48-250;295;151;149;68;81
8;161002;161000;48-250;292;149;149;71;78
9;161002;161000;48-250;306;136;134;80;54
10;161002;161000;48-250;410;151;149;72;77
11;161002;161000;48-250;437;280;278;233;45
12;161002;161000;48-250;344;192;191;135;56
13;161002;161000;48-250;565;245;245;109;136
14;161002;161000;48-250;387;210;209;113;96
15;161002;161000;48-250;276;133;131;56;75
16;161002;161000;48-250;769;376;372;177;195
17;161002;161000;48-250;159;90;90;38;52
18;161002;161000;48-250;214;123;122;47;75
19;161002;161000;48-250;31;18;18;12;6
20;161002;161000;48-250;63;8;8;7;1
1;161003;161000;48-231;357;231;230;137;93
2;161003;161000;48-200;195;133;132;75;57
3;161003;161000;48-231;151;95;95;50;45
4;161003;161000;48-231;692;461;456;241;215
5;161003;161000;48-231;307;156;154;86;68
6;161003;161000;48-231;308;192;191;137;54
7;161003;161000;48-231;252;158;158;126;32
8;161003;161000;48-231;292;196;196;130;66
9;161003;161000;48-200;604;415;410;246;164
1;161004;161000;48-200;1394;811;808;449;359
2;161004;161000;48-200;809;532;525;246;279
3;161004;161000;48-200;1125;833;821;337;484
4;161004;161000;48-200;769;548;546;241;305
5;161004;161000;48-200;869;579;577;271;306
6;161004;161000;48-200;974;488;485;269;216
7;161004;161000;48-200;1067;620;613;365;248
8;161004;161000;48-200;1222;678;673;414;259
9;161004;161000;48-200;954;553;548;296;252
10;161004;161000;48-200;999;640;636;332;304
11;161004;161000;48-200;890;636;631;328;303
12;161004;161000;48-200;961;653;647;340;307
13;161004;161000;48-200;1012;703;699;355;344
14;161004;161000;48-200;929;655;649;343;306
15;161004;161000;48-200;853;563;560;359;201
16;161004;161000;48-200;628;401;400;273;127
17;161004;161000;48-200;481;318;317;239;78
18;161004;161000;48-200;1065;716;712;452;260
19;161004;161000;48-200;315;204;203;153;50
20;161004;161000;48-200;736;487;484;377;107
21;161004;161000;48-200;136;69;69;42;27
22;161004;161000;48-200;224;149;148;130;18
23;161004;161000;48-200;153;97;95;67;28
24;161004;161000;48-200;57;31;31;21;10
25;161004;161000;48-200;66;33;33;19;14
26;161004;161000;48-200;106;81;80;11;69
27;161004;161000;48-200;22;6;6;1;5
1;161101;161100;47-180;633;362;358;133;225
2;161101;161100;47-180;704;357;357;165;192
3;161101;161100;47-180;370;191;189;100;89
4;161101;161100;47-180;873;506;498;194;304
5;161101;161100;47-180;379;214;213;125;88
6;161101;161100;47-180;246;161;159;52;107
7;161101;161100;47-180;288;158;156;49;107
8;161101;161100;47-180;376;204;203;104;99
9;161101;161100;47-180;232;109;109;43;66
1;161102;161100;47-133;1177;641;636;314;322
2;161102;161100;47-133;1660;836;831;392;439
3;161102;161100;47-133;786;439;435;237;198
4;161102;161100;47-134;389;198;196;108;88
5;161102;161100;47-133;437;197;195;109;86
6;161102;161100;47-133;535;269;262;137;125
7;161102;161100;47-133;479;237;233;154;79
8;161102;161100;47-133;240;114;113;74;39
9;161102;161100;47-133;25;25;24;10;14
1;161103;161100;47-110;933;520;517;232;285
2;161103;161100;47-110;920;480;479;198;281
3;161103;161100;47-113;700;318;316;110;206
4;161103;161100;47-175;435;200;199;98;101
5;161103;161100;47-113;786;392;386;170;216
6;161103;161100;47-113;714;340;338;138;200
1;161104;161100;47-150;1025;653;638;300;338
2;161104;161100;47-150;967;609;599;276;323
3;161104;161100;47-150;576;351;347;186;161
4;161104;161100;47-100;362;175;174;97;77
5;161104;161100;47-150;265;134;131;54;77
6;161104;161100;47-150;874;452;441;244;197
7;161104;161100;47-150;941;492;488;237;251
8;161104;161100;47-150;313;148;146;64;82
9;161104;161100;47-150;294;154;151;69;82
10;161104;161100;47-150;60;30;27;15;12
1;161105;161100;47-100;1008;630;624;258;366
2;161105;161100;47-100;799;467;462;185;277
3;161105;161100;47-100;428;248;245;103;142
4;161105;161100;47-100;676;408;404;154;250
5;161105;161100;47-100;912;602;601;214;387
6;161105;161100;47-100;390;190;188;91;97
7;161105;161100;47-100;587;376;373;136;237
8;161105;161100;47-100;813;476;467;174;293
9;161105;161100;47-100;960;643;639;416;223
10;161105;161100;47-100;1134;753;746;251;495
11;161105;161100;47-100;995;590;585;230;355
12;161105;161100;47-100;1078;787;785;253;532
13;161105;161100;47-100;1028;640;638;255;383
14;161105;161100;47-100;944;637;630;215;415
15;161105;161100;47-100;929;642;638;237;401
16;161105;161100;47-100;1050;600;596;316;280
17;161105;161100;47-100;513;287;284;120;164
18;161105;161100;47-100;912;465;456;232;224
19;161105;161100;47-100;541;293;292;175;117
20;161105;161100;47-100;325;175;173;101;72
21;161105;161100;47-100;703;393;392;208;184
22;161105;161100;47-100;568;285;282;124;158
23;161105;161100;47-100;670;343;343;163;180
24;161105;161100;47-100;515;295;291;129;162
25;161105;161100;47-100;766;437;429;188;241
26;161105;161100;47-100;820;389;381;204;177
27;161105;161100;47-100;338;222;222;120;102
28;161105;161100;47-100;1090;545;542;281;261
29;161105;161100;47-100;51;31;30;18;12
30;161105;161100;47-100;116;41;38;16;22
31;161105;161100;47-100;59;9;9;5;4
32;161105;161100;47-100;821;640;627;60;567
33;161105;161100;47-100;548;373;370;57;313
1;161106;161100;47-143;1353;867;861;453;408
2;161106;161100;47-143;338;168;165;81;84
3;161106;161100;47-143;606;333;331;205;126
4;161106;161100;47-143;665;374;369;194;175
5;161106;161100;47-143;517;279;279;151;128
6;161106;161100;47-143;473;255;253;163;90
7;161106;161100;47-143;452;243;241;143;98
8;161106;161100;47-134;199;111;108;55;53
9;161106;161100;47-143;225;143;142;67;75
1;161107;161100;47-120;1420;740;732;431;301
2;161107;161100;47-120;1597;887;876;467;409
3;161107;161100;47-120;1920;1123;1115;512;603
4;161107;161100;47-120;1835;965;955;630;325
5;161107;161100;47-126;1439;826;815;527;288
1;166101;166100;45-960;461;308;306;101;205
2;166101;166100;45-960;740;480;480;191;289
3;166101;166100;45-837;651;508;504;168;336
4;166101;166100;45-834;1289;980;973;292;681
5;166101;166100;45-834;1387;1084;1070;326;744
6;166101;166100;45-856;1436;1081;1070;372;698
7;166101;166100;45-856;1402;1003;995;353;642
8;166101;166100;45-867;1507;1213;1199;422;777
9;166101;166100;45-720;2106;1672;1657;484;1173
10;166101;166100;45-761;985;813;808;249;559
11;166101;166100;45-710;1080;825;819;257;562
12;166101;166100;45-705;1643;1161;1146;403;743
13;166101;166100;45-714;1269;944;935;296;639
14;166101;166100;45-714;1031;728;719;231;488
15;166101;166100;45-940;2529;1953;1934;530;1404
16;166101;166100;45-760;1698;1316;1301;429;872
17;166101;166100;45-760;1234;1005;996;293;703
18;166101;166100;45-776;1476;1043;1034;312;722
19;166101;166100;45-776;600;402;399;153;246
20;166101;166100;45-920;449;229;221;93;128
21;166101;166100;45-920;551;314;313;108;205
22;166101;166100;45-920;1460;984;975;302;673
23;166101;166100;45-920;1716;1155;1144;340;804
24;166101;166100;45-128;659;420;414;147;267
25;166101;166100;45-122;1042;693;685;273;412
26;166101;166100;45-221;1293;1020;1014;302;712
27;166101;166100;45-221;1122;808;802;273;529
28;166101;166100;45-048;1103;766;756;285;471
29;166101;166100;45-222;1237;910;902;257;645
30;166101;166100;45-222;853;686;681;204;477
31;166101;166100;45-267;1779;1328;1319;425;894
32;166101;166100;45-267;1670;1308;1291;443;848
33;166101;166100;45-267;1899;1517;1498;513;985
34;166101;166100;45-265;1636;1286;1272;367;905
35;166101;166100;45-284;1354;1063;1051;343;708
36;166101;166100;45-284;1454;1159;1150;421;729
37;166101;166100;45-286;1665;1299;1292;430;862
38;166101;166100;45-240;1177;844;836;288;548
39;166101;166100;45-304;978;832;827;209;618
40;166101;166100;45-401;1029;794;790;175;615
41;166101;166100;45-401;1758;1398;1387;436;951
42;166101;166100;45-304;843;702;690;195;495
43;166101;166100;45-301;1557;1182;1170;341;829
44;166101;166100;45-305;1452;1113;1103;356;747
45;166101;166100;45-409;1778;1423;1415;374;1041
46;166101;166100;45-301;1745;1415;1400;427;973
47;166101;166100;45-432;1409;1074;1071;345;726
48;166101;166100;45-432;1724;1336;1325;409;916
49;166101;166100;45-573;1292;811;804;311;493
50;166101;166100;45-558;1115;739;731;295;436
51;166101;166100;45-558;960;649;642;190;452
52;166101;166100;45-517;2445;1899;1893;492;1401
53;166101;166100;45-675;992;599;596;208;388
54;166101;166100;45-627;976;644;638;241;397
55;166101;166100;45-627;1127;697;693;283;410
56;166101;166100;45-641;962;658;650;247;403
57;166101;166100;45-643;1136;784;778;312;466
58;166101;166100;45-005;1507;1008;1000;378;622
59;166101;166100;45-048;1600;1216;1206;368;838
60;166101;166100;45-027;1406;1034;1029;355;674
61;166101;166100;45-037;948;714;707;191;516
62;166101;166100;45-062;1257;913;900;273;627
63;166101;166100;45-368;1284;949;941;282;659
64;166101;166100;45-086;1089;838;836;227;609
65;166101;166100;45-072;1274;918;906;269;637
66;166101;166100;45-062;1412;1026;1019;321;698
67;166101;166100;45-368;1494;1062;1051;367;684
68;166101;166100;45-342;659;446;446;136;310
69;166101;166100;45-356;1318;899;891;327;564
70;166101;166100;45-061;1350;961;951;261;690
71;166101;166100;45-071;1247;845;843;277;566
72;166101;166100;45-356;1053;718;712;276;436
73;166101;166100;45-066;6;6;6;0;6
74;166101;166100;45-401;230;130;129;59;70
75;166101;166100;45-372;244;110;109;42;67
76;166101;166100;45-221;198;85;83;38;45
77;166101;166100;45-075;25;25;25;13;12
78;166101;166100;45-758;92;55;51;22;29
79;166101;166100;45-033;280;214;209;34;175
80;166101;166100;45-853;47;46;46;4;42
81;166101;166100;45-759;94;29;29;14;15
82;166101;166100;45-061;102;38;38;20;18
83;166101;166100;45-758;52;11;10;3;7
84;166101;166100;45-403;56;35;35;5;30
1;180103;180100;38-710;909;594;589;401;188
2;180103;180100;38-710;278;157;152;106;46
3;180103;180100;38-710;305;222;220;177;43
4;180103;180100;38-710;169;98;98;66;32
5;180103;180100;38-710;170;98;98;83;15
1;180105;180100;38-713;783;473;465;284;181
2;180105;180100;38-713;494;352;347;189;158
3;180105;180100;38-713;267;194;193;91;102
4;180105;180100;38-713;295;191;189;124;65
1;180108;180100;38-700;771;462;458;274;184
2;180108;180100;38-700;654;400;399;222;177
3;180108;180100;38-700;826;497;496;278;218
4;180108;180100;38-700;865;582;581;292;289
5;180108;180100;38-700;834;556;555;290;265
6;180108;180100;38-700;572;346;345;199;146
7;180108;180100;38-700;1079;719;714;376;338
8;180108;180100;38-700;689;400;397;265;132
9;180108;180100;38-700;402;222;221;157;64
10;180108;180100;38-700;670;433;431;298;133
11;180108;180100;38-700;517;351;345;249;96
12;180108;180100;38-700;334;192;189;108;81
13;180108;180100;38-700;396;250;245;167;78
14;180108;180100;38-700;194;72;70;51;19
15;180108;180100;38-700;319;208;205;133;72
16;180108;180100;38-700;205;128;126;80;46
17;180108;180100;38-700;413;227;227;131;96
18;180108;180100;38-712;444;314;313;196;117
19;180108;180100;38-712;483;273;272;173;99
20;180108;180100;38-711;633;386;379;256;123
21;180108;180100;38-711;231;143;143;91;52
22;180108;180100;38-700;193;122;119;93;26
23;180108;180100;38-700;200;137;135;94;41
24;180108;180100;38-700;182;139;137;68;69
25;180108;180100;38-700;223;145;145;100;45
26;180108;180100;38-700;148;81;81;59;22
27;180108;180100;38-711;166;119;116;99;17
28;180108;180100;38-700;41;29;29;23;6
1;180201;180200;36-200;2030;1347;1336;891;445
2;180201;180200;36-200;1716;1155;1147;843;304
3;180201;180200;36-200;1612;1095;1088;734;354
4;180201;180200;36-206;1213;781;777;603;174
5;180201;180200;36-206;1142;717;712;533;179
6;180201;180200;36-206;1104;725;724;568;156
7;180201;180200;36-207;1167;790;786;550;236
8;180201;180200;36-207;1224;737;737;577;160
9;180201;180200;36-200;1104;740;737;609;128
10;180201;180200;36-200;816;535;532;399;133
11;180201;180200;36-200;907;632;631;540;91
12;180201;180200;36-200;1268;865;863;753;110
13;180201;180200;36-200;1303;923;918;773;145
14;180201;180200;36-200;1576;1085;1080;971;109
15;180201;180200;36-200;1246;877;875;781;94
16;180201;180200;36-200;147;70;70;46;24
17;180201;180200;36-200;47;31;31;25;6
1;180202;180200;36-230;692;488;485;438;47
2;180202;180200;36-230;622;443;442;398;44
3;180202;180200;36-230;1483;1073;1069;895;174
4;180202;180200;36-230;211;139;137;111;26
5;180202;180200;36-230;965;666;661;602;59
6;180202;180200;36-230;563;392;391;360;31
1;180203;180200;36-204;1139;743;738;627;111
2;180203;180200;36-207;425;289;286;265;21
3;180203;180200;36-204;800;523;520;456;64
4;180203;180200;36-204;394;221;220;164;56
5;180203;180200;36-204;312;188;187;165;22
6;180203;180200;36-204;254;169;169;132;37
7;180203;180200;36-204;226;142;141;117;24
8;180203;180200;36-204;250;157;157;123;34
9;180203;180200;36-204;286;183;182;164;18
10;180203;180200;36-204;341;218;217;185;32
11;180203;180200;36-207;1141;751;749;620;129
12;180203;180200;36-204;427;279;277;249;28
1;180204;180200;36-213;913;638;626;513;113
2;180204;180200;36-213;1510;1062;1054;746;308
3;180204;180200;36-212;803;530;527;427;100
4;180204;180200;36-212;270;182;182;144;38
5;180204;180200;36-211;1040;698;698;534;164
6;180204;180200;36-211;686;445;444;355;89
7;180204;180200;36-213;769;574;572;500;72
8;180204;180200;36-213;815;622;618;525;93
1;180205;180200;36-220;1603;1231;1211;1028;183
2;180205;180200;36-221;1269;936;930;831;99
3;180205;180200;36-221;1271;965;956;805;151
4;180205;180200;36-220;1119;841;837;750;87
5;180205;180200;36-220;503;356;356;335;21
1;180206;180200;36-245;993;665;658;507;151
2;180206;180200;36-245;663;424;418;324;94
3;180206;180200;36-245;849;600;599;478;121
4;180206;180200;36-245;301;191;190;167;23
5;180206;180200;36-245;130;74;74;69;5
6;180206;180200;36-203;857;540;536;457;79
7;180206;180200;36-203;770;487;482;355;127
8;180206;180200;36-203;268;187;187;174;13
9;180206;180200;36-233;853;550;548;473;75
10;180206;180200;36-233;53;44;42;38;4
11;180206;180200;36-233;248;180;180;153;27
1;180301;180300;39-200;1390;1022;1016;567;449
2;180301;180300;39-200;1413;1001;989;597;392
3;180301;180300;39-200;1404;1019;1010;585;425
4;180301;180300;39-200;1912;1402;1389;926;463
5;180301;180300;39-200;1241;850;836;534;302
6;180301;180300;39-200;1226;890;881;581;300
7;180301;180300;39-200;1356;979;973;619;354
8;180301;180300;39-200;1363;965;960;636;324
9;180301;180300;39-200;1329;937;928;551;377
10;180301;180300;39-200;1505;969;965;600;365
11;180301;180300;39-200;1447;986;973;606;367
12;180301;180300;39-200;1010;685;676;414;262
13;180301;180300;39-200;1262;898;890;569;321
14;180301;180300;39-200;1998;1464;1452;964;488
15;180301;180300;39-200;2021;1578;1573;922;651
16;180301;180300;39-200;1427;906;898;557;341
17;180301;180300;39-200;1623;1163;1155;732;423
18;180301;180300;39-200;2053;1596;1584;948;636
19;180301;180300;39-200;1673;1236;1223;745;478
20;180301;180300;39-200;1367;1067;1055;602;453
21;180301;180300;39-200;2201;1641;1632;1197;435
22;180301;180300;39-200;85;52;51;36;15
23;180301;180300;39-200;131;92;91;67;24
24;180301;180300;39-200;521;350;345;62;283
1;180302;180300;39-230;1068;749;744;590;154
2;180302;180300;39-230;976;656;651;477;174
3;180302;180300;39-230;510;364;364;289;75
4;180302;180300;39-230;339;218;217;187;30
5;180302;180300;39-230;321;224;224;201;23
6;180302;180300;39-230;627;432;427;366;61
7;180302;180300;39-232;566;391;391;349;42
8;180302;180300;39-232;389;265;265;248;17
9;180302;180300;39-231;724;474;474;426;48
10;180302;180300;39-231;513;367;367;324;43
11;180302;180300;39-230;390;294;292;254;38
12;180302;180300;39-230;521;365;361;319;42
13;180302;180300;39-232;189;124;123;107;16
14;180302;180300;39-231;500;348;343;315;28
15;180302;180300;39-232;299;214;213;195;18
16;180302;180300;39-232;214;171;170;152;18
17;180302;180300;39-230;390;260;257;238;19
18;180302;180300;39-230;633;405;404;375;29
19;180302;180300;39-230;294;196;195;174;21
20;180302;180300;39-230;279;188;187;158;29
1;180303;180300;39-215;886;620;615;426;189
2;180303;180300;39-215;846;630;625;461;164
3;180303;180300;39-215;784;589;582;415;167
4;180303;180300;39-215;440;338;337;308;29
5;180303;180300;39-216;863;618;614;539;75
6;180303;180300;39-216;297;212;212;191;21
7;180303;180300;39-216;86;62;62;40;22
8;180303;180300;39-216;925;652;649;550;99
9;180303;180300;39-215;560;405;403;321;82
10;180303;180300;39-217;694;505;503;395;108
11;180303;180300;39-217;970;723;718;533;185
12;180303;180300;39-217;477;291;286;217;69
13;180303;180300;39-217;645;438;435;340;95
14;180303;180300;39-215;759;549;545;452;93
15;180303;180300;39-217;753;498;494;397;97
1;180304;180300;39-200;1178;855;849;622;227
2;180304;180300;39-200;1116;767;761;564;197
3;180304;180300;39-200;1029;711;708;646;62
4;180304;180300;39-200;742;551;549;484;65
5;180304;180300;39-208;906;630;629;527;102
6;180304;180300;39-200;1139;817;812;592;220
7;180304;180300;39-208;633;485;482;427;55
8;180304;180300;39-208;450;309;309;276;33
9;180304;180300;39-200;811;604;600;460;140
10;180304;180300;39-200;1255;898;891;719;172
11;180304;180300;39-207;1119;786;783;629;154
12;180304;180300;39-206;741;454;447;299;148
13;180304;180300;39-206;785;513;509;331;178
14;180304;180300;39-206;258;179;179;152;27
15;180304;180300;39-205;471;312;312;246;66
16;180304;180300;39-205;657;418;416;344;72
17;180304;180300;39-205;1128;735;732;630;102
18;180304;180300;39-200;1021;799;794;512;282
19;180304;180300;39-200;1007;739;731;543;188
20;180304;180300;39-206;770;567;565;368;197
21;180304;180300;39-207;949;671;665;509;156
22;180304;180300;39-207;1088;774;766;539;227
1;180305;180300;39-225;996;654;645;523;122
2;180305;180300;39-225;825;540;536;472;64
3;180305;180300;39-225;726;466;464;399;65
4;180305;180300;39-225;335;223;222;190;32
5;180305;180300;39-225;744;517;514;459;55
6;180305;180300;39-225;373;250;248;216;32
1;180306;180300;39-220;1816;1313;1303;1050;253
2;180306;180300;39-220;1950;1402;1393;998;395
3;180306;180300;39-223;367;269;268;243;25
4;180306;180300;39-223;815;599;594;500;94
5;180306;180300;39-220;975;747;739;634;105
6;180306;180300;39-220;238;176;176;148;28
7;180306;180300;39-220;303;208;208;189;19
8;180306;180300;39-223;526;383;381;331;50
9;180306;180300;39-220;1152;862;857;757;100
10;180306;180300;39-221;1257;853;849;722;127
11;180306;180300;39-221;1087;759;757;642;115
12;180306;180300;39-220;608;431;429;334;95
13;180306;180300;39-221;255;184;183;153;30
14;180306;180300;39-220;762;593;587;476;111
15;180306;180300;39-223;803;581;578;534;44
16;180306;180300;39-223;889;589;583;535;48
17;180306;180300;39-220;87;34;33;27;6
1;180307;180300;39-204;1336;1019;1016;723;293
2;180307;180300;39-204;573;443;440;355;85
3;180307;180300;39-203;1139;792;787;642;145
4;180307;180300;39-203;586;415;414;358;56
5;180307;180300;39-203;301;210;206;167;39
6;180307;180300;39-203;1228;864;859;744;115
7;180307;180300;39-209;459;344;343;322;21
8;180307;180300;39-209;701;524;522;476;46
9;180307;180300;39-209;695;535;530;464;66
10;180307;180300;39-204;841;623;619;528;91
11;180307;180300;39-218;1714;1251;1241;913;328
12;180307;180300;39-218;547;396;394;340;54
13;180307;180300;39-204;805;592;587;371;216
14;180307;180300;39-218;129;54;53;37;16
1;180401;180400;37-500;1178;684;678;441;237
2;180401;180400;37-500;1205;808;803;503;300
3;180401;180400;37-500;1336;876;872;557;315
4;180401;180400;37-500;1251;845;840;590;250
5;180401;180400;37-500;1145;797;792;482;310
6;180401;180400;37-500;1097;670;664;421;243
7;180401;180400;37-500;1216;809;795;482;313
8;180401;180400;37-500;1064;720;717;405;312
9;180401;180400;37-500;988;697;693;400;293
10;180401;180400;37-500;1042;718;715;424;291
11;180401;180400;37-500;933;622;617;419;198
12;180401;180400;37-500;1295;932;923;533;390
13;180401;180400;37-500;1248;916;911;512;399
14;180401;180400;37-500;1453;930;921;524;397
15;180401;180400;37-500;1756;1197;1190;659;531
16;180401;180400;37-500;1187;811;808;458;350
17;180401;180400;37-500;1318;891;883;509;374
18;180401;180400;37-500;1453;1057;1051;628;423
19;180401;180400;37-500;1431;990;982;622;360
20;180401;180400;37-500;1266;933;927;512;415
21;180401;180400;37-500;1812;1253;1247;951;296
22;180401;180400;37-500;123;89;88;68;20
23;180401;180400;37-500;357;151;149;112;37
1;180402;180400;37-550;1375;891;889;619;270
2;180402;180400;37-550;718;490;490;336;154
3;180402;180400;37-550;1742;1173;1163;860;303
1;180403;180400;37-561;732;514;511;433;78
2;180403;180400;37-554;913;576;574;467;107
3;180403;180400;37-554;608;431;430;398;32
4;180403;180400;37-561;699;404;401;335;66
5;180403;180400;37-561;587;413;413;353;60
6;180403;180400;37-554;412;256;252;210;42
7;180403;180400;37-554;193;136;134;100;34
1;180404;180400;37-500;627;496;486;336;150
2;180404;180400;37-511;468;273;272;246;26
3;180404;180400;37-500;858;542;536;419;117
4;180404;180400;37-514;783;496;494;425;69
5;180404;180400;37-514;1604;1129;1124;785;339
6;180404;180400;37-511;1316;882;875;680;195
7;180404;180400;37-500;362;265;262;165;97
8;180404;180400;37-500;783;508;504;392;112
9;180404;180400;37-514;1251;851;845;638;207
10;180404;180400;37-511;573;376;374;342;32
11;180404;180400;37-511;1075;745;742;665;77
12;180404;180400;37-500;168;111;110;87;23
1;180405;180400;37-543;422;253;253;222;31
2;180405;180400;37-543;229;153;151;129;22
3;180405;180400;37-543;472;276;273;222;51
4;180405;180400;37-543;651;493;491;415;76
5;180405;180400;37-543;685;474;467;371;96
6;180405;180400;37-543;578;333;331;272;59
7;180405;180400;37-543;399;278;276;232;44
8;180405;180400;37-543;221;129;129;101;28
9;180405;180400;37-543;577;386;381;325;56
10;180405;180400;37-543;320;185;183;146;37
11;180405;180400;37-543;404;239;235;186;49
12;180405;180400;37-543;65;64;56;54;2
1;180406;180400;37-500;1420;962;957;720;237
2;180406;180400;37-500;1101;832;829;557;272
3;180406;180400;37-500;493;320;317;247;70
4;180406;180400;37-500;425;333;331;221;110
5;180406;180400;37-500;233;160;159;119;40
6;180406;180400;37-500;469;340;334;231;103
7;180406;180400;37-500;672;466;465;366;99
8;180406;180400;37-205;217;149;149;133;16
9;180406;180400;37-500;967;621;619;465;154
10;180406;180400;37-500;348;242;238;197;41
1;180407;180400;37-560;356;236;233;180;53
2;180407;180400;37-560;986;708;705;653;52
3;180407;180400;37-560;1254;906;902;869;33
4;180407;180400;37-560;1771;1290;1279;1035;244
5;180407;180400;37-560;552;408;405;372;33
6;180407;180400;37-560;617;410;407;313;94
7;180407;180400;37-560;349;239;239;213;26
8;180407;180400;37-560;281;180;180;154;26
9;180407;180400;37-560;273;194;193;165;28
10;180407;180400;37-560;340;235;234;218;16
11;180407;180400;37-560;484;337;335;292;43
1;180408;180400;37-552;649;380;379;318;61
2;180408;180400;37-552;324;213;212;177;35
3;180408;180400;37-550;770;527;524;438;86
4;180408;180400;37-550;332;200;199;170;29
5;180408;180400;37-552;423;275;273;242;31
6;180408;180400;37-550;643;417;415;368;47
7;180408;180400;37-550;588;327;326;283;43
8;180408;180400;37-550;1148;803;799;697;102
9;180408;180400;37-550;1133;811;805;649;156
10;180408;180400;37-555;1016;683;681;554;127
11;180408;180400;37-555;821;578;573;486;87
12;180408;180400;37-550;469;336;332;305;27
13;180408;180400;37-543;41;19;16;14;2
14;180408;180400;37-555;60;20;20;16;4
1;180409;180400;37-562;483;289;284;240;44
2;180409;180400;37-562;1145;764;754;633;121
3;180409;180400;37-562;338;206;203;164;39
4;180409;180400;37-562;543;351;347;310;37
5;180409;180400;37-562;708;467;464;415;49
1;180410;180400;37-565;567;394;391;270;121
2;180410;180400;37-565;862;565;559;463;96
3;180410;180400;37-565;395;266;266;237;29
4;180410;180400;37-565;316;217;217;163;54
5;180410;180400;37-565;353;226;224;175;49
6;180410;180400;37-565;378;248;247;206;41
7;180410;180400;37-560;597;417;416;359;57
8;180410;180400;37-560;442;315;314;288;26
9;180410;180400;37-565;274;198;197;140;57
10;180410;180400;37-560;160;107;107;90;17
11;180410;180400;37-565;178;113;113;96;17
12;180410;180400;37-560;205;145;145;127;18
1;180411;180400;37-522;1704;1232;1226;1028;198
2;180411;180400;37-522;542;390;388;332;56
3;180411;180400;37-523;457;353;349;238;111
4;180411;180400;37-523;396;294;294;263;31
5;180411;180400;37-523;425;321;317;272;45
6;180411;180400;37-544;1153;728;725;616;109
7;180411;180400;37-544;540;347;346;302;44
8;180411;180400;37-522;867;627;623;575;48
9;180411;180400;37-522;1968;1386;1378;1115;263
10;180411;180400;37-500;608;428;424;287;137
11;180411;180400;37-522;320;226;223;179;44
1;180501;180500;38-200;1304;888;879;456;423
2;180501;180500;38-200;959;612;607;329;278
3;180501;180500;38-200;1085;699;693;408;285
4;180501;180500;38-200;1303;919;908;460;448
5;180501;180500;38-200;1292;887;882;526;356
6;180501;180500;38-200;1431;1004;994;552;442
7;180501;180500;38-200;932;592;585;350;235
8;180501;180500;38-200;614;469;464;379;85
9;180501;180500;38-200;511;364;362;249;113
10;180501;180500;38-200;941;589;584;460;124
11;180501;180500;38-200;560;382;378;284;94
12;180501;180500;38-200;892;662;656;389;267
13;180501;180500;38-200;1458;1043;1035;555;480
14;180501;180500;38-200;764;582;575;451;124
15;180501;180500;38-200;571;404;396;230;166
16;180501;180500;38-200;706;491;486;334;152
17;180501;180500;38-200;1353;994;988;636;352
18;180501;180500;38-200;1332;1020;1003;533;470
19;180501;180500;38-200;1338;939;922;477;445
20;180501;180500;38-200;599;394;393;218;175
21;180501;180500;38-200;498;337;335;175;160
22;180501;180500;38-200;1142;731;722;444;278
23;180501;180500;38-200;718;486;482;279;203
24;180501;180500;38-200;649;408;403;253;150
25;180501;180500;38-200;787;495;492;347;145
26;180501;180500;38-200;843;528;523;347;176
27;180501;180500;38-200;418;296;295;194;101
28;180501;180500;38-200;237;69;68;56;12
1;180502;180500;38-212;584;402;401;352;49
2;180502;180500;38-212;646;442;441;388;53
3;180502;180500;38-212;914;630;628;595;33
4;180502;180500;38-212;778;482;479;408;71
5;180502;180500;38-212;372;265;261;225;36
6;180502;180500;38-212;496;382;375;323;52
7;180502;180500;38-211;430;311;310;248;62
8;180502;180500;38-212;268;193;192;175;17
9;180502;180500;38-211;475;344;343;302;41
1;180503;180500;38-222;1152;816;816;712;104
2;180503;180500;38-222;472;318;315;265;50
3;180503;180500;38-220;492;349;346;311;35
4;180503;180500;38-220;1727;1223;1219;915;304
5;180503;180500;38-220;397;256;254;208;46
6;180503;180500;38-220;833;590;588;473;115
7;180503;180500;38-220;525;332;332;288;44
8;180503;180500;38-222;366;248;245;233;12
9;180503;180500;38-222;353;205;202;153;49
10;180503;180500;38-222;250;175;172;132;40
11;180503;180500;38-220;130;55;53;38;15
1;180504;180500;38-200;383;298;293;222;71
2;180504;180500;38-200;232;163;163;119;44
3;180504;180500;38-200;668;506;501;351;150
4;180504;180500;38-200;573;391;389;254;135
5;180504;180500;38-203;299;227;227;172;55
6;180504;180500;38-203;417;318;317;257;60
7;180504;180500;38-203;433;299;296;241;55
8;180504;180500;38-203;238;167;167;112;55
9;180504;180500;38-203;738;541;538;390;148
10;180504;180500;38-200;617;448;444;330;114
11;180504;180500;38-200;730;492;487;401;86
12;180504;180500;38-200;532;357;354;254;100
13;180504;180500;38-200;725;521;519;395;124
14;180504;180500;38-200;286;200;199;132;67
15;180504;180500;38-241;884;627;626;573;53
16;180504;180500;38-241;878;587;583;483;100
17;180504;180500;38-241;876;599;598;499;99
18;180504;180500;38-207;781;545;541;405;136
19;180504;180500;38-207;936;684;681;584;97
20;180504;180500;38-200;532;372;371;282;89
21;180504;180500;38-200;442;301;298;262;36
22;180504;180500;38-200;242;184;182;53;129
1;180505;180500;38-213;1095;776;771;608;163
2;180505;180500;38-211;304;224;221;177;44
3;180505;180500;38-214;1130;805;797;685;112
4;180505;180500;38-214;1113;794;787;710;77
5;180505;180500;38-214;441;287;286;252;34
6;180505;180500;38-214;812;585;579;529;50
7;180505;180500;38-213;649;464;463;430;33
8;180505;180500;38-213;1271;889;880;660;220
1;180506;180500;38-232;182;81;80;62;18
2;180506;180500;38-232;610;412;410;287;123
3;180506;180500;38-232;174;112;112;96;16
4;180506;180500;38-232;189;112;108;81;27
5;180506;180500;38-232;256;132;131;105;26
1;180507;180500;38-230;1036;716;712;511;201
2;180507;180500;38-230;306;217;217;183;34
3;180507;180500;38-230;481;328;324;288;36
4;180507;180500;38-230;701;418;413;351;62
5;180507;180500;38-230;927;651;647;559;88
6;180507;180500;38-230;481;341;337;296;41
7;180507;180500;38-230;650;435;430;365;65
8;180507;180500;38-230;366;222;221;192;29
9;180507;180500;38-230;512;363;362;330;32
10;180507;180500;38-230;196;153;152;134;18
11;180507;180500;38-230;347;203;201;179;22
12;180507;180500;38-230;283;202;201;167;34
13;180507;180500;38-230;267;194;192;176;16
14;180507;180500;38-230;242;163;161;125;36
1;180508;180500;38-223;583;400;395;318;77
2;180508;180500;38-223;721;474;471;421;50
3;180508;180500;38-223;498;357;355;305;50
4;180508;180500;38-223;563;365;360;327;33
5;180508;180500;38-223;614;370;369;341;28
6;180508;180500;38-223;398;252;249;210;39
7;180508;180500;38-223;448;316;309;255;54
8;180508;180500;38-223;197;136;136;113;23
1;180509;180500;38-242;1520;1059;1047;730;317
2;180509;180500;38-200;574;374;370;325;45
3;180509;180500;38-242;982;662;660;568;92
4;180509;180500;38-207;1202;847;843;672;171
5;180509;180500;38-243;1195;802;799;595;204
6;180509;180500;38-242;1593;1117;1105;878;227
7;180509;180500;38-211;338;229;228;196;32
8;180509;180500;38-242;687;467;465;351;114
9;180509;180500;38-340;345;255;252;157;95
10;180509;180500;38-243;336;207;205;141;64
11;180509;180500;38-242;406;289;286;220;66
12;180509;180500;38-243;204;122;120;85;35
1;180511;180500;38-204;934;620;618;428;190
2;180511;180500;38-204;1014;704;701;570;131
3;180511;180500;38-204;395;261;261;227;34
4;180511;180500;38-204;871;621;615;565;50
5;180511;180500;38-204;925;584;583;430;153
6;180511;180500;38-204;766;520;513;335;178
7;180511;180500;38-204;502;376;376;341;35
8;180511;180500;38-204;512;365;363;304;59
9;180511;180500;38-204;514;343;341;270;71
10;180511;180500;38-204;552;382;382;307;75
1;180601;180600;36-105;903;631;629;535;94
2;180601;180600;36-105;1334;950;944;770;174
3;180601;180600;36-106;1030;745;743;658;85
4;180601;180600;36-105;755;490;485;403;82
5;180601;180600;36-105;450;303;302;280;22
6;180601;180600;36-105;375;254;253;220;33
7;180601;180600;36-105;595;403;399;347;52
8;180601;180600;36-105;601;384;381;345;36
9;180601;180600;36-105;44;34;33;33;0
1;180602;180600;36-100;1142;795;788;522;266
2;180602;180600;36-100;1095;755;750;480;270
3;180602;180600;36-100;973;646;634;406;228
4;180602;180600;36-100;1051;676;669;417;252
5;180602;180600;36-100;1009;656;650;390;260
6;180602;180600;36-100;1139;730;726;467;259
7;180602;180600;36-100;838;533;529;365;164
8;180602;180600;36-100;850;566;558;364;194
9;180602;180600;36-100;660;466;465;408;57
10;180602;180600;36-100;1148;816;811;661;150
11;180602;180600;36-100;1209;865;861;653;208
12;180602;180600;36-100;942;629;622;471;151
13;180602;180600;36-100;298;209;207;170;37
14;180602;180600;36-100;216;159;158;142;16
15;180602;180600;36-145;164;97;97;80;17
16;180602;180600;36-100;224;151;151;128;23
17;180602;180600;36-100;444;285;282;212;70
18;180602;180600;36-145;922;603;596;469;127
19;180602;180600;36-145;868;576;571;477;94
20;180602;180600;36-145;1152;707;701;590;111
21;180602;180600;36-100;782;520;518;450;68
22;180602;180600;36-100;647;415;414;374;40
23;180602;180600;36-100;594;392;390;253;137
24;180602;180600;36-100;140;46;46;36;10
1;180603;180600;36-110;2113;1339;1321;1038;283
2;180603;180600;36-110;1095;690;686;602;84
3;180603;180600;36-110;528;334;334;314;20
4;180603;180600;36-110;161;122;118;106;12
5;180603;180600;36-110;672;441;440;385;55
6;180603;180600;36-110;667;450;448;414;34
7;180603;180600;36-110;1035;673;670;551;119
8;180603;180600;36-110;1038;660;656;571;85
1;180604;180600;36-147;1168;740;737;583;154
2;180604;180600;36-147;375;281;279;223;56
3;180604;180600;36-107;586;444;443;372;71
4;180604;180600;36-147;626;429;428;370;58
5;180604;180600;36-147;583;400;396;360;36
6;180604;180600;36-147;487;323;322;263;59
7;180604;180600;36-147;328;227;226;200;26
8;180604;180600;36-147;221;157;153;134;19
9;180604;180600;36-147;221;133;133;116;17
1;180605;180600;36-130;1764;1252;1247;959;288
2;180605;180600;36-125;1363;900;895;807;88
3;180605;180600;36-130;585;425;421;374;47
4;180605;180600;36-130;473;337;332;301;31
5;180605;180600;36-130;427;291;288;249;39
6;180605;180600;36-130;187;130;130;121;9
7;180605;180600;36-130;214;149;145;130;15
8;180605;180600;36-130;226;153;151;126;25
9;180605;180600;36-130;29;11;11;4;7
1;180606;180600;36-122;1032;661;657;531;126
2;180606;180600;36-122;508;317;316;281;35
3;180606;180600;36-121;615;420;418;381;37
4;180606;180600;36-121;514;311;308;280;28
5;180606;180600;36-121;995;621;611;527;84
6;180606;180600;36-123;873;495;492;395;97
7;180606;180600;36-122;260;155;153;119;34
1;180701;180700;38-458;627;380;379;252;127
2;180701;180700;38-458;656;465;458;359;99
3;180701;180700;38-458;394;254;252;214;38
4;180701;180700;38-458;571;339;339;311;28
5;180701;180700;38-462;799;566;562;435;127
6;180701;180700;38-458;1056;664;661;594;67
7;180701;180700;38-458;393;270;270;220;50
8;180701;180700;38-458;207;155;154;117;37
9;180701;180700;38-230;210;135;135;119;16
10;180701;180700;38-458;293;190;187;157;30
11;180701;180700;38-457;1733;1207;1202;860;342
12;180701;180700;38-458;906;628;626;448;178
13;180701;180700;38-457;1663;1174;1161;852;309
14;180701;180700;38-458;777;522;519;417;102
1;180702;180700;38-450;824;553;549;317;232
2;180702;180700;38-450;723;504;502;313;189
3;180702;180700;38-450;716;456;451;309;142
4;180702;180700;38-450;824;595;594;445;149
5;180702;180700;38-450;627;405;399;341;58
6;180702;180700;38-450;577;433;432;390;42
7;180702;180700;38-456;567;373;369;304;65
8;180702;180700;38-456;602;414;412;291;121
9;180702;180700;38-451;625;418;415;326;89
10;180702;180700;38-451;708;476;475;329;146
11;180702;180700;38-451;696;429;425;320;105
12;180702;180700;38-450;979;661;657;483;174
13;180702;180700;38-450;886;608;603;539;64
14;180702;180700;38-450;640;363;361;295;66
15;180702;180700;38-454;820;455;452;356;96
1;180703;180700;38-440;2193;1819;1812;1070;742
2;180703;180700;38-440;1537;1044;1037;787;250
3;180703;180700;38-440;1578;1094;1083;831;252
4;180703;180700;38-440;846;550;549;441;108
5;180703;180700;38-440;1056;729;725;626;99
6;180703;180700;38-440;1527;1065;1062;926;136
7;180703;180700;38-440;198;191;190;113;77
1;180704;180700;38-460;999;660;654;401;253
2;180704;180700;38-460;799;547;542;371;171
3;180704;180700;38-460;899;621;609;423;186
4;180704;180700;38-460;1056;731;729;490;239
5;180704;180700;38-460;478;331;330;246;84
6;180704;180700;38-460;565;380;379;285;94
7;180704;180700;38-460;506;334;331;266;65
8;180704;180700;38-460;561;390;388;284;104
9;180704;180700;38-460;590;373;371;280;91
10;180704;180700;38-460;1055;725;722;596;126
11;180704;180700;38-460;937;561;559;389;170
12;180704;180700;38-459;324;197;196;166;30
13;180704;180700;38-404;649;389;388;258;130
14;180704;180700;38-404;667;422;420;232;188
15;180704;180700;38-460;800;537;536;400;136
16;180704;180700;38-460;292;194;192;161;31
17;180704;180700;38-459;264;185;185;166;19
18;180704;180700;38-460;23;10;10;7;3
1;180705;180700;38-420;1797;1331;1324;953;371
2;180705;180700;38-420;1675;1163;1154;842;312
3;180705;180700;38-420;993;742;736;472;264
4;180705;180700;38-420;283;194;194;131;63
5;180705;180700;38-420;290;220;216;153;63
6;180705;180700;38-422;942;708;707;583;124
7;180705;180700;38-420;1061;735;728;579;149
8;180705;180700;38-420;551;363;362;316;46
9;180705;180700;38-420;622;393;389;319;70
10;180705;180700;38-420;318;239;238;217;21
1;180706;180700;38-422;1065;747;742;626;116
2;180706;180700;38-422;1184;809;802;573;229
3;180706;180700;38-422;1078;778;770;523;247
4;180706;180700;38-422;802;601;601;453;148
1;180707;180700;38-455;1742;1270;1261;906;355
2;180707;180700;38-423;1418;1021;1014;728;286
3;180707;180700;38-430;1523;1059;1056;761;295
4;180707;180700;38-455;227;171;169;119;50
5;180707;180700;38-430;1904;1302;1288;896;392
6;180707;180700;38-423;1664;1132;1123;806;317
7;180707;180700;38-423;521;374;371;290;81
8;180707;180700;38-455;908;633;625;425;200
9;180707;180700;38-423;394;279;276;213;63
1;180708;180700;38-480;1952;1399;1391;944;447
2;180708;180700;38-480;845;618;615;471;144
3;180708;180700;38-480;1414;1049;1042;803;239
4;180708;180700;38-483;710;494;490;374;116
5;180708;180700;38-483;414;302;300;259;41
6;180708;180700;38-480;898;577;576;440;136
7;180708;180700;38-481;1462;1149;1143;704;439
8;180708;180700;38-483;927;635;632;530;102
9;180708;180700;38-480;740;457;450;375;75
10;180708;180700;38-481;688;461;453;386;67
11;180708;180700;38-481;1202;886;875;646;229
12;180708;180700;38-480;351;244;242;189;53
13;180708;180700;38-483;553;367;366;280;86
14;180708;180700;38-480;60;48;48;30;18
15;180708;180700;38-480;134;104;103;61;42
16;180708;180700;38-480;70;60;60;37;23
17;180708;180700;38-480;32;32;32;19;13
1;180709;180700;38-406;1978;1328;1311;969;342
2;180709;180700;38-406;510;337;332;240;92
3;180709;180700;38-471;546;368;362;270;92
4;180709;180700;38-471;810;490;487;381;106
5;180709;180700;38-406;909;574;572;411;161
6;180709;180700;38-471;640;449;448;323;125
7;180709;180700;38-471;517;346;343;250;93
8;180709;180700;38-471;258;173;171;113;58
9;180709;180700;38-471;247;162;161;113;48
10;180709;180700;38-471;314;165;165;125;40
11;180709;180700;38-406;391;294;292;214;78
1;180710;180700;38-485;665;431;426;329;97
2;180710;180700;38-485;208;139;139;114;25
3;180710;180700;38-543;132;87;87;45;42
4;180710;180700;38-485;601;398;395;340;55
5;180710;180700;38-543;287;183;180;50;130
1;180801;180800;37-300;1431;1005;1000;654;346
2;180801;180800;37-300;1463;963;955;586;369
3;180801;180800;37-300;1136;733;730;470;260
4;180801;180800;37-300;1130;721;711;405;306
5;180801;180800;37-300;1112;709;706;478;228
6;180801;180800;37-300;1404;1022;1014;676;338
7;180801;180800;37-300;1355;937;926;653;273
8;180801;180800;37-300;737;549;546;381;165
9;180801;180800;37-300;97;69;69;53;16
1;180802;180800;37-306;1251;879;868;734;134
2;180802;180800;37-306;595;414;411;358;53
3;180802;180800;37-306;739;521;516;451;65
4;180802;180800;37-306;887;615;611;505;106
5;180802;180800;37-306;568;404;402;350;52
6;180802;180800;37-306;1384;886;881;757;124
7;180802;180800;37-306;591;423;419;325;94
1;180803;180800;37-303;1284;820;802;633;169
2;180803;180800;37-304;989;684;678;606;72
3;180803;180800;37-304;177;118;117;93;24
4;180803;180800;37-303;445;286;284;257;27
5;180803;180800;37-303;411;266;265;236;29
6;180803;180800;37-303;300;197;194;155;39
7;180803;180800;37-303;229;154;154;119;35
8;180803;180800;37-303;181;121;120;91;29
9;180803;180800;37-303;158;115;114;96;18
1;180804;180800;37-300;1424;993;987;818;169
2;180804;180800;37-300;1156;762;759;677;82
3;180804;180800;37-305;980;676;674;553;121
4;180804;180800;37-300;1514;974;964;838;126
5;180804;180800;37-300;1509;1110;1097;901;196
6;180804;180800;37-307;1450;1060;1053;936;117
7;180804;180800;37-307;1278;932;926;761;165
8;180804;180800;37-311;582;425;425;373;52
9;180804;180800;37-311;244;173;173;148;25
10;180804;180800;37-300;695;424;419;340;79
11;180804;180800;37-300;1286;783;781;652;129
12;180804;180800;37-305;668;418;415;334;81
13;180804;180800;37-300;880;492;489;396;93
14;180804;180800;37-110;1060;783;778;711;67
15;180804;180800;37-300;207;113;112;81;31
16;180804;180800;37-307;49;23;22;22;0
1;180805;180800;37-310;1300;788;778;490;288
2;180805;180800;37-310;1315;863;859;565;294
3;180805;180800;37-310;709;461;461;323;138
4;180805;180800;37-310;584;370;367;253;114
5;180805;180800;37-310;1548;1050;1044;946;98
6;180805;180800;37-310;1356;854;849;734;115
7;180805;180800;37-310;653;463;460;401;59
8;180805;180800;37-310;522;387;386;344;42
9;180805;180800;37-310;1226;882;875;742;133
10;180805;180800;37-310;353;286;285;227;58
11;180805;180800;37-311;1302;950;949;868;81
12;180805;180800;37-311;1534;1137;1133;1062;71
13;180805;180800;37-312;446;347;345;323;22
14;180805;180800;37-312;1066;773;771;712;59
15;180805;180800;37-312;544;412;412;386;26
16;180805;180800;37-312;466;351;350;331;19
17;180805;180800;37-310;653;482;480;441;39
1;180901;180900;37-600;1344;897;889;598;291
2;180901;180900;37-600;1280;831;824;495;329
3;180901;180900;37-600;946;648;643;355;288
4;180901;180900;37-600;1414;923;921;498;423
5;180901;180900;37-600;1310;849;843;499;344
6;180901;180900;37-600;1147;805;797;518;279
7;180901;180900;37-600;1224;840;835;505;330
8;180901;180900;37-600;114;55;55;47;8
1;180902;180900;37-611;328;206;205;182;23
2;180902;180900;37-611;1007;572;568;404;164
3;180902;180900;37-611;735;452;450;319;131
4;180902;180900;37-611;1032;649;639;499;140
5;180902;180900;37-611;256;157;156;108;48
6;180902;180900;37-611;545;310;308;234;74
7;180902;180900;37-611;505;336;336;249;87
8;180902;180900;37-611;339;205;205;168;37
9;180902;180900;37-611;322;186;184;144;40
10;180902;180900;37-611;191;120;120;96;24
1;180903;180900;37-620;952;678;676;446;230
2;180903;180900;37-620;1071;687;682;457;225
3;180903;180900;37-622;338;212;208;128;80
4;180903;180900;37-620;384;215;215;171;44
5;180903;180900;37-620;219;136;134;109;25
6;180903;180900;37-620;505;304;298;196;102
7;180903;180900;37-620;190;84;83;63;20
8;180903;180900;37-620;62;49;44;30;14
1;180904;180900;37-621;820;523;520;409;111
2;180904;180900;37-621;383;204;204;181;23
3;180904;180900;37-625;1082;709;708;604;104
4;180904;180900;37-600;972;653;648;477;171
5;180904;180900;37-600;1430;960;946;785;161
6;180904;180900;37-600;837;555;553;398;155
7;180904;180900;37-600;684;412;411;307;104
8;180904;180900;37-600;248;168;168;131;37
9;180904;180900;37-621;215;136;134;106;28
10;180904;180900;37-600;249;167;165;139;26
11;180904;180900;37-625;17;17;17;12;5
1;180905;180900;37-610;1511;962;958;668;290
2;180905;180900;37-610;928;559;555;429;126
3;180905;180900;37-610;796;485;481;405;76
4;180905;180900;37-614;317;217;216;169;47
5;180905;180900;37-613;725;446;445;319;126
6;180905;180900;37-614;333;189;188;145;43
7;180905;180900;37-613;271;176;176;145;31
8;180905;180900;37-610;884;547;542;451;91
9;180905;180900;37-613;147;64;60;42;18
1;180906;180900;37-630;461;317;315;269;46
2;180906;180900;37-630;243;141;141;117;24
3;180906;180900;37-630;1192;802;796;537;259
4;180906;180900;37-630;978;662;653;438;215
5;180906;180900;37-630;705;461;457;359;98
6;180906;180900;37-630;440;272;269;213;56
7;180906;180900;37-630;439;278;277;205;72
8;180906;180900;37-630;162;118;117;98;19
1;180907;180900;37-632;888;537;535;410;125
2;180907;180900;37-632;633;401;400;341;59
3;180907;180900;37-632;438;296;296;247;49
4;180907;180900;37-632;333;243;240;206;34
5;180907;180900;37-632;384;221;219;185;34
6;180907;180900;37-632;458;278;278;233;45
1;180908;180900;37-627;253;170;167;124;43
2;180908;180900;37-626;667;440;438;378;60
3;180908;180900;37-626;482;330;330;271;59
4;180908;180900;37-627;300;212;210;178;32
5;180908;180900;37-627;682;452;449;342;107
6;180908;180900;37-631;213;136;136;115;21
7;180908;180900;37-627;187;117;117;99;18
1;181001;181000;37-100;1159;891;887;587;300
2;181001;181000;37-100;910;671;668;370;298
3;181001;181000;37-100;826;609;601;365;236
4;181001;181000;37-100;963;735;730;452;278
5;181001;181000;37-100;856;607;599;342;257
6;181001;181000;37-100;1071;792;785;521;264
7;181001;181000;37-100;1126;883;876;545;331
8;181001;181000;37-100;1371;937;926;517;409
9;181001;181000;37-100;938;689;687;457;230
10;181001;181000;37-100;1012;753;752;472;280
11;181001;181000;37-100;995;754;752;486;266
12;181001;181000;37-100;1364;913;905;657;248
13;181001;181000;37-100;758;533;526;318;208
14;181001;181000;37-100;68;41;39;30;9
15;181001;181000;37-100;226;51;51;34;17
1;181002;181000;37-114;2029;1431;1425;1155;270
2;181002;181000;37-100;1447;1008;997;735;262
3;181002;181000;37-114;1298;909;905;765;140
4;181002;181000;37-114;1036;713;710;602;108
5;181002;181000;37-100;786;569;562;426;136
1;181003;181000;37-125;1414;965;959;722;237
2;181003;181000;37-100;692;505;500;372;128
3;181003;181000;37-100;1289;958;951;735;216
4;181003;181000;37-127;1107;820;813;649;164
5;181003;181000;37-126;1603;1178;1171;1050;121
6;181003;181000;37-126;1176;914;909;771;138
7;181003;181000;37-126;555;408;399;345;54
8;181003;181000;37-127;1144;876;868;658;210
1;181004;181000;37-122;1134;837;824;602;222
2;181004;181000;37-122;1143;850;846;669;177
3;181004;181000;37-124;656;503;501;430;71
4;181004;181000;37-100;1399;988;978;766;212
5;181004;181000;37-123;1164;771;762;579;183
6;181004;181000;37-112;1357;992;990;830;160
7;181004;181000;37-112;1345;987;978;852;126
8;181004;181000;37-124;1491;1148;1145;932;213
9;181004;181000;37-124;1428;1060;1046;819;227
10;181004;181000;37-112;907;657;655;542;113
11;181004;181000;37-100;1178;887;884;627;257
12;181004;181000;37-100;1246;929;920;601;319
13;181004;181000;37-100;2122;1625;1615;1276;339
1;181005;181000;37-120;1370;1058;1050;817;233
2;181005;181000;37-120;1692;1301;1291;1098;193
3;181005;181000;37-121;1477;1035;1026;875;151
4;181005;181000;37-121;322;218;218;180;38
1;181006;181000;37-111;1376;1012;1003;750;253
2;181006;181000;37-111;1127;780;769;585;184
3;181006;181000;37-111;853;585;584;514;70
4;181006;181000;37-111;839;585;579;526;53
5;181006;181000;37-110;523;391;389;359;30
6;181006;181000;37-111;453;322;322;283;39
7;181006;181000;37-111;375;236;234;205;29
1;181007;181000;37-110;1355;874;869;682;187
2;181007;181000;37-110;1448;1048;1042;765;277
3;181007;181000;37-110;510;394;391;291;100
4;181007;181000;37-110;872;640;639;552;87
5;181007;181000;37-110;1175;859;848;671;177
6;181007;181000;37-110;54;13;13;12;1
1;181101;181100;39-300;819;591;582;449;133
2;181101;181100;39-300;1678;1240;1228;815;413
3;181101;181100;39-300;1653;1184;1176;683;493
4;181101;181100;39-300;1084;592;580;349;231
5;181101;181100;39-300;1236;806;802;505;297
6;181101;181100;39-300;1120;720;712;456;256
7;181101;181100;39-300;1299;910;900;555;345
8;181101;181100;39-300;2318;1703;1685;970;715
9;181101;181100;39-300;2018;1478;1466;804;662
10;181101;181100;39-300;1285;893;889;523;366
11;181101;181100;39-300;1639;1151;1146;719;427
12;181101;181100;39-300;1681;1225;1218;750;468
13;181101;181100;39-300;1967;1348;1342;779;563
14;181101;181100;39-300;1703;1235;1227;724;503
15;181101;181100;39-300;1200;857;849;519;330
16;181101;181100;39-300;1157;757;748;431;317
17;181101;181100;39-300;1264;873;867;534;333
18;181101;181100;39-300;1192;800;795;495;300
19;181101;181100;39-300;1528;1017;1006;582;424
20;181101;181100;39-300;1071;692;687;396;291
21;181101;181100;39-300;1447;1009;1003;587;416
22;181101;181100;39-300;882;645;639;428;211
23;181101;181100;39-300;252;157;156;107;49
24;181101;181100;39-300;1104;811;800;530;270
25;181101;181100;39-300;1392;993;988;662;326
26;181101;181100;39-300;1854;1420;1407;853;554
27;181101;181100;39-300;1428;1074;1068;632;436
28;181101;181100;39-300;1607;1313;1301;646;655
29;181101;181100;39-300;1812;1338;1329;772;557
30;181101;181100;39-300;1960;1406;1390;884;506
31;181101;181100;39-300;407;143;140;91;49
32;181101;181100;39-300;135;66;65;49;16
33;181101;181100;39-300;29;12;11;6;5
1;181102;181100;39-305;1198;848;837;625;212
2;181102;181100;39-305;431;285;284;218;66
3;181102;181100;39-305;173;134;130;111;19
4;181102;181100;39-305;388;277;276;222;54
5;181102;181100;39-305;264;173;171;129;42
6;181102;181100;39-305;221;166;165;123;42
7;181102;181100;39-305;485;318;317;235;82
8;181102;181100;39-305;190;128;127;102;25
9;181102;181100;39-305;175;124;120;87;33
10;181102;181100;39-305;588;436;431;318;113
1;181103;181100;39-304;1522;1093;1081;806;275
2;181103;181100;39-304;1017;696;694;592;102
3;181103;181100;39-304;395;274;271;226;45
4;181103;181100;39-304;414;256;252;226;26
5;181103;181100;39-306;536;371;367;321;46
6;181103;181100;39-304;652;438;436;385;51
7;181103;181100;39-304;307;233;232;183;49
8;181103;181100;39-306;332;246;246;216;30
9;181103;181100;39-304;194;141;141;126;15
1;181104;181100;39-307;374;254;252;211;41
2;181104;181100;39-307;301;201;200;179;21
3;181104;181100;39-307;237;175;175;157;18
4;181104;181100;39-307;237;181;177;142;35
5;181104;181100;39-307;448;329;322;268;54
6;181104;181100;39-307;359;257;255;209;46
7;181104;181100;39-307;130;80;80;63;17
1;181105;181100;39-331;1544;1124;1112;851;261
2;181105;181100;39-331;2149;1518;1504;1012;492
3;181105;181100;39-331;571;395;392;272;120
4;181105;181100;39-300;852;577;575;452;123
5;181105;181100;39-300;1384;944;934;690;244
6;181105;181100;39-300;1667;1209;1200;852;348
7;181105;181100;39-300;1031;735;730;513;217
8;181105;181100;39-300;856;620;612;425;187
9;181105;181100;39-300;267;205;204;183;21
1;181106;181100;39-340;1024;711;706;569;137
2;181106;181100;39-340;414;282;282;244;38
3;181106;181100;39-340;165;114;114;92;22
4;181106;181100;39-340;163;118;118;103;15
5;181106;181100;39-340;277;181;181;162;19
6;181106;181100;39-340;214;140;140;122;18
7;181106;181100;39-340;275;195;191;164;27
8;181106;181100;39-340;182;134;133;115;18
9;181106;181100;39-340;819;518;514;416;98
10;181106;181100;39-340;267;195;194;170;24
11;181106;181100;39-340;161;114;114;98;16
1;181107;181100;39-320;1313;904;899;678;221
2;181107;181100;39-320;625;414;412;336;76
3;181107;181100;39-322;1066;746;742;547;195
4;181107;181100;39-321;1978;1392;1382;1055;327
5;181107;181100;39-320;806;579;578;523;55
6;181107;181100;39-322;738;538;533;446;87
7;181107;181100;39-321;726;485;480;392;88
8;181107;181100;39-320;765;561;557;498;59
9;181107;181100;39-320;602;402;400;369;31
10;181107;181100;39-320;186;136;135;104;31
11;181107;181100;39-320;178;134;133;122;11
12;181107;181100;39-320;8;7;7;2;5
1;181108;181100;39-310;1163;852;845;607;238
2;181108;181100;39-310;879;639;634;560;74
3;181108;181100;39-308;531;382;382;348;34
4;181108;181100;39-315;1179;782;778;685;93
5;181108;181100;39-315;520;370;369;347;22
6;181108;181100;39-311;694;457;456;356;100
7;181108;181100;39-311;684;467;462;375;87
8;181108;181100;39-312;671;450;445;346;99
9;181108;181100;39-312;518;332;331;262;69
10;181108;181100;39-312;1324;818;809;650;159
11;181108;181100;39-310;619;418;415;338;77
12;181108;181100;39-308;367;248;247;188;59
13;181108;181100;39-310;1338;966;957;709;248
14;181108;181100;39-310;233;170;167;149;18
1;181109;181100;39-332;855;593;589;470;119
2;181109;181100;39-331;1460;1105;1096;782;314
3;181109;181100;39-331;566;367;363;275;88
4;181109;181100;39-307;599;430;429;361;68
5;181109;181100;39-332;1030;744;739;622;117
6;181109;181100;39-332;494;353;352;314;38
7;181109;181100;39-333;455;329;329;309;20
8;181109;181100;39-332;794;589;586;450;136
1;181110;181100;39-308;1289;920;916;759;157
2;181110;181100;39-308;550;384;380;336;44
3;181110;181100;39-308;747;494;493;426;67
4;181110;181100;39-308;609;395;392;327;65
5;181110;181100;39-308;661;426;426;375;51
6;181110;181100;39-308;547;384;383;342;41
7;181110;181100;39-308;293;198;196;136;60
8;181110;181100;39-308;433;276;274;238;36
9;181110;181100;39-308;189;137;136;113;23
10;181110;181100;39-308;232;165;162;113;49
11;181110;181100;39-308;305;215;211;187;24
1;181201;181200;37-413;626;366;364;290;74
2;181201;181200;37-413;366;217;216;189;27
3;181201;181200;37-413;364;245;243;196;47
4;181201;181200;37-413;309;169;168;124;44
5;181201;181200;37-413;450;302;299;245;54
6;181201;181200;37-413;519;329;326;256;70
7;181201;181200;37-413;243;167;166;153;13
8;181201;181200;37-413;261;181;180;162;18
9;181201;181200;37-413;258;171;169;150;19
10;181201;181200;37-413;203;117;117;103;14
11;181201;181200;37-413;253;159;158;135;23
12;181201;181200;37-413;216;140;138;125;13
13;181201;181200;37-413;172;123;123;115;8
14;181201;181200;37-413;247;158;156;133;23
1;181202;181200;37-405;917;551;543;412;131
2;181202;181200;37-405;479;322;322;249;73
3;181202;181200;37-405;268;170;168;151;17
4;181202;181200;37-405;508;305;303;251;52
5;181202;181200;37-405;461;283;278;245;33
6;181202;181200;37-405;428;248;245;175;70
7;181202;181200;37-405;536;312;309;256;53
8;181202;181200;37-405;195;118;114;78;36
9;181202;181200;37-405;274;166;166;127;39
1;181203;181200;37-430;1161;797;793;718;75
2;181203;181200;37-430;1297;988;985;922;63
3;181203;181200;37-430;679;469;467;433;34
4;181203;181200;37-430;558;389;386;359;27
5;181203;181200;37-430;681;494;491;452;39
6;181203;181200;37-430;541;436;431;408;23
7;181203;181200;37-430;435;328;327;302;25
8;181203;181200;37-430;351;255;253;221;32
9;181203;181200;37-430;415;308;308;296;12
10;181203;181200;37-430;727;492;490;455;35
11;181203;181200;37-430;362;222;221;207;14
12;181203;181200;37-430;270;161;161;148;13
13;181203;181200;37-430;17;7;6;6;0
1;181204;181200;37-418;701;443;440;320;120
2;181204;181200;37-418;541;339;336;282;54
3;181204;181200;37-418;642;411;409;349;60
4;181204;181200;37-418;476;336;336;303;33
5;181204;181200;37-418;256;179;178;150;28
6;181204;181200;37-418;165;108;108;92;16
7;181204;181200;37-418;217;112;112;86;26
8;181204;181200;37-418;221;146;146;124;22
1;181205;181200;37-400;1244;853;847;482;365
2;181205;181200;37-400;525;301;297;171;126
3;181205;181200;37-400;1273;838;833;509;324
4;181205;181200;37-400;995;672;668;455;213
5;181205;181200;37-400;1423;945;939;664;275
6;181205;181200;37-400;1154;771;766;466;300
7;181205;181200;37-400;1077;774;765;544;221
8;181205;181200;37-400;1579;1022;1018;671;347
9;181205;181200;37-400;749;491;487;364;123
10;181205;181200;37-400;807;533;532;398;134
11;181205;181200;37-400;1071;708;702;487;215
12;181205;181200;37-400;677;458;457;338;119
13;181205;181200;37-400;1517;949;943;754;189
14;181205;181200;37-400;1141;797;793;683;110
15;181205;181200;37-400;250;163;161;137;24
16;181205;181200;37-400;314;196;195;150;45
17;181205;181200;37-400;238;157;157;127;30
18;181205;181200;37-400;97;43;42;34;8
1;181206;181200;37-420;1073;688;684;475;209
2;181206;181200;37-420;779;501;500;353;147
3;181206;181200;37-420;992;591;589;387;202
4;181206;181200;37-420;890;573;567;400;167
5;181206;181200;37-420;759;461;457;291;166
6;181206;181200;37-420;647;405;402;291;111
7;181206;181200;37-420;1354;755;753;594;159
8;181206;181200;37-420;939;597;593;492;101
1;181207;181200;37-410;1123;715;707;522;185
2;181207;181200;37-410;1028;652;646;536;110
3;181207;181200;37-410;501;315;313;254;59
4;181207;181200;37-410;556;371;368;309;59
5;181207;181200;37-410;571;353;348;278;70
6;181207;181200;37-410;750;440;438;321;117
7;181207;181200;37-410;231;159;157;129;28
8;181207;181200;37-410;340;175;171;142;29
9;181207;181200;37-410;356;227;224;187;37
10;181207;181200;37-410;300;190;190;164;26
11;181207;181200;37-410;212;140;139;119;20
12;181207;181200;37-410;193;131;129;115;14
13;181207;181200;37-410;164;103;101;82;19
1;181301;181300;37-740;850;560;555;440;115
2;181301;181300;37-740;904;561;555;455;100
3;181301;181300;37-740;560;368;366;310;56
4;181301;181300;37-744;322;215;215;187;28
5;181301;181300;37-751;347;196;195;163;32
6;181301;181300;37-751;220;127;127;105;22
7;181301;181300;37-751;300;208;208;187;21
8;181301;181300;37-740;209;144;144;119;25
9;181301;181300;37-740;392;247;246;231;15
10;181301;181300;37-740;339;212;212;176;36
11;181301;181300;37-740;191;121;120;106;14
12;181301;181300;37-740;216;146;146;109;37
1;181302;181300;37-752;701;443;439;349;90
2;181302;181300;37-753;593;356;353;301;52
3;181302;181300;37-750;874;605;600;416;184
4;181302;181300;37-750;1636;1081;1070;856;214
5;181302;181300;37-750;335;220;219;172;47
6;181302;181300;37-751;323;193;193;177;16
7;181302;181300;37-752;333;211;211;166;45
8;181302;181300;37-750;323;190;190;170;20
9;181302;181300;37-750;970;625;620;488;132
10;181302;181300;37-750;389;246;241;218;23
11;181302;181300;37-750;190;115;114;96;18
12;181302;181300;37-750;226;126;125;97;28
1;181303;181300;37-734;555;359;359;275;84
2;181303;181300;37-743;428;263;263;220;43
3;181303;181300;37-734;350;220;220;152;68
4;181303;181300;37-743;474;296;296;218;78
5;181303;181300;37-743;295;217;216;177;39
6;181303;181300;37-742;295;196;193;131;62
7;181303;181300;37-734;365;222;222;169;53
8;181303;181300;37-734;220;156;156;109;47
9;181303;181300;37-743;206;134;133;116;17
10;181303;181300;37-734;418;229;228;183;45
11;181303;181300;37-734;250;175;173;145;28
12;181303;181300;37-742;261;176;174;138;36
13;181303;181300;37-743;52;35;35;26;9
1;181304;181300;37-741;799;573;567;367;200
2;181304;181300;37-700;709;520;515;302;213
3;181304;181300;37-741;1122;735;725;555;170
4;181304;181300;37-741;471;295;291;237;54
5;181304;181300;37-741;406;253;250;160;90
6;181304;181300;37-741;377;287;284;165;119
1;181305;181300;37-754;609;402;400;344;56
2;181305;181300;37-754;515;314;311;285;26
3;181305;181300;37-755;401;285;284;187;97
4;181305;181300;37-741;167;95;95;79;16
5;181305;181300;37-755;565;396;392;349;43
6;181305;181300;37-755;469;306;306;264;42
7;181305;181300;37-754;338;208;207;189;18
8;181305;181300;37-755;155;75;75;64;11
9;181305;181300;37-755;367;251;250;224;26
1;181306;181300;37-705;420;280;280;206;74
2;181306;181300;37-705;419;266;265;189;76
3;181306;181300;37-705;405;286;285;214;71
4;181306;181300;37-723;456;271;269;213;56
5;181306;181300;37-732;1026;704;702;541;161
6;181306;181300;37-732;898;581;575;438;137
7;181306;181300;37-705;528;341;339;264;75
8;181306;181300;37-732;651;443;436;374;62
9;181306;181300;37-732;220;178;177;33;144
1;181307;181300;37-716;973;710;709;502;207
2;181307;181300;37-716;704;449;447;373;74
3;181307;181300;37-716;728;499;497;395;102
4;181307;181300;37-716;716;520;517;410;107
5;181307;181300;37-716;545;390;388;333;55
6;181307;181300;37-716;304;223;221;167;54
7;181307;181300;37-716;381;219;215;156;59
8;181307;181300;37-717;330;212;210;177;33
9;181307;181300;37-717;360;239;238;178;60
10;181307;181300;37-717;583;382;381;331;50
11;181307;181300;37-717;238;151;151;118;33
12;181307;181300;37-717;314;208;206;180;26
13;181307;181300;37-717;379;275;270;179;91
1;181308;181300;37-700;448;295;293;214;79
2;181308;181300;37-705;286;196;192;127;65
3;181308;181300;37-733;448;312;310;205;105
4;181308;181300;37-733;759;494;486;344;142
5;181308;181300;37-733;405;287;285;189;96
6;181308;181300;37-733;641;477;474;365;109
7;181308;181300;37-733;316;206;206;180;26
8;181308;181300;37-700;498;367;365;278;87
9;181308;181300;37-700;488;343;339;226;113
10;181308;181300;37-700;383;254;254;193;61
11;181308;181300;37-700;1853;1376;1370;784;586
12;181308;181300;37-713;751;484;482;395;87
13;181308;181300;37-733;251;174;173;149;24
14;181308;181300;37-733;270;177;176;124;52
1;181309;181300;37-724;229;152;152;121;31
2;181309;181300;37-724;795;447;444;331;113
3;181309;181300;37-723;569;335;334;272;62
4;181309;181300;37-723;959;580;579;413;166
5;181309;181300;37-723;192;118;118;95;23
6;181309;181300;37-723;160;100;100;95;5
1;181310;181300;37-713;230;149;145;114;31
2;181310;181300;37-722;1275;846;840;657;183
3;181310;181300;37-710;650;465;461;330;131
4;181310;181300;37-710;589;416;412;285;127
5;181310;181300;37-713;645;423;420;351;69
6;181310;181300;37-713;769;474;473;380;93
7;181310;181300;37-712;776;534;531;427;104
8;181310;181300;37-722;1030;682;681;566;115
9;181310;181300;37-710;1220;851;849;543;306
10;181310;181300;37-710;1185;870;864;584;280
11;181310;181300;37-710;1180;857;851;572;279
12;181310;181300;37-710;186;81;80;61;19
1;181401;181400;37-200;786;563;553;363;190
2;181401;181400;37-200;608;425;423;262;161
3;181401;181400;37-200;731;490;489;312;177
4;181401;181400;37-200;765;537;533;325;208
5;181401;181400;37-200;1398;907;901;598;303
6;181401;181400;37-200;798;538;535;328;207
7;181401;181400;37-200;883;619;616;407;209
8;181401;181400;37-200;827;578;572;411;161
9;181401;181400;37-200;810;566;561;355;206
10;181401;181400;37-200;957;709;703;446;257
11;181401;181400;37-200;1227;901;893;555;338
12;181401;181400;37-200;794;533;530;346;184
13;181401;181400;37-200;579;405;399;316;83
14;181401;181400;37-200;118;73;72;55;17
1;181402;181400;37-534;885;571;567;432;135
2;181402;181400;37-534;565;354;347;285;62
3;181402;181400;37-534;1086;727;726;596;130
4;181402;181400;37-534;370;243;242;196;46
5;181402;181400;37-534;173;88;87;68;19
1;181403;181400;37-207;1183;828;822;619;203
2;181403;181400;37-207;499;348;344;282;62
3;181403;181400;37-207;292;171;168;133;35
4;181403;181400;37-220;375;239;238;192;46
5;181403;181400;37-200;919;689;688;609;79
6;181403;181400;37-207;208;140;139;124;15
1;181404;181400;37-232;1373;940;935;694;241
2;181404;181400;37-231;419;298;297;227;70
3;181404;181400;37-230;308;203;202;144;58
4;181404;181400;37-230;671;439;437;339;98
5;181404;181400;37-232;184;125;124;106;18
6;181404;181400;37-232;167;118;116;89;27
7;181404;181400;37-230;331;210;208;148;60
1;181405;181400;37-220;1082;707;703;447;256
2;181405;181400;37-220;879;587;584;432;152
3;181405;181400;37-222;1181;788;782;611;171
4;181405;181400;37-224;860;537;533;370;163
5;181405;181400;37-223;706;471;468;381;87
6;181405;181400;37-206;1302;781;771;561;210
7;181405;181400;37-225;802;550;549;381;168
8;181405;181400;37-220;406;285;283;210;73
9;181405;181400;37-220;1241;848;846;528;318
10;181405;181400;37-220;403;271;270;208;62
11;181405;181400;37-220;264;163;161;130;31
12;181405;181400;37-206;146;105;103;94;9
1;181406;181400;37-200;591;418;416;364;52
2;181406;181400;37-200;1326;933;929;756;173
3;181406;181400;37-200;1558;1090;1084;877;207
4;181406;181400;37-200;274;216;213;178;35
5;181406;181400;37-200;979;679;674;569;105
6;181406;181400;37-200;1115;867;863;766;97
7;181406;181400;37-200;1616;1118;1110;881;229
8;181406;181400;37-200;1245;889;879;703;176
9;181406;181400;37-200;666;487;482;434;48
10;181406;181400;37-200;600;414;413;374;39
11;181406;181400;37-200;1376;963;955;766;189
1;181407;181400;37-530;334;216;214;168;46
2;181407;181400;37-530;418;320;319;249;70
3;181407;181400;37-530;371;246;244;212;32
4;181407;181400;37-530;633;431;427;326;101
5;181407;181400;37-530;358;240;238;181;57
6;181407;181400;37-530;543;311;309;241;68
7;181407;181400;37-530;527;352;348;316;32
8;181407;181400;37-530;1565;1052;1044;666;378
9;181407;181400;37-530;572;404;400;335;65
1;181408;181400;37-204;956;672;670;579;91
2;181408;181400;37-204;1041;695;691;598;93
3;181408;181400;37-203;1620;1180;1176;1028;148
4;181408;181400;37-203;900;628;621;547;74
5;181408;181400;37-204;209;146;144;122;22
6;181408;181400;37-203;677;498;496;433;63
7;181408;181400;37-204;546;341;341;300;41
8;181408;181400;37-204;221;139;139;120;19
9;181408;181400;37-204;199;137;135;115;20
1;181409;181400;37-205;1135;861;855;690;165
2;181409;181400;37-205;820;552;552;384;168
3;181409;181400;37-200;972;691;686;569;117
4;181409;181400;37-200;692;492;481;405;76
5;181409;181400;37-205;540;363;363;300;63
6;181409;181400;37-205;490;335;333;288;45
7;181409;181400;37-205;322;240;239;216;23
8;181409;181400;37-205;325;266;264;225;39
9;181409;181400;37-205;198;141;141;119;22
1;181501;181500;39-124;816;572;571;462;109
2;181501;181500;39-120;549;417;411;306;105
3;181501;181500;39-127;1026;696;693;508;185
4;181501;181500;39-124;967;707;702;597;105
5;181501;181500;39-124;366;269;267;247;20
6;181501;181500;39-124;483;322;321;284;37
7;181501;181500;39-124;669;471;468;408;60
8;181501;181500;39-124;423;348;348;312;36
9;181501;181500;39-124;552;404;403;343;60
1;181502;181500;39-103;1333;907;901;685;216
2;181502;181500;39-103;847;558;553;445;108
3;181502;181500;39-104;579;402;401;367;34
4;181502;181500;39-104;973;705;703;621;82
5;181502;181500;39-104;190;121;120;93;27
6;181502;181500;39-122;714;508;503;448;55
7;181502;181500;39-104;193;141;141;120;21
8;181502;181500;39-120;243;199;198;169;29
9;181502;181500;39-103;594;409;408;348;60
1;181503;181500;39-102;901;583;579;482;97
2;181503;181500;39-102;1629;1148;1139;910;229
3;181503;181500;39-106;1037;708;707;617;90
4;181503;181500;39-100;343;239;237;195;42
5;181503;181500;39-107;608;442;438;391;47
6;181503;181500;39-107;740;586;584;525;59
7;181503;181500;39-107;679;512;508;474;34
8;181503;181500;39-107;1015;719;710;604;106
9;181503;181500;39-105;935;667;660;583;77
10;181503;181500;39-105;698;517;516;469;47
11;181503;181500;39-100;549;422;419;316;103
12;181503;181500;39-100;656;497;494;437;57
13;181503;181500;39-100;684;523;521;338;183
14;181503;181500;39-100;1054;742;733;549;184
15;181503;181500;39-100;1409;982;977;796;181
16;181503;181500;39-100;690;494;487;376;111
17;181503;181500;39-100;1481;1101;1090;788;302
18;181503;181500;39-100;1279;867;860;552;308
19;181503;181500;39-100;466;333;328;211;117
20;181503;181500;39-100;1137;836;825;567;258
21;181503;181500;39-100;786;605;601;393;208
22;181503;181500;39-100;516;356;355;262;93
23;181503;181500;39-100;1246;881;867;578;289
1;181504;181500;39-120;717;522;514;367;147
2;181504;181500;39-120;739;506;501;303;198
3;181504;181500;39-120;669;494;491;335;156
4;181504;181500;39-120;1312;944;939;581;358
5;181504;181500;39-120;998;734;727;502;225
6;181504;181500;39-120;1301;935;922;658;264
7;181504;181500;39-120;1302;979;973;835;138
8;181504;181500;39-120;778;546;542;448;94
9;181504;181500;39-120;548;383;383;316;67
10;181504;181500;39-120;1087;787;781;656;125
11;181504;181500;39-127;765;559;555;480;75
12;181504;181500;39-120;311;220;218;197;21
13;181504;181500;39-123;145;111;110;95;15
14;181504;181500;39-123;1203;908;903;795;108
15;181504;181500;39-120;841;612;609;536;73
16;181504;181500;39-127;1186;805;798;629;169
17;181504;181500;39-120;910;651;645;548;97
18;181504;181500;39-122;218;174;174;163;11
19;181504;181500;39-126;568;404;402;371;31
20;181504;181500;39-126;1270;977;975;908;67
21;181504;181500;39-126;1125;853;846;806;40
22;181504;181500;39-122;79;63;53;44;9
23;181504;181500;39-120;92;32;30;25;5
1;181505;181500;39-106;651;462;458;421;37
2;181505;181500;39-106;1082;810;808;748;60
3;181505;181500;39-110;1554;1070;1060;872;188
4;181505;181500;39-111;1718;1108;1099;970;129
5;181505;181500;39-110;1053;739;732;676;56
1;181601;181600;36-065;1540;1036;1031;741;290
2;181601;181600;36-065;720;522;517;338;179
3;181601;181600;36-065;1661;1203;1194;843;351
4;181601;181600;36-065;695;494;490;457;33
5;181601;181600;36-065;71;53;50;40;10
1;181602;181600;36-030;1647;1153;1144;850;294
2;181602;181600;36-030;561;384;384;283;101
3;181602;181600;36-030;1356;1009;1003;804;199
4;181602;181600;36-030;1035;712;707;524;183
5;181602;181600;36-030;660;450;448;366;82
6;181602;181600;36-030;1023;751;747;618;129
7;181602;181600;36-030;1048;686;685;607;78
8;181602;181600;36-030;480;358;357;295;62
9;181602;181600;36-030;662;442;441;414;27
1;181603;181600;36-040;1945;1367;1354;906;448
2;181603;181600;36-040;1740;1285;1277;730;547
3;181603;181600;36-040;1010;818;812;530;282
4;181603;181600;36-041;484;362;360;240;120
5;181603;181600;36-040;1353;967;957;707;250
6;181603;181600;36-040;1088;842;835;563;272
7;181603;181600;36-047;2240;1679;1666;1304;362
8;181603;181600;36-046;1206;899;890;748;142
9;181603;181600;36-046;1216;905;895;758;137
10;181603;181600;36-046;1175;887;883;672;211
11;181603;181600;36-047;1250;979;965;589;376
12;181603;181600;35-106;1457;1146;1126;677;449
1;181604;181600;36-016;1530;1165;1149;833;316
2;181604;181600;36-016;1434;1083;1072;845;227
3;181604;181600;36-017;797;565;564;430;134
4;181604;181600;36-017;738;519;516;424;92
5;181604;181600;36-017;569;409;405;315;90
6;181604;181600;36-016;258;195;195;161;34
7;181604;181600;36-016;64;34;34;31;3
1;181605;181600;36-068;845;567;563;429;134
2;181605;181600;36-065;329;226;223;187;36
3;181605;181600;36-069;398;246;244;216;28
4;181605;181600;36-067;770;533;531;418;113
5;181605;181600;36-067;797;567;565;503;62
6;181605;181600;36-068;272;155;153;129;24
7;181605;181600;36-065;941;558;558;458;100
8;181605;181600;36-065;373;245;244;217;27
9;181605;181600;36-065;275;210;208;177;31
10;181605;181600;36-065;151;104;104;88;16
1;181606;181600;36-060;754;562;559;374;185
2;181606;181600;36-060;1449;1085;1077;786;291
3;181606;181600;36-060;1073;786;781;492;289
4;181606;181600;36-060;1165;868;859;597;262
5;181606;181600;36-060;1247;1022;1014;538;476
6;181606;181600;36-060;581;438;432;362;70
7;181606;181600;36-060;637;472;467;310;157
8;181606;181600;36-060;273;206;203;131;72
9;181606;181600;36-060;660;483;478;325;153
10;181606;181600;36-060;425;329;328;239;89
11;181606;181600;36-003;306;217;217;196;21
12;181606;181600;36-130;355;255;254;240;14
13;181606;181600;36-003;1263;893;884;722;162
14;181606;181600;36-060;1535;1137;1132;946;186
15;181606;181600;36-061;1866;1438;1429;1140;289
16;181606;181600;36-054;1110;856;850;564;286
17;181606;181600;36-060;53;53;53;32;21
18;181606;181600;36-060;24;24;24;17;7
1;181607;181600;36-024;451;341;338;293;45
2;181607;181600;36-024;1118;865;859;727;132
3;181607;181600;36-024;1006;790;779;706;73
4;181607;181600;36-024;228;187;187;160;27
5;181607;181600;36-025;437;325;324;283;41
6;181607;181600;36-025;573;421;420;372;48
7;181607;181600;36-025;778;580;576;483;93
8;181607;181600;36-025;726;505;501;429;72
1;181608;181600;36-053;893;592;589;521;68
2;181608;181600;36-053;1075;795;790;746;44
3;181608;181600;36-053;607;444;437;387;50
4;181608;181600;36-053;646;468;467;419;48
5;181608;181600;36-053;1254;790;784;692;92
6;181608;181600;36-053;734;526;521;460;61
1;181609;181600;36-007;1802;1300;1290;804;486
2;181609;181600;36-007;2373;1876;1852;1102;750
3;181609;181600;36-007;1623;1269;1254;927;327
4;181609;181600;36-007;1126;853;846;636;210
5;181609;181600;36-073;1543;1163;1155;737;418
6;181609;181600;36-073;948;734;728;518;210
1;181610;181600;36-042;1894;1386;1378;1036;342
2;181610;181600;36-042;1319;987;984;748;236
3;181610;181600;36-043;1451;1039;1031;840;191
4;181610;181600;36-043;333;235;232;206;26
5;181610;181600;36-042;36;31;30;17;13
1;181611;181600;36-050;1661;1231;1220;887;333
2;181611;181600;36-050;1515;1129;1119;883;236
3;181611;181600;36-051;286;192;192;170;22
4;181611;181600;36-051;414;193;193;162;31
5;181611;181600;36-051;1256;912;907;829;78
6;181611;181600;36-050;1672;1240;1234;1140;94
7;181611;181600;36-052;2128;1623;1616;1394;222
8;181611;181600;36-050;907;665;659;585;74
9;181611;181600;36-050;1408;977;976;874;102
10;181611;181600;36-050;562;411;411;379;32
11;181611;181600;36-050;248;173;172;163;9
12;181611;181600;36-050;452;353;353;308;45
13;181611;181600;36-050;466;337;332;299;33
1;181612;181600;36-072;874;624;622;457;165
2;181612;181600;36-072;1871;1355;1348;887;461
3;181612;181600;36-054;1122;850;837;601;236
4;181612;181600;36-054;1307;971;963;598;365
5;181612;181600;36-071;454;334;329;220;109
6;181612;181600;36-071;444;301;297;221;76
7;181612;181600;36-071;890;605;595;437;158
8;181612;181600;36-071;2002;1453;1438;993;445
9;181612;181600;36-055;1754;1330;1323;999;324
10;181612;181600;36-055;1686;1220;1214;911;303
1;181613;181600;36-001;2881;2118;2096;1470;626
2;181613;181600;36-062;1463;1146;1136;790;346
3;181613;181600;36-001;1113;869;862;637;225
4;181613;181600;36-002;608;480;467;276;191
5;181613;181600;36-002;2253;1703;1689;1121;568
6;181613;181600;36-002;1770;1285;1273;957;316
7;181613;181600;36-002;861;628;622;466;156
8;181613;181600;36-002;1391;1091;1084;807;277
9;181613;181600;36-004;1904;1427;1417;1097;320
10;181613;181600;36-004;1516;1106;1095;752;343
11;181613;181600;36-001;469;342;341;256;85
12;181613;181600;36-062;1814;1438;1428;930;498
1;181614;181600;36-020;1660;1293;1281;766;515
2;181614;181600;36-020;1594;1240;1226;821;405
3;181614;181600;36-020;1617;1158;1155;824;331
4;181614;181600;36-020;1420;1056;1046;835;211
5;181614;181600;36-020;1122;815;810;640;170
6;181614;181600;36-020;1020;718;709;585;124
1;181701;181700;38-500;1016;617;612;334;278
2;181701;181700;38-500;968;590;585;313;272
3;181701;181700;38-500;1136;740;732;388;344
4;181701;181700;38-500;987;654;648;319;329
5;181701;181700;38-500;1522;1052;1044;625;419
6;181701;181700;38-500;1294;842;833;544;289
7;181701;181700;38-500;1201;786;782;402;380
8;181701;181700;38-500;1286;819;815;487;328
9;181701;181700;38-500;1274;846;843;467;376
10;181701;181700;38-500;940;605;602;278;324
11;181701;181700;38-500;1063;696;691;381;310
12;181701;181700;38-500;1310;794;791;410;381
13;181701;181700;38-500;1146;787;780;388;392
14;181701;181700;38-500;1200;859;851;454;397
15;181701;181700;38-500;1090;755;751;370;381
16;181701;181700;38-500;1079;698;696;360;336
17;181701;181700;38-500;2107;1503;1483;816;667
18;181701;181700;38-500;1316;843;840;506;334
19;181701;181700;38-500;1632;1093;1081;570;511
20;181701;181700;38-500;1191;788;786;467;319
21;181701;181700;38-500;1157;813;802;423;379
22;181701;181700;38-500;204;74;73;41;32
1;181702;181700;38-524;1124;709;704;560;144
2;181702;181700;38-524;910;567;564;435;129
3;181702;181700;38-524;952;641;635;524;111
4;181702;181700;38-524;269;162;160;127;33
1;181703;181700;38-505;1456;979;974;763;211
2;181703;181700;38-505;1161;795;792;591;201
3;181703;181700;38-505;754;528;519;433;86
4;181703;181700;38-505;223;186;183;150;33
5;181703;181700;38-505;240;132;117;74;43
6;181703;181700;38-505;160;92;91;80;11
1;181704;181700;38-543;929;506;502;306;196
2;181704;181700;38-543;163;88;88;59;29
3;181704;181700;38-542;492;244;240;137;103
4;181704;181700;38-543;576;327;325;150;175
5;181704;181700;38-542;841;457;455;242;213
6;181704;181700;38-543;186;93;92;57;35
7;181704;181700;38-542;235;138;137;88;49
8;181704;181700;38-543;260;177;176;30;146
1;181705;181700;38-500;582;415;414;303;111
2;181705;181700;38-504;1634;1094;1090;967;123
3;181705;181700;38-504;615;394;393;320;73
4;181705;181700;38-533;297;207;205;164;41
5;181705;181700;38-500;643;441;438;343;95
6;181705;181700;38-500;398;274;273;165;108
7;181705;181700;38-533;788;526;521;360;161
8;181705;181700;38-500;522;354;354;236;118
9;181705;181700;38-507;608;426;425;355;70
10;181705;181700;38-507;578;367;363;282;81
11;181705;181700;38-507;848;651;643;561;82
12;181705;181700;38-507;971;662;659;547;112
13;181705;181700;38-507;677;444;439;366;73
14;181705;181700;38-500;942;581;576;377;199
15;181705;181700;38-503;198;117;117;93;24
16;181705;181700;38-500;286;183;181;131;50
17;181705;181700;38-503;611;376;372;285;87
18;181705;181700;38-503;469;294;292;221;71
19;181705;181700;38-500;719;475;470;316;154
20;181705;181700;38-534;564;345;341;206;135
21;181705;181700;38-503;236;132;131;95;36
22;181705;181700;38-507;418;271;270;193;77
23;181705;181700;38-507;24;13;12;6;6
1;181706;181700;38-535;1073;691;687;518;169
2;181706;181700;38-535;251;138;138;111;27
3;181706;181700;38-535;182;118;116;94;22
1;181707;181700;38-540;1674;1099;1093;713;380
2;181707;181700;38-540;2087;1360;1349;900;449
3;181707;181700;38-516;911;568;565;449;116
4;181707;181700;38-516;1565;1043;1041;884;157
5;181707;181700;38-516;1060;736;732;608;124
6;181707;181700;38-540;1003;678;673;547;126
7;181707;181700;38-542;495;263;260;139;121
8;181707;181700;38-500;934;628;623;436;187
1;181708;181700;38-530;1419;898;892;581;311
2;181708;181700;38-530;949;652;648;529;119
3;181708;181700;38-530;616;399;394;224;170
4;181708;181700;38-530;1180;790;785;623;162
5;181708;181700;38-530;1023;694;690;449;241
6;181708;181700;38-530;681;447;444;361;83
7;181708;181700;38-530;855;501;498;394;104
8;181708;181700;38-530;188;135;133;90;43
1;181801;181800;37-450;1221;912;901;535;366
2;181801;181800;37-450;1815;1251;1243;769;474
3;181801;181800;37-450;1624;1066;1058;705;353
4;181801;181800;37-450;993;713;708;473;235
5;181801;181800;37-450;1030;727;723;434;289
6;181801;181800;37-450;965;610;608;404;204
7;181801;181800;37-450;969;669;667;416;251
8;181801;181800;37-450;1077;786;782;495;287
9;181801;181800;37-450;1180;817;808;519;289
10;181801;181800;37-450;1017;727;724;486;238
11;181801;181800;37-450;961;659;655;423;232
12;181801;181800;37-450;1094;804;795;472;323
13;181801;181800;37-450;1239;854;851;554;297
14;181801;181800;37-450;1596;1156;1146;692;454
15;181801;181800;37-450;1035;662;657;386;271
16;181801;181800;37-450;1447;900;891;552;339
17;181801;181800;37-450;844;573;566;353;213
18;181801;181800;37-450;962;664;659;428;231
19;181801;181800;37-450;1008;676;673;374;299
20;181801;181800;37-450;1375;933;927;552;375
21;181801;181800;37-450;891;611;600;344;256
22;181801;181800;37-450;967;628;618;355;263
23;181801;181800;37-450;1687;1114;1103;653;450
24;181801;181800;37-450;1223;820;813;489;324
25;181801;181800;37-450;1279;856;850;485;365
26;181801;181800;37-450;1373;831;823;494;329
27;181801;181800;37-450;1077;688;683;459;224
28;181801;181800;37-450;1470;1080;1071;610;461
29;181801;181800;37-450;1257;758;756;432;324
30;181801;181800;37-450;1171;728;724;443;281
31;181801;181800;37-450;1014;692;684;441;243
32;181801;181800;37-450;741;478;476;308;168
33;181801;181800;37-450;1754;1147;1139;711;428
34;181801;181800;37-450;991;654;648;403;245
35;181801;181800;37-450;551;332;329;196;133
36;181801;181800;37-450;267;136;135;98;37
37;181801;181800;37-450;56;33;33;20;13
38;181801;181800;37-450;99;67;60;41;19
39;181801;181800;37-450;27;20;20;12;8
40;181801;181800;37-450;55;52;52;36;16
1;181802;181800;37-433;622;406;401;336;65
2;181802;181800;37-433;491;312;312;273;39
3;181802;181800;37-433;255;160;159;137;22
4;181802;181800;37-433;280;180;180;164;16
5;181802;181800;37-433;155;107;107;94;13
6;181802;181800;37-433;469;286;285;255;30
7;181802;181800;37-433;1286;768;763;621;142
8;181802;181800;37-433;435;295;295;259;36
9;181802;181800;37-433;1138;713;712;606;106
10;181802;181800;37-433;456;323;322;209;113
11;181802;181800;37-433;227;169;167;150;17
1;181803;181800;37-403;2047;1414;1400;902;498
2;181803;181800;37-403;1405;960;954;629;325
3;181803;181800;37-450;647;452;452;308;144
4;181803;181800;37-403;929;589;587;529;58
5;181803;181800;37-403;465;293;290;243;47
6;181803;181800;37-403;251;144;143;126;17
7;181803;181800;37-403;312;215;213;170;43
8;181803;181800;37-403;1143;789;787;633;154
9;181803;181800;37-403;1268;758;751;507;244
10;181803;181800;37-403;372;222;220;182;38
1;181804;181800;37-455;659;450;444;292;152
2;181804;181800;37-455;597;382;380;310;70
3;181804;181800;37-455;807;510;505;418;87
4;181804;181800;37-455;616;398;396;314;82
5;181804;181800;37-455;664;443;443;331;112
6;181804;181800;37-455;227;146;146;117;29
7;181804;181800;37-455;151;121;121;87;34
8;181804;181800;37-455;302;184;183;134;49
9;181804;181800;37-455;212;143;143;106;37
10;181804;181800;37-455;202;124;124;115;9
11;181804;181800;37-455;368;251;248;196;52
12;181804;181800;37-455;350;231;230;162;68
13;181804;181800;37-455;307;194;191;149;42
1;181805;181800;37-470;1500;1002;996;642;354
2;181805;181800;37-470;830;527;526;357;169
3;181805;181800;37-470;630;409;409;344;65
4;181805;181800;37-470;720;479;477;402;75
5;181805;181800;37-470;627;398;397;358;39
6;181805;181800;37-470;1060;710;704;495;209
7;181805;181800;37-470;894;614;611;443;168
8;181805;181800;37-470;81;55;55;54;1
1;181806;181800;37-415;806;557;556;453;103
2;181806;181800;37-415;962;669;663;471;192
3;181806;181800;37-415;1134;766;758;575;183
4;181806;181800;37-415;1074;747;743;574;169
5;181806;181800;37-415;672;466;463;363;100
6;181806;181800;37-415;710;461;458;369;89
7;181806;181800;37-415;343;235;233;180;53
8;181806;181800;37-450;921;649;640;428;212
9;181806;181800;37-415;512;336;329;268;61
10;181806;181800;37-415;423;273;269;192;77
11;181806;181800;37-450;348;279;273;194;79
12;181806;181800;37-415;182;132;132;110;22
13;181806;181800;37-415;299;206;204;159;45
1;181901;181900;38-120;2221;1670;1657;1220;437
2;181901;181900;38-120;1543;1105;1093;840;253
3;181901;181900;38-120;959;689;684;461;223
4;181901;181900;38-120;1098;771;767;590;177
5;181901;181900;38-100;799;528;523;455;68
6;181901;181900;38-120;655;485;475;395;80
7;181901;181900;38-120;1446;1015;1004;852;152
8;181901;181900;38-120;195;143;138;126;12
1;181902;181900;38-130;820;572;566;383;183
2;181902;181900;38-130;1098;729;722;572;150
3;181902;181900;38-131;648;406;403;354;49
4;181902;181900;38-131;843;512;509;426;83
5;181902;181900;38-131;174;119;118;109;9
6;181902;181900;38-125;579;336;335;289;46
7;181902;181900;38-125;854;540;532;416;116
8;181902;181900;38-130;651;430;425;337;88
9;181902;181900;38-130;427;271;270;216;54
10;181902;181900;38-130;612;426;417;327;90
11;181902;181900;38-130;1084;738;733;606;127
1;181903;181900;38-114;432;323;321;233;88
2;181903;181900;38-114;293;199;199;177;22
3;181903;181900;38-114;246;164;163;145;18
4;181903;181900;38-114;970;751;746;653;93
5;181903;181900;38-116;325;242;241;211;30
6;181903;181900;38-116;1010;695;692;585;107
7;181903;181900;38-112;1660;1153;1149;997;152
8;181903;181900;38-114;914;663;662;600;62
9;181903;181900;38-115;1168;821;814;662;152
10;181903;181900;38-115;770;572;568;488;80
11;181903;181900;38-114;205;144;144;116;28
1;181904;181900;38-100;1473;929;924;551;373
2;181904;181900;38-100;1605;1070;1061;679;382
3;181904;181900;38-100;1011;695;685;478;207
4;181904;181900;38-100;831;538;530;335;195
5;181904;181900;38-100;1493;952;943;589;354
6;181904;181900;38-100;251;151;150;124;26
7;181904;181900;38-100;229;141;141;109;32
8;181904;181900;38-100;290;173;173;145;28
9;181904;181900;38-100;143;105;104;86;18
10;181904;181900;38-100;424;278;278;202;76
11;181904;181900;38-100;598;377;374;333;41
12;181904;181900;38-100;609;396;394;303;91
13;181904;181900;38-100;1682;1033;1026;854;172
14;181904;181900;38-111;640;428;425;377;48
15;181904;181900;38-111;112;85;84;78;6
16;181904;181900;38-123;763;455;455;360;95
17;181904;181900;38-123;724;468;468;345;123
18;181904;181900;38-100;1292;874;869;591;278
19;181904;181900;38-102;756;515;511;435;76
20;181904;181900;38-102;269;178;178;156;22
21;181904;181900;38-100;85;28;27;23;4
22;181904;181900;38-111;61;19;19;10;9
1;181905;181900;38-124;1240;893;879;671;208
2;181905;181900;38-102;712;470;465;380;85
3;181905;181900;38-124;408;284;283;234;49
4;181905;181900;38-124;322;215;215;160;55
5;181905;181900;38-124;314;194;192;135;57
6;181905;181900;38-126;624;385;379;332;47
7;181905;181900;38-124;428;292;289;263;26
8;181905;181900;38-124;209;126;124;105;19
9;181905;181900;38-124;831;525;521;445;76
10;181905;181900;38-124;270;197;195;149;46
11;181905;181900;38-126;334;219;218;181;37
12;181905;181900;38-123;175;102;102;79;23
13;181905;181900;38-124;276;188;187;158;29
1;182001;182000;39-450;1113;728;720;444;276
2;182001;182000;39-451;1123;767;761;527;234
3;182001;182000;39-450;430;291;289;220;69
4;182001;182000;39-450;851;589;586;502;84
5;182001;182000;39-450;487;330;328;282;46
6;182001;182000;39-451;425;301;298;238;60
7;182001;182000;39-451;1597;1023;1013;856;157
8;182001;182000;39-451;539;343;340;308;32
9;182001;182000;39-450;253;162;160;130;30
10;182001;182000;39-450;241;159;158;112;46
11;182001;182000;39-450;248;170;170;157;13
12;182001;182000;39-450;449;289;286;220;66
13;182001;182000;39-450;196;141;139;81;58
14;182001;182000;39-451;776;495;491;350;141
1;182002;182000;39-432;1140;753;745;468;277
2;182002;182000;39-432;1223;830;826;545;281
3;182002;182000;39-432;1213;788;783;489;294
4;182002;182000;39-432;1097;739;732;485;247
5;182002;182000;39-432;302;203;202;148;54
6;182002;182000;39-432;164;117;115;88;27
7;182002;182000;39-432;1213;814;809;613;196
8;182002;182000;39-432;1145;772;769;597;172
9;182002;182000;39-432;1411;879;874;640;234
10;182002;182000;39-432;188;123;123;99;24
11;182002;182000;39-400;552;371;369;274;95
1;182003;182000;39-410;1952;1360;1349;1009;340
2;182003;182000;39-410;369;244;243;204;39
3;182003;182000;39-410;581;435;434;340;94
4;182003;182000;39-410;1016;650;647;494;153
5;182003;182000;39-400;1602;1121;1114;913;201
6;182003;182000;39-400;691;490;483;418;65
7;182003;182000;39-410;587;402;398;341;57
8;182003;182000;39-410;958;627;625;508;117
1;182004;182000;39-460;1179;643;638;411;227
2;182004;182000;39-460;1260;747;742;480;262
3;182004;182000;39-460;673;414;412;264;148
4;182004;182000;39-460;980;618;613;360;253
5;182004;182000;39-460;1011;665;663;414;249
6;182004;182000;39-460;1976;1388;1373;1009;364
7;182004;182000;39-460;1546;1000;992;673;319
8;182004;182000;39-460;579;419;418;302;116
9;182004;182000;39-442;1528;979;969;714;255
10;182004;182000;39-442;868;566;559;446;113
11;182004;182000;39-442;1177;809;809;690;119
12;182004;182000;39-460;497;325;325;275;50
13;182004;182000;39-460;648;441;440;368;72
14;182004;182000;39-460;48;42;39;30;9
15;182004;182000;39-460;74;19;19;15;4
16;182004;182000;39-460;19;16;15;11;4
17;182004;182000;39-460;56;26;25;20;5
18;182004;182000;39-442;139;95;90;25;65
1;182101;182100;38-606;1341;860;847;593;254
2;182101;182100;38-606;597;397;396;297;99
3;182101;182100;38-604;555;367;364;273;91
1;182102;182100;38-607;969;747;731;322;409
2;182102;182100;38-608;1032;836;822;301;521
1;182103;182100;38-600;954;630;626;347;279
2;182103;182100;38-600;1050;698;695;358;337
3;182103;182100;38-600;1124;721;716;430;286
4;182103;182100;38-600;937;605;602;392;210
5;182103;182100;38-600;409;279;277;214;63
6;182103;182100;38-600;678;431;429;260;169
7;182103;182100;38-600;344;248;246;193;53
8;182103;182100;38-604;726;484;482;363;119
9;182103;182100;38-600;424;269;266;207;59
10;182103;182100;38-604;957;612;609;500;109
11;182103;182100;38-600;243;164;163;118;45
12;182103;182100;38-600;191;131;131;117;14
13;182103;182100;38-600;285;182;181;130;51
14;182103;182100;38-600;42;40;39;27;12
15;182103;182100;38-604;52;39;37;16;21
1;182104;182100;38-722;1158;745;743;532;211
2;182104;182100;38-623;1509;989;981;641;340
3;182104;182100;38-722;458;301;300;236;64
4;182104;182100;38-711;554;302;302;221;81
5;182104;182100;38-623;363;249;245;95;150
1;182105;182100;38-623;750;550;545;326;219
2;182105;182100;38-610;329;241;241;172;69
3;182105;182100;38-610;729;535;531;430;101
4;182105;182100;38-610;474;338;337;264;73
5;182105;182100;38-610;1480;1280;1272;621;651
6;182105;182100;38-610;544;387;386;308;78
7;182105;182100;38-610;719;494;488;357;131
8;182105;182100;38-623;436;300;299;220;79
1;186101;186100;38-400;2410;1691;1683;925;758
2;186101;186100;38-400;1539;998;988;537;451
3;186101;186100;38-400;1987;1437;1428;840;588
4;186101;186100;38-400;970;685;684;386;298
5;186101;186100;38-400;1189;841;835;493;342
6;186101;186100;38-400;1212;829;823;470;353
7;186101;186100;38-400;1675;1056;1049;622;427
8;186101;186100;38-400;1041;663;661;368;293
9;186101;186100;38-400;582;385;380;212;168
10;186101;186100;38-400;1313;956;944;478;466
11;186101;186100;38-400;1371;1050;1044;606;438
12;186101;186100;38-400;445;336;333;185;148
13;186101;186100;38-400;1268;881;874;427;447
14;186101;186100;38-400;1595;1123;1114;568;546
15;186101;186100;38-400;1431;1006;997;602;395
16;186101;186100;38-400;1384;963;956;527;429
17;186101;186100;38-400;978;722;715;387;328
18;186101;186100;38-400;1167;813;806;422;384
19;186101;186100;38-400;1239;920;913;534;379
20;186101;186100;38-400;2184;1655;1642;951;691
21;186101;186100;38-400;1332;947;944;451;493
22;186101;186100;38-400;1548;1061;1052;611;441
23;186101;186100;38-400;1379;984;976;541;435
24;186101;186100;38-400;1862;1322;1313;681;632
25;186101;186100;38-400;82;44;42;29;13
26;186101;186100;38-400;20;16;16;13;3
27;186101;186100;38-400;239;176;175;126;49
28;186101;186100;38-400;68;22;22;19;3
1;186201;186200;37-700;1129;797;784;381;403
2;186201;186200;37-700;1470;999;994;541;453
3;186201;186200;37-700;1762;1223;1216;653;563
4;186201;186200;37-700;1594;1039;1035;606;429
5;186201;186200;37-700;1004;729;723;352;371
6;186201;186200;37-700;1207;864;858;421;437
7;186201;186200;37-700;702;531;529;252;277
8;186201;186200;37-700;1734;1245;1238;647;591
9;186201;186200;37-700;1524;973;968;505;463
10;186201;186200;37-700;1680;1094;1087;532;555
11;186201;186200;37-700;1340;948;941;521;420
12;186201;186200;37-700;1260;837;831;447;384
13;186201;186200;37-700;1465;966;961;482;479
14;186201;186200;37-700;2105;1533;1528;741;787
15;186201;186200;37-700;1442;981;973;495;478
16;186201;186200;37-700;1361;957;948;559;389
17;186201;186200;37-700;860;543;539;298;241
18;186201;186200;37-700;1846;1213;1204;719;485
19;186201;186200;37-700;1123;724;720;421;299
20;186201;186200;37-700;1800;1212;1208;641;567
21;186201;186200;37-700;851;473;466;286;180
22;186201;186200;37-700;858;548;543;359;184
23;186201;186200;37-700;1595;938;929;521;408
24;186201;186200;37-700;1216;814;805;360;445
25;186201;186200;37-700;1248;741;735;413;322
26;186201;186200;37-700;678;371;367;226;141
27;186201;186200;37-700;1539;935;927;547;380
28;186201;186200;37-700;1452;938;931;527;404
29;186201;186200;37-700;1771;1184;1180;602;578
30;186201;186200;37-700;1139;759;755;482;273
31;186201;186200;37-700;564;362;358;269;89
32;186201;186200;37-700;139;67;59;46;13
33;186201;186200;37-700;174;143;141;39;102
34;186201;186200;37-700;90;47;41;28;13
35;186201;186200;37-700;26;23;17;11;6
36;186201;186200;37-700;60;34;31;24;7
37;186201;186200;37-700;207;207;205;129;76
38;186201;186200;37-700;95;33;32;20;12
39;186201;186200;37-700;166;84;76;47;29
1;186301;186300;35-069;1635;1094;1080;624;456
2;186301;186300;35-006;1451;958;951;515;436
3;186301;186300;35-055;1317;905;898;452;446
4;186301;186300;35-030;913;661;655;293;362
5;186301;186300;35-011;1762;1286;1275;628;647
6;186301;186300;35-016;1650;1164;1148;589;559
7;186301;186300;35-051;1168;877;866;377;489
8;186301;186300;35-051;1379;1023;1011;486;525
9;186301;186300;35-051;1207;868;861;359;502
10;186301;186300;35-045;1636;1178;1165;531;634
11;186301;186300;35-077;1462;1033;1025;575;450
12;186301;186300;35-077;1676;1207;1198;616;582
13;186301;186300;35-021;1419;998;985;451;534
14;186301;186300;35-040;1066;711;703;386;317
15;186301;186300;35-083;3142;2511;2476;1261;1215
16;186301;186300;35-101;2888;2248;2210;1072;1138
17;186301;186300;35-112;1600;1189;1174;562;612
18;186301;186300;35-112;1441;1092;1083;504;579
19;186301;186300;35-111;1646;1261;1249;672;577
20;186301;186300;35-207;1248;839;833;460;373
21;186301;186300;35-225;1229;865;859;441;418
22;186301;186300;35-225;963;611;607;365;242
23;186301;186300;35-209;1447;950;945;482;463
24;186301;186300;35-209;1285;942;936;418;518
25;186301;186300;35-209;1249;913;904;459;445
26;186301;186300;35-231;2222;1796;1780;845;935
27;186301;186300;35-231;2386;1922;1909;972;937
28;186301;186300;35-201;1296;908;903;505;398
29;186301;186300;35-202;1436;1001;989;519;470
30;186301;186300;35-202;1465;1065;1051;547;504
31;186301;186300;35-234;2004;1500;1484;795;689
32;186301;186300;35-301;1303;921;914;490;424
33;186301;186300;35-321;1649;1246;1233;651;582
34;186301;186300;35-303;1455;1129;1115;554;561
35;186301;186300;35-303;1519;1191;1182;508;674
36;186301;186300;35-303;1539;1182;1163;563;600
37;186301;186300;35-326;1613;1228;1218;591;627
38;186301;186300;35-310;1308;1031;1027;504;523
39;186301;186300;35-310;1260;945;940;497;443
40;186301;186300;35-310;1429;1039;1033;578;455
41;186301;186300;35-312;1104;790;780;463;317
42;186301;186300;35-312;1392;1049;1040;592;448
43;186301;186300;35-309;1477;1093;1087;514;573
44;186301;186300;35-309;1748;1260;1249;612;637
45;186301;186300;35-309;1445;1081;1076;550;526
46;186301;186300;35-614;2857;2280;2267;1227;1040
47;186301;186300;35-620;2290;1814;1794;893;901
48;186301;186300;35-330;2267;1804;1789;1008;781
49;186301;186300;35-330;1666;1296;1285;795;490
50;186301;186300;35-610;2792;2186;2162;1121;1041
51;186301;186300;35-602;2936;2387;2353;1137;1216
52;186301;186300;35-602;1718;1391;1382;620;762
53;186301;186300;35-603;1676;1361;1344;625;719
54;186301;186300;35-119;1704;1432;1414;726;688
55;186301;186300;35-213;2214;1712;1693;878;815
56;186301;186300;35-213;1717;1272;1263;824;439
57;186301;186300;35-213;1349;999;991;675;316
58;186301;186300;35-509;1947;1520;1503;758;745
59;186301;186300;35-508;1305;980;972;494;478
60;186301;186300;35-508;1497;1115;1107;581;526
61;186301;186300;35-508;1395;1063;1056;578;478
62;186301;186300;35-506;1185;867;856;463;393
63;186301;186300;35-211;1289;970;955;460;495
64;186301;186300;35-111;1073;787;780;370;410
65;186301;186300;35-111;1295;1014;1002;541;461
66;186301;186300;35-329;1461;1118;1112;596;516
67;186301;186300;35-329;1338;1011;998;542;456
68;186301;186300;35-326;1713;1313;1303;688;615
69;186301;186300;35-326;1653;1342;1333;652;681
70;186301;186300;35-326;2245;1796;1778;838;940
71;186301;186300;35-314;2208;1789;1773;952;821
72;186301;186300;35-118;1619;1243;1235;673;562
73;186301;186300;35-118;1447;1141;1124;633;491
74;186301;186300;35-118;1126;864;854;464;390
75;186301;186300;35-116;1149;862;855;475;380
76;186301;186300;35-119;2226;1737;1722;810;912
77;186301;186300;35-505;2029;1656;1638;699;939
78;186301;186300;35-322;2038;1522;1504;808;696
79;186301;186300;35-083;1406;1017;1007;627;380
80;186301;186300;35-083;1428;1136;1126;604;522
81;186301;186300;35-304;2592;2011;1989;1122;867
82;186301;186300;35-232;834;694;684;280;404
83;186301;186300;35-317;1939;1589;1571;854;717
84;186301;186300;35-317;2563;1942;1929;1154;775
85;186301;186300;35-213;476;348;343;283;60
86;186301;186300;35-330;1461;1161;1149;717;432
87;186301;186300;35-212;753;582;579;306;273
88;186301;186300;35-314;1592;1303;1294;606;688
89;186301;186300;35-311;1919;1545;1535;750;785
90;186301;186300;35-317;1957;1596;1584;818;766
91;186301;186300;35-212;1056;820;814;458;356
92;186301;186300;35-119;2099;1770;1749;817;932
93;186301;186300;35-505;1228;944;929;565;364
94;186301;186300;35-055;376;198;198;136;62
95;186301;186300;35-301;409;148;148;101;47
96;186301;186300;35-241;61;38;38;23;15
97;186301;186300;35-241;137;49;49;32;17
98;186301;186300;35-111;169;40;40;24;16
99;186301;186300;35-302;122;25;25;14;11
100;186301;186300;35-225;53;18;17;13;4
101;186301;186300;35-207;41;10;10;3;7
102;186301;186300;35-322;1227;969;949;188;761
1;186401;186400;39-400;1316;847;843;406;437
2;186401;186400;39-400;1392;882;880;403;477
3;186401;186400;39-400;961;631;628;329;299
4;186401;186400;39-400;1240;824;819;437;382
5;186401;186400;39-400;1389;922;921;449;472
6;186401;186400;39-400;1380;883;878;480;398
7;186401;186400;39-400;1389;917;911;489;422
8;186401;186400;39-400;1384;973;961;504;457
9;186401;186400;39-400;1278;811;808;395;413
10;186401;186400;39-400;583;401;399;172;227
11;186401;186400;39-400;406;287;286;102;184
12;186401;186400;39-400;1050;730;726;330;396
13;186401;186400;39-400;1142;819;814;438;376
14;186401;186400;39-400;1266;893;886;455;431
15;186401;186400;39-400;1004;784;775;356;419
16;186401;186400;39-400;124;105;103;57;46
17;186401;186400;39-400;487;360;357;208;149
18;186401;186400;39-400;1498;991;983;468;515
19;186401;186400;39-400;1410;912;909;435;474
20;186401;186400;39-400;1556;1016;1003;474;529
21;186401;186400;39-400;371;256;254;113;141
22;186401;186400;39-400;708;509;504;265;239
23;186401;186400;39-400;1127;738;731;381;350
24;186401;186400;39-400;903;661;655;322;333
25;186401;186400;39-400;1200;941;937;348;589
26;186401;186400;39-400;1764;1228;1218;790;428
27;186401;186400;39-400;1233;846;837;539;298
28;186401;186400;39-400;793;557;551;329;222
29;186401;186400;39-400;420;310;307;168;139
30;186401;186400;39-400;1268;820;817;557;260
31;186401;186400;39-400;844;637;635;279;356
32;186401;186400;39-400;55;29;27;19;8
33;186401;186400;39-400;124;81;79;55;24
34;186401;186400;39-400;66;27;25;18;7
35;186401;186400;39-400;47;43;41;35;6
1;200101;200100;16-300;904;600;593;328;265
2;200101;200100;16-300;1160;770;761;375;386
3;200101;200100;16-300;749;532;529;270;259
4;200101;200100;16-300;1579;982;977;585;392
5;200101;200100;16-300;1001;619;616;358;258
6;200101;200100;16-300;516;355;347;175;172
7;200101;200100;16-300;1721;1185;1173;668;505
8;200101;200100;16-300;2159;1348;1339;767;572
9;200101;200100;16-300;1396;877;870;485;385
10;200101;200100;16-300;835;551;547;311;236
11;200101;200100;16-300;953;597;593;350;243
12;200101;200100;16-300;1069;710;705;407;298
13;200101;200100;16-300;589;409;407;251;156
14;200101;200100;16-300;752;503;500;260;240
15;200101;200100;16-300;1758;1170;1159;664;495
16;200101;200100;16-300;1286;860;857;526;331
17;200101;200100;16-300;911;638;628;384;244
18;200101;200100;16-300;1569;1088;1076;659;417
19;200101;200100;16-300;830;614;601;310;291
20;200101;200100;16-300;59;23;23;16;7
21;200101;200100;16-300;100;91;89;55;34
1;200102;200100;16-300;816;540;538;414;124
2;200102;200100;16-300;405;225;225;175;50
3;200102;200100;16-300;1042;683;683;555;128
4;200102;200100;16-320;386;249;248;200;48
5;200102;200100;16-300;901;532;527;362;165
6;200102;200100;16-300;498;260;255;197;58
7;200102;200100;16-300;263;159;158;129;29
8;200102;200100;16-300;217;144;144;116;28
9;200102;200100;16-300;229;155;155;122;33
10;200102;200100;16-320;251;164;164;131;33
1;200103;200100;16-320;1993;1149;1144;881;263
2;200103;200100;16-320;748;431;428;345;83
3;200103;200100;16-320;816;400;400;298;102
4;200103;200100;16-320;483;272;271;205;66
1;200104;200100;16-315;507;312;311;241;70
2;200104;200100;16-315;502;326;324;287;37
3;200104;200100;16-315;480;249;247;213;34
4;200104;200100;16-315;913;630;628;400;228
5;200104;200100;16-315;723;442;441;309;132
6;200104;200100;16-315;264;168;163;151;12
7;200104;200100;16-315;326;190;189;154;35
1;200105;200100;16-304;538;341;338;226;112
2;200105;200100;16-304;553;395;393;268;125
3;200105;200100;16-304;749;576;572;320;252
4;200105;200100;16-304;547;350;347;268;79
1;200106;200100;16-326;605;424;421;228;193
2;200106;200100;16-326;787;532;524;279;245
3;200106;200100;16-326;755;532;528;388;140
4;200106;200100;16-326;159;113;112;88;24
1;200107;200100;16-310;1704;1071;1061;695;366
2;200107;200100;16-310;389;225;224;159;65
3;200107;200100;16-310;1133;618;615;487;128
4;200107;200100;16-310;511;276;272;217;55
1;200201;200200;16-070;2313;1715;1700;1026;674
2;200201;200200;16-070;1017;688;684;448;236
3;200201;200200;16-070;724;557;550;466;84
4;200201;200200;16-070;407;283;281;191;90
5;200201;200200;16-070;555;365;363;275;88
6;200201;200200;16-070;1174;844;837;487;350
7;200201;200200;15-635;1794;1408;1394;792;602
8;200201;200200;16-070;2008;1566;1545;824;721
9;200201;200200;16-070;1088;806;799;491;308
10;200201;200200;16-070;605;457;453;307;146
11;200201;200200;16-070;305;207;205;150;55
12;200201;200200;16-070;1103;862;856;426;430
13;200201;200200;16-070;201;68;64;47;17
14;200201;200200;16-070;687;307;300;176;124
1;200202;200200;16-020;1709;1050;1040;577;463
2;200202;200200;16-020;1475;948;941;573;368
3;200202;200200;16-020;1258;849;845;499;346
4;200202;200200;16-020;1241;801;786;491;295
5;200202;200200;16-020;1143;751;747;438;309
6;200202;200200;16-020;383;228;225;170;55
7;200202;200200;16-020;738;530;528;343;185
1;200203;200200;16-002;1540;1113;1098;687;411
2;200203;200200;16-002;1392;1021;1012;619;393
3;200203;200200;16-002;594;408;406;269;137
4;200203;200200;16-002;525;311;308;206;102
5;200203;200200;15-694;1372;1024;1018;570;448
6;200203;200200;16-002;738;568;565;376;189
7;200203;200200;16-002;501;368;360;263;97
8;200203;200200;16-002;559;387;384;283;101
9;200203;200200;16-002;491;332;330;249;81
1;200204;200200;16-040;713;435;431;128;303
2;200204;200200;16-040;699;421;417;145;272
3;200204;200200;16-040;874;565;560;229;331
4;200204;200200;16-040;305;167;166;56;110
5;200204;200200;16-040;264;160;156;93;63
6;200204;200200;16-040;166;80;78;55;23
7;200204;200200;16-040;169;94;93;56;37
8;200204;200200;16-040;467;281;280;94;186
9;200204;200200;16-040;303;207;204;79;125
10;200204;200200;16-040;310;224;223;84;139
1;200205;200200;16-061;948;634;629;373;256
2;200205;200200;16-061;921;709;705;527;178
3;200205;200200;16-061;974;710;704;542;162
4;200205;200200;16-061;542;430;424;248;176
5;200205;200200;16-001;1026;818;811;506;305
6;200205;200200;16-001;1279;1011;1002;647;355
7;200205;200200;16-061;950;714;710;338;372
8;200205;200200;15-603;1054;848;839;394;445
9;200205;200200;15-378;674;528;526;256;270
10;200205;200200;16-001;1453;1113;1104;722;382
11;200205;200200;16-001;868;620;614;371;243
12;200205;200200;16-001;1161;797;790;518;272
13;200205;200200;16-061;286;236;233;181;52
14;200205;200200;16-001;1052;815;806;393;413
15;200205;200200;16-061;86;37;34;20;14
1;200206;200200;18-100;367;239;235;207;28
2;200206;200200;18-100;825;532;529;465;64
3;200206;200200;18-100;1483;1031;1015;777;238
4;200206;200200;18-112;335;238;236;202;34
5;200206;200200;18-100;1065;767;760;535;225
6;200206;200200;18-100;1327;906;895;645;250
7;200206;200200;18-100;1536;1055;1050;765;285
8;200206;200200;18-100;891;670;668;498;170
9;200206;200200;18-100;1116;835;827;585;242
10;200206;200200;18-100;1477;1083;1077;792;285
11;200206;200200;18-100;1044;760;753;567;186
12;200206;200200;18-100;914;635;629;454;175
13;200206;200200;18-100;752;554;546;373;173
14;200206;200200;18-100;1054;730;727;508;219
15;200206;200200;18-100;289;197;197;172;25
16;200206;200200;18-100;224;167;166;149;17
17;200206;200200;18-100;686;519;516;445;71
18;200206;200200;18-100;119;70;68;52;16
19;200206;200200;18-100;103;31;31;22;9
1;200207;200200;16-050;997;612;608;306;302
2;200207;200200;16-050;1233;787;782;411;371
3;200207;200200;16-050;673;426;422;196;226
4;200207;200200;16-050;244;154;150;60;90
5;200207;200200;16-050;169;96;95;60;35
6;200207;200200;16-050;370;196;196;89;107
7;200207;200200;16-050;340;182;178;94;84
8;200207;200200;16-050;360;203;202;95;107
9;200207;200200;16-050;442;253;248;130;118
10;200207;200200;16-050;181;97;96;61;35
11;200207;200200;16-050;131;61;57;26;31
12;200207;200200;16-050;55;20;20;15;5
1;200208;200200;18-112;952;723;714;635;79
2;200208;200200;18-112;848;585;582;510;72
3;200208;200200;18-112;653;452;450;396;54
1;200209;200200;16-030;1444;1020;1017;516;501
2;200209;200200;16-030;1351;1018;1009;483;526
3;200209;200200;16-030;680;468;464;145;319
4;200209;200200;16-030;215;132;130;56;74
5;200209;200200;16-030;765;541;534;282;252
6;200209;200200;16-030;638;482;477;214;263
7;200209;200200;16-030;416;333;330;163;167
8;200209;200200;16-030;171;171;170;89;81
1;200210;200200;18-105;817;589;585;432;153
2;200210;200200;18-105;272;177;177;153;24
3;200210;200200;18-105;197;135;134;124;10
4;200210;200200;18-105;199;141;140;98;42
1;200211;200200;18-106;918;688;682;524;158
2;200211;200200;18-106;809;607;605;480;125
3;200211;200200;18-106;722;544;537;360;177
4;200211;200200;18-106;443;302;301;197;104
5;200211;200200;18-106;1376;1137;1124;498;626
6;200211;200200;18-106;383;278;276;211;65
7;200211;200200;18-106;384;272;268;164;104
8;200211;200200;18-106;302;219;218;155;63
1;200212;200200;16-080;1575;1103;1092;747;345
2;200212;200200;16-080;577;366;364;323;41
3;200212;200200;16-080;198;128;128;120;8
4;200212;200200;16-080;448;269;269;220;49
5;200212;200200;16-080;360;241;239;212;27
6;200212;200200;16-080;550;367;365;311;54
7;200212;200200;16-080;653;411;405;326;79
8;200212;200200;16-080;213;162;160;138;22
9;200212;200200;16-080;197;138;136;125;11
1;200213;200200;16-010;1412;983;975;574;401
2;200213;200200;16-010;2193;1525;1518;831;687
3;200213;200200;16-010;1572;1153;1143;638;505
4;200213;200200;16-010;2075;1493;1484;853;631
5;200213;200200;16-010;1625;1180;1167;632;535
6;200213;200200;16-010;1016;666;658;331;327
7;200213;200200;16-010;941;721;709;351;358
8;200213;200200;16-010;1631;1356;1351;687;664
9;200213;200200;16-010;489;377;373;224;149
10;200213;200200;16-010;681;559;555;270;285
11;200213;200200;16-010;216;159;158;114;44
12;200213;200200;16-010;602;489;485;219;266
1;200214;200200;16-060;448;304;303;172;131
2;200214;200200;16-060;826;527;522;358;164
3;200214;200200;16-060;1067;713;707;472;235
4;200214;200200;15-588;645;456;453;250;203
5;200214;200200;16-060;663;475;472;247;225
6;200214;200200;16-060;536;383;381;262;119
7;200214;200200;16-060;732;433;432;156;276
8;200214;200200;15-593;770;575;570;341;229
9;200214;200200;16-060;856;574;571;412;159
10;200214;200200;16-060;992;705;698;446;252
1;200215;200200;16-075;1369;879;874;740;134
2;200215;200200;16-075;613;367;366;324;42
1;200216;200200;15-523;1791;1424;1408;585;823
2;200216;200200;15-523;1806;1402;1391;596;795
3;200216;200200;15-509;1246;902;897;378;519
4;200216;200200;15-509;1065;829;820;356;464
5;200216;200200;15-509;1576;1191;1173;565;608
6;200216;200200;15-511;368;270;263;144;119
7;200216;200200;15-528;535;445;443;244;199
1;200301;200300;17-100;1179;710;709;305;404
2;200301;200300;17-100;952;649;646;342;304
3;200301;200300;17-100;1233;824;819;334;485
4;200301;200300;17-100;1439;998;993;498;495
5;200301;200300;17-100;1686;1090;1078;479;599
6;200301;200300;17-100;1128;739;735;262;473
7;200301;200300;17-100;1595;1007;999;437;562
8;200301;200300;17-100;1671;1086;1081;417;664
9;200301;200300;17-100;726;471;467;190;277
10;200301;200300;17-100;1924;1254;1239;440;799
11;200301;200300;17-100;1714;1140;1133;525;608
12;200301;200300;17-100;1817;1237;1228;722;506
13;200301;200300;17-100;926;573;568;269;299
14;200301;200300;17-100;92;48;47;22;25
1;200302;200300;17-120;1183;813;804;654;150
2;200302;200300;17-120;1400;1022;1015;842;173
3;200302;200300;17-120;97;33;33;24;9
1;200303;200300;17-100;796;474;471;313;158
2;200303;200300;17-100;718;452;451;370;81
3;200303;200300;17-106;338;188;187;49;138
4;200303;200300;17-100;415;286;285;181;104
5;200303;200300;17-100;285;153;153;58;95
6;200303;200300;17-100;446;273;271;158;113
7;200303;200300;17-100;672;378;376;139;237
8;200303;200300;17-100;645;383;378;121;257
9;200303;200300;17-100;377;185;182;62;120
10;200303;200300;17-111;243;137;136;68;68
11;200303;200300;17-100;439;285;283;91;192
1;200304;200300;17-111;457;290;289;240;49
2;200304;200300;17-111;1213;809;808;570;238
3;200304;200300;17-111;564;281;279;104;175
4;200304;200300;17-111;456;287;286;266;20
5;200304;200300;17-120;435;286;283;260;23
1;200305;200300;17-120;497;321;317;287;30
2;200305;200300;17-120;300;230;228;207;21
3;200305;200300;17-120;531;345;343;292;51
4;200305;200300;17-120;366;241;239;210;29
5;200305;200300;17-120;236;171;169;158;11
6;200305;200300;17-120;553;387;385;367;18
7;200305;200300;17-120;563;425;423;388;35
8;200305;200300;17-120;319;240;238;213;25
9;200305;200300;17-120;218;169;168;146;22
10;200305;200300;17-120;309;226;224;212;12
11;200305;200300;17-120;188;146;144;132;12
1;200306;200300;17-106;690;426;417;163;254
2;200306;200300;17-106;723;403;403;188;215
3;200306;200300;17-106;255;126;125;59;66
4;200306;200300;17-106;260;130;130;51;79
5;200306;200300;17-106;216;105;105;37;68
1;200307;200300;17-123;845;553;543;435;108
2;200307;200300;17-123;307;201;200;177;23
3;200307;200300;17-123;187;127;126;93;33
1;200308;200300;17-132;690;462;459;396;63
2;200308;200300;17-132;1058;726;722;606;116
3;200308;200300;17-132;821;533;530;462;68
4;200308;200300;17-132;586;444;443;397;46
1;200401;200400;19-200;828;554;546;355;191
2;200401;200400;19-200;949;585;579;381;198
3;200401;200400;19-200;961;603;598;398;200
4;200401;200400;19-200;1120;746;741;477;264
5;200401;200400;19-200;763;475;473;334;139
6;200401;200400;19-200;953;588;581;384;197
7;200401;200400;19-200;1241;793;784;531;253
8;200401;200400;19-200;1025;582;579;396;183
9;200401;200400;19-200;1613;1001;996;611;385
10;200401;200400;19-200;1727;1122;1114;708;406
11;200401;200400;19-200;1040;637;631;378;253
12;200401;200400;19-200;1291;762;754;462;292
13;200401;200400;19-200;1397;948;942;618;324
14;200401;200400;19-200;131;67;67;49;18
1;200402;200400;19-200;796;436;433;350;83
2;200402;200400;19-200;566;365;359;297;62
3;200402;200400;19-200;579;359;357;245;112
4;200402;200400;19-200;726;439;435;379;56
5;200402;200400;19-200;360;249;245;178;67
6;200402;200400;19-200;476;277;275;201;74
7;200402;200400;19-200;321;196;194;166;28
8;200402;200400;19-200;454;297;294;226;68
1;200403;200400;19-213;277;193;192;185;7
2;200403;200400;19-213;155;102;102;96;6
3;200403;200400;19-213;539;321;319;264;55
4;200403;200400;19-213;439;271;265;246;19
5;200403;200400;19-213;386;235;234;208;26
6;200403;200400;19-213;285;158;157;121;36
7;200403;200400;19-213;342;222;220;198;22
8;200403;200400;19-213;990;569;565;456;109
1;200404;200400;19-206;1627;1002;996;528;468
2;200404;200400;19-206;542;318;313;218;95
3;200404;200400;19-206;533;289;287;214;73
4;200404;200400;19-206;400;234;234;164;70
5;200404;200400;19-206;846;417;415;320;95
1;200405;200400;19-230;912;521;521;352;169
2;200405;200400;19-230;896;552;545;354;191
3;200405;200400;19-230;558;360;359;304;55
4;200405;200400;19-230;778;488;484;350;134
5;200405;200400;19-230;647;397;394;340;54
6;200405;200400;19-230;552;354;352;293;59
1;200406;200400;19-222;844;543;535;405;130
2;200406;200400;19-222;717;407;403;333;70
3;200406;200400;19-222;515;345;344;296;48
4;200406;200400;19-222;183;121;120;103;17
5;200406;200400;19-222;346;225;223;194;29
1;200501;200500;17-200;1885;1129;1120;440;680
2;200501;200500;17-200;1821;1144;1134;442;692
3;200501;200500;17-200;1880;1256;1245;461;784
4;200501;200500;17-200;814;524;516;204;312
5;200501;200500;17-200;994;649;641;258;383
6;200501;200500;17-200;1229;712;705;348;357
7;200501;200500;17-200;848;558;555;240;315
8;200501;200500;17-200;1125;675;669;349;320
9;200501;200500;17-200;2163;1391;1382;605;777
10;200501;200500;17-200;2042;1316;1297;462;835
11;200501;200500;17-200;131;57;57;25;32
12;200501;200500;17-200;43;5;4;2;2
13;200501;200500;17-200;432;359;348;80;268
1;200502;200500;17-230;1649;1133;1112;464;648
2;200502;200500;17-230;242;165;161;84;77
3;200502;200500;17-230;62;25;23;15;8
1;200503;200500;17-240;1770;1124;1116;588;528
2;200503;200500;17-240;693;374;371;187;184
1;200504;200500;17-207;584;345;340;126;214
2;200504;200500;17-207;356;181;179;77;102
3;200504;200500;17-207;358;186;182;75;107
4;200504;200500;17-207;246;116;116;44;72
1;200505;200500;17-204;1077;699;690;423;267
2;200505;200500;17-204;325;170;168;90;78
3;200505;200500;17-204;206;121;118;31;87
1;200506;200500;17-200;253;153;150;74;76
2;200506;200500;17-200;442;283;279;132;147
3;200506;200500;17-200;507;266;264;126;138
4;200506;200500;17-200;379;194;192;90;102
5;200506;200500;17-200;388;235;232;120;112
6;200506;200500;17-200;151;93;93;45;48
7;200506;200500;17-200;402;240;238;98;140
8;200506;200500;17-200;370;250;243;114;129
9;200506;200500;17-200;199;111;111;41;70
1;200507;200500;17-250;1086;668;660;368;292
2;200507;200500;17-250;162;92;92;41;51
3;200507;200500;17-250;278;147;147;76;71
4;200507;200500;17-250;300;160;157;77;80
1;200508;200500;17-210;1435;810;808;339;469
2;200508;200500;17-210;422;203;199;95;104
3;200508;200500;17-210;211;104;103;35;68
4;200508;200500;17-210;471;298;292;122;170
5;200508;200500;17-210;205;106;106;46;60
1;200509;200500;17-220;879;567;564;285;279
2;200509;200500;17-220;734;422;417;183;234
3;200509;200500;17-220;650;515;513;247;266
4;200509;200500;17-220;701;369;362;169;193
1;200601;200600;18-500;543;343;341;241;100
2;200601;200600;18-500;566;376;375;265;110
3;200601;200600;18-500;957;580;576;383;193
4;200601;200600;18-500;921;578;574;429;145
5;200601;200600;18-500;685;429;428;264;164
6;200601;200600;18-500;735;428;427;267;160
7;200601;200600;18-500;1041;661;650;447;203
8;200601;200600;18-500;1010;705;701;461;240
9;200601;200600;18-500;663;433;428;298;130
10;200601;200600;18-500;58;24;24;19;5
1;200602;200600;18-507;318;211;208;127;81
2;200602;200600;18-507;749;441;438;322;116
3;200602;200600;18-507;538;348;348;329;19
4;200602;200600;18-507;393;246;246;200;46
5;200602;200600;18-507;245;148;146;127;19
6;200602;200600;18-507;273;179;179;168;11
1;200603;200600;18-500;725;469;466;364;102
2;200603;200600;18-500;383;218;218;186;32
3;200603;200600;18-500;769;506;506;422;84
4;200603;200600;18-500;623;382;379;344;35
5;200603;200600;18-500;514;331;328;233;95
6;200603;200600;18-500;341;225;223;179;44
7;200603;200600;18-500;518;332;329;300;29
8;200603;200600;18-500;441;318;315;268;47
9;200603;200600;18-500;361;204;202;157;45
10;200603;200600;18-500;731;483;482;437;45
11;200603;200600;18-500;487;291;290;229;61
12;200603;200600;18-500;160;103;103;72;31
13;200603;200600;18-500;253;159;159;137;22
1;200604;200600;18-516;736;449;444;377;67
2;200604;200600;18-516;1281;773;768;627;141
3;200604;200600;18-516;857;575;572;472;100
4;200604;200600;18-516;344;221;220;179;41
5;200604;200600;18-516;427;291;288;255;33
1;200605;200600;18-520;879;508;507;351;156
2;200605;200600;18-520;692;395;394;300;94
3;200605;200600;18-520;884;534;531;501;30
4;200605;200600;18-520;269;178;178;167;11
5;200605;200600;18-520;742;442;440;415;25
6;200605;200600;18-520;383;225;224;170;54
7;200605;200600;18-520;368;229;228;206;22
8;200605;200600;18-520;249;171;170;143;27
1;200606;200600;18-525;953;653;647;569;78
2;200606;200600;18-525;1097;724;718;533;185
3;200606;200600;18-525;625;361;361;275;86
4;200606;200600;18-525;384;230;230;195;35
5;200606;200600;18-525;359;234;232;201;31
6;200606;200600;18-525;364;240;237;201;36
1;200701;200700;18-420;681;422;419;335;84
2;200701;200700;18-420;723;487;486;447;39
3;200701;200700;18-420;893;568;564;525;39
4;200701;200700;18-420;662;420;417;374;43
5;200701;200700;18-420;707;484;482;390;92
6;200701;200700;18-420;161;102;102;91;11
1;200702;200700;18-400;616;446;439;363;76
2;200702;200700;18-400;461;318;317;272;45
3;200702;200700;18-400;1228;902;897;617;280
4;200702;200700;18-400;570;372;366;280;86
5;200702;200700;18-400;545;361;360;315;45
6;200702;200700;18-400;840;596;588;473;115
7;200702;200700;18-400;467;305;304;229;75
8;200702;200700;18-400;394;286;283;249;34
9;200702;200700;18-400;454;316;313;277;36
10;200702;200700;18-400;439;338;336;234;102
11;200702;200700;18-400;1037;801;799;511;288
12;200702;200700;18-400;830;669;667;402;265
13;200702;200700;18-400;684;484;482;290;192
14;200702;200700;18-400;269;175;173;131;42
15;200702;200700;18-400;206;137;134;110;24
1;200703;200700;18-413;612;421;417;364;53
2;200703;200700;18-413;777;521;520;415;105
3;200703;200700;18-413;161;100;98;95;3
4;200703;200700;18-413;648;437;433;371;62
5;200703;200700;18-413;211;141;141;123;18
6;200703;200700;18-413;380;223;222;202;20
7;200703;200700;18-413;293;185;183;165;18
1;200704;200700;18-414;394;278;275;231;44
2;200704;200700;18-414;592;386;382;298;84
3;200704;200700;18-414;776;511;508;341;167
4;200704;200700;18-414;788;502;501;361;140
5;200704;200700;18-414;434;304;302;265;37
1;200705;200700;18-421;1710;1153;1144;771;373
2;200705;200700;18-421;1163;762;755;578;177
3;200705;200700;18-421;1108;667;660;562;98
4;200705;200700;18-421;979;630;626;509;117
5;200705;200700;18-421;911;579;576;491;85
6;200705;200700;18-421;475;322;320;278;42
7;200705;200700;18-421;525;296;295;259;36
8;200705;200700;18-421;1095;694;689;532;157
1;200706;200700;18-423;294;162;161;148;13
2;200706;200700;18-423;492;305;302;287;15
3;200706;200700;18-423;208;148;146;141;5
4;200706;200700;18-423;501;313;311;277;34
1;200707;200700;18-411;427;257;256;230;26
2;200707;200700;18-411;725;459;453;372;81
3;200707;200700;18-411;815;554;548;419;129
4;200707;200700;18-411;1002;716;709;628;81
5;200707;200700;18-411;979;716;715;636;79
1;200708;200700;18-430;384;259;258;228;30
2;200708;200700;18-430;360;231;231;206;25
3;200708;200700;18-430;966;662;657;535;122
4;200708;200700;18-430;560;349;348;297;51
5;200708;200700;18-430;502;339;337;296;41
6;200708;200700;18-430;181;122;121;96;25
1;200709;200700;18-416;911;551;545;385;160
2;200709;200700;18-416;414;269;267;198;69
3;200709;200700;18-416;638;388;384;321;63
4;200709;200700;18-416;890;556;552;479;73
5;200709;200700;18-416;331;209;207;169;38
1;200801;200800;19-110;1689;1081;1075;691;384
2;200801;200800;19-110;621;392;389;278;111
3;200801;200800;19-110;215;131;130;113;17
4;200801;200800;19-110;360;203;199;160;39
5;200801;200800;19-110;372;223;221;201;20
6;200801;200800;19-110;333;185;184;151;33
1;200802;200800;19-122;1019;627;619;475;144
2;200802;200800;19-122;1038;643;637;488;149
1;200803;200800;19-124;752;468;464;368;96
2;200803;200800;19-124;271;166;165;145;20
3;200803;200800;19-124;882;489;487;376;111
4;200803;200800;19-124;298;137;137;119;18
5;200803;200800;19-124;371;200;199;173;26
6;200803;200800;19-124;229;152;150;141;9
7;200803;200800;16-150;265;143;142;127;15
8;200803;200800;19-124;475;304;304;257;47
9;200803;200800;19-124;47;36;34;28;6
1;200804;200800;19-120;1448;933;924;674;250
2;200804;200800;19-120;1399;826;814;589;225
3;200804;200800;19-120;607;355;354;308;46
1;200805;200800;19-111;909;564;561;413;148
2;200805;200800;19-111;868;503;501;417;84
3;200805;200800;19-111;456;256;253;204;49
4;200805;200800;19-111;744;468;465;300;165
1;200806;200800;19-100;1372;892;883;559;324
2;200806;200800;19-100;1370;810;802;494;308
3;200806;200800;19-100;1155;680;675;436;239
4;200806;200800;19-100;1266;689;684;414;270
5;200806;200800;19-100;835;531;527;317;210
6;200806;200800;19-100;1411;858;846;572;274
7;200806;200800;19-100;632;392;389;253;136
8;200806;200800;19-100;554;304;301;241;60
9;200806;200800;19-100;667;342;341;258;83
10;200806;200800;19-100;798;515;511;429;82
11;200806;200800;19-100;157;98;98;78;20
12;200806;200800;19-100;285;182;182;139;43
13;200806;200800;19-100;102;62;60;42;18
14;200806;200800;19-100;29;12;12;9;3
1;200807;200800;19-104;1078;642;638;498;140
2;200807;200800;19-104;1125;630;626;572;54
3;200807;200800;19-104;298;163;160;148;12
4;200807;200800;19-104;493;276;276;239;37
5;200807;200800;19-104;166;114;114;109;5
1;200901;200900;16-500;1214;766;757;383;374
2;200901;200900;16-500;1216;757;751;365;386
3;200901;200900;16-500;1371;906;902;423;479
4;200901;200900;16-500;30;18;18;9;9
1;200902;200900;16-506;825;563;561;315;246
2;200902;200900;16-506;345;210;209;145;64
3;200902;200900;16-506;421;272;272;160;112
4;200902;200900;16-506;211;136;136;76;60
5;200902;200900;16-506;321;167;166;123;43
1;200903;200900;16-503;1107;676;670;440;230
2;200903;200900;16-503;906;560;557;357;200
3;200903;200900;16-503;447;293;292;171;121
4;200903;200900;16-503;398;244;243;169;74
1;200904;200900;16-515;1238;576;569;290;279
2;200904;200900;16-515;443;242;238;149;89
3;200904;200900;16-515;579;275;273;147;126
4;200904;200900;16-515;933;571;558;134;424
1;200905;200900;16-500;1405;800;785;484;301
2;200905;200900;16-500;364;183;183;97;86
3;200905;200900;16-500;398;216;215;112;103
4;200905;200900;16-500;222;139;138;96;42
5;200905;200900;16-500;666;380;378;246;132
1;201001;201000;17-300;1640;1103;1089;619;470
2;201001;201000;17-300;847;543;536;323;213
3;201001;201000;17-300;999;615;608;330;278
4;201001;201000;17-300;1523;1022;1017;542;475
5;201001;201000;17-300;1714;1098;1087;549;538
6;201001;201000;17-300;544;342;336;182;154
7;201001;201000;17-300;1802;1179;1165;675;490
8;201001;201000;17-300;849;577;571;344;227
9;201001;201000;17-300;50;23;23;20;3
10;201001;201000;17-300;28;8;8;5;3
1;201002;201000;17-312;1486;969;963;627;336
2;201002;201000;17-312;1082;650;644;482;162
3;201002;201000;17-312;694;428;424;345;79
4;201002;201000;17-312;427;272;269;234;35
5;201002;201000;17-312;846;516;511;415;96
1;201003;201000;17-306;697;465;463;374;89
2;201003;201000;17-306;253;150;149;86;63
3;201003;201000;17-306;477;285;284;239;45
4;201003;201000;17-306;512;287;285;248;37
1;201004;201000;17-315;376;224;224;134;90
2;201004;201000;17-315;834;543;539;400;139
3;201004;201000;17-315;710;449;447;392;55
4;201004;201000;17-315;514;317;317;277;40
5;201004;201000;17-315;582;354;352;245;107
1;201005;201000;17-307;362;225;222;112;110
2;201005;201000;17-307;1209;851;847;497;350
3;201005;201000;17-307;492;291;288;112;176
1;201006;201000;17-332;668;436;427;196;231
2;201006;201000;17-332;242;142;140;53;87
3;201006;201000;17-332;187;98;97;56;41
4;201006;201000;17-332;116;63;63;30;33
5;201006;201000;17-332;187;109;107;75;32
1;201007;201000;17-330;1153;677;675;420;255
2;201007;201000;17-330;986;558;547;314;233
3;201007;201000;17-330;454;205;201;118;83
4;201007;201000;17-330;231;131;130;67;63
1;201008;201000;17-322;171;114;114;100;14
2;201008;201000;17-322;1188;763;753;658;95
3;201008;201000;17-322;355;198;196;131;65
4;201008;201000;17-322;128;84;84;63;21
5;201008;201000;17-322;206;102;102;78;24
1;201009;201000;17-300;399;217;214;87;127
2;201009;201000;17-300;512;337;330;215;115
3;201009;201000;17-300;556;360;359;316;43
4;201009;201000;17-300;289;183;183;80;103
5;201009;201000;17-300;696;411;408;256;152
6;201009;201000;17-300;241;146;146;85;61
7;201009;201000;17-300;273;173;173;124;49
8;201009;201000;17-300;316;196;194;138;56
9;201009;201000;17-300;272;149;148;71;77
10;201009;201000;17-300;306;192;191;103;88
11;201009;201000;17-300;290;179;179;104;75
12;201009;201000;17-300;259;138;136;65;71
13;201009;201000;17-300;29;9;9;8;1
1;201101;201100;16-200;1211;765;755;482;273
2;201101;201100;16-200;816;444;440;294;146
3;201101;201100;16-200;1272;834;826;570;256
4;201101;201100;16-200;863;588;582;365;217
5;201101;201100;16-200;457;299;298;251;47
6;201101;201100;16-200;996;584;580;415;165
7;201101;201100;16-200;693;423;419;345;74
8;201101;201100;16-200;646;404;402;308;94
9;201101;201100;16-200;516;312;309;267;42
10;201101;201100;16-200;287;178;175;157;18
11;201101;201100;16-200;161;92;91;51;40
12;201101;201100;16-200;216;129;127;108;19
13;201101;201100;16-200;50;9;9;7;2
1;201102;201100;16-130;1251;722;715;487;228
2;201102;201100;16-130;597;386;383;313;70
3;201102;201100;16-130;332;188;184;127;57
4;201102;201100;16-130;837;474;472;364;108
1;201103;201100;16-140;310;219;219;166;53
2;201103;201100;16-140;1497;945;938;722;216
3;201103;201100;16-140;312;171;168;123;45
4;201103;201100;16-140;313;191;190;150;40
1;201104;201100;16-120;301;162;162;83;79
2;201104;201100;16-120;613;388;385;231;154
3;201104;201100;16-120;699;464;463;268;195
4;201104;201100;16-120;756;480;476;304;172
1;201105;201100;16-123;1030;677;672;505;167
2;201105;201100;16-123;852;548;541;382;159
3;201105;201100;16-123;332;197;197;149;48
4;201105;201100;16-123;367;237;233;186;47
5;201105;201100;16-123;332;211;210;168;42
1;201106;201100;16-205;505;290;288;217;71
2;201106;201100;16-205;541;291;290;201;89
3;201106;201100;16-205;396;250;250;191;59
4;201106;201100;16-205;472;246;245;185;60
1;201107;201100;16-124;1017;612;604;429;175
2;201107;201100;16-124;148;101;101;74;27
3;201107;201100;16-124;466;284;281;230;51
4;201107;201100;16-124;351;192;191;151;40
5;201107;201100;16-124;223;151;151;113;38
6;201107;201100;16-124;306;201;199;170;29
1;201108;201100;16-100;2012;1374;1365;827;538
2;201108;201100;16-100;1066;710;703;374;329
3;201108;201100;16-100;1138;779;770;425;345
4;201108;201100;16-100;1392;846;841;467;374
5;201108;201100;16-100;1372;893;893;495;398
6;201108;201100;16-100;1990;1374;1365;701;664
7;201108;201100;16-100;1912;1266;1251;756;495
8;201108;201100;16-100;1781;1037;1028;614;414
9;201108;201100;16-100;532;318;312;253;59
10;201108;201100;16-100;820;427;424;303;121
11;201108;201100;16-100;574;366;358;273;85
12;201108;201100;16-100;733;464;461;312;149
13;201108;201100;16-100;617;369;366;269;97
14;201108;201100;16-100;648;390;387;299;88
15;201108;201100;16-100;731;417;412;299;113
16;201108;201100;16-100;160;96;95;80;15
17;201108;201100;16-100;365;233;230;192;38
18;201108;201100;16-100;221;147;145;107;38
19;201108;201100;16-100;52;52;51;43;8
1;201109;201100;16-150;797;490;489;393;96
2;201109;201100;16-150;268;143;143;102;41
3;201109;201100;16-150;800;471;468;303;165
4;201109;201100;16-150;731;480;473;296;177
5;201109;201100;16-150;267;185;181;150;31
6;201109;201100;16-150;780;444;440;366;74
7;201109;201100;16-150;633;376;374;316;58
8;201109;201100;16-150;226;146;143;111;32
9;201109;201100;16-150;328;215;213;192;21
10;201109;201100;16-150;254;157;156;143;13
1;201110;201100;16-113;499;318;313;232;81
2;201110;201100;16-113;758;441;438;243;195
3;201110;201100;16-113;265;151;150;90;60
4;201110;201100;16-113;716;437;434;319;115
1;201201;201200;16-423;770;510;505;324;181
2;201201;201200;16-423;572;346;341;262;79
3;201201;201200;16-423;652;414;411;310;101
4;201201;201200;16-423;322;168;168;135;33
1;201202;201200;16-424;1260;763;760;517;243
2;201202;201200;16-424;1541;906;904;665;239
3;201202;201200;16-424;454;266;264;211;53
1;201203;201200;16-404;285;225;222;160;62
2;201203;201200;16-404;951;623;619;432;187
3;201203;201200;16-404;957;642;636;454;182
4;201203;201200;16-404;209;174;174;112;62
1;201204;201200;16-427;493;309;308;216;92
2;201204;201200;16-427;1021;619;615;489;126
3;201204;201200;16-427;575;362;361;261;100
1;201205;201200;16-420;501;322;318;243;75
2;201205;201200;16-420;939;617;616;486;130
3;201205;201200;16-420;697;441;436;298;138
4;201205;201200;16-420;893;641;633;426;207
5;201205;201200;16-420;361;222;221;183;38
6;201205;201200;16-420;491;309;305;257;48
7;201205;201200;16-420;399;274;269;175;94
1;201206;201200;16-406;791;505;503;370;133
2;201206;201200;16-407;297;218;217;144;73
3;201206;201200;16-406;736;471;466;336;130
1;201207;201200;16-402;480;359;352;188;164
2;201207;201200;16-402;472;320;317;209;108
3;201207;201200;16-402;936;672;664;338;326
4;201207;201200;16-402;422;276;276;201;75
5;201207;201200;16-402;420;277;275;180;95
6;201207;201200;16-402;728;462;458;335;123
7;201207;201200;16-400;1094;758;753;479;274
8;201207;201200;16-402;754;560;555;355;200
9;201207;201200;16-402;239;176;175;107;68
10;201207;201200;16-402;256;160;160;112;48
11;201207;201200;16-402;291;221;221;143;78
1;201208;201200;16-411;1221;771;768;442;326
2;201208;201200;16-411;484;291;288;171;117
3;201208;201200;16-411;809;464;462;317;145
4;201208;201200;16-411;603;367;362;215;147
1;201209;201200;16-407;610;402;398;238;160
2;201209;201200;16-407;748;484;479;369;110
3;201209;201200;16-407;331;219;218;185;33
1;201301;201300;18-200;1740;1316;1307;882;425
2;201301;201300;18-200;1530;1070;1061;808;253
3;201301;201300;18-200;1365;960;949;606;343
4;201301;201300;18-200;1094;777;770;510;260
5;201301;201300;18-200;1007;746;738;541;197
6;201301;201300;18-200;16;10;10;8;2
1;201302;201300;18-230;953;636;629;435;194
2;201302;201300;18-230;839;520;517;377;140
3;201302;201300;18-230;361;232;229;152;77
4;201302;201300;18-230;820;497;491;304;187
5;201302;201300;18-230;746;476;473;347;126
6;201302;201300;18-230;282;170;170;157;13
7;201302;201300;18-230;298;203;199;152;47
8;201302;201300;18-230;303;228;227;215;12
9;201302;201300;18-230;250;187;187;170;17
10;201302;201300;18-230;181;131;131;108;23
11;201302;201300;18-230;316;194;193;180;13
12;201302;201300;18-230;151;96;96;91;5
13;201302;201300;18-230;170;114;113;92;21
14;201302;201300;18-230;285;179;175;144;31
15;201302;201300;18-230;225;146;146;118;28
16;201302;201300;18-230;53;28;27;18;9
17;201302;201300;18-230;68;25;24;19;5
1;201303;201300;18-220;1192;812;809;619;190
2;201303;201300;18-220;1030;742;737;557;180
3;201303;201300;18-220;810;553;551;485;66
4;201303;201300;18-220;517;389;383;335;48
5;201303;201300;18-220;531;402;400;353;47
6;201303;201300;18-220;420;322;321;221;100
7;201303;201300;18-220;213;173;173;148;25
1;201304;201300;18-214;1172;863;855;777;78
2;201304;201300;18-214;1018;780;773;694;79
3;201304;201300;18-214;965;682;677;593;84
1;201305;201300;18-204;636;417;416;360;56
2;201305;201300;18-204;619;435;433;414;19
3;201305;201300;18-204;374;271;270;258;12
4;201305;201300;18-204;526;388;387;354;33
5;201305;201300;18-204;236;148;148;118;30
1;201306;201300;18-208;543;412;410;371;39
2;201306;201300;18-208;628;440;436;401;35
3;201306;201300;18-208;629;494;492;471;21
4;201306;201300;18-208;431;337;336;319;17
1;201307;201300;18-212;857;634;634;548;86
2;201307;201300;18-212;930;702;697;601;96
3;201307;201300;18-212;1000;754;745;681;64
1;201308;201300;18-218;640;434;433;412;21
2;201308;201300;18-218;1200;898;894;795;99
3;201308;201300;18-218;1159;827;825;744;81
4;201308;201300;18-218;1101;782;773;619;154
5;201308;201300;18-218;110;14;14;9;5
6;201308;201300;18-218;39;37;37;19;18
1;201309;201300;18-210;666;446;440;288;152
2;201309;201300;18-210;895;650;644;410;234
3;201309;201300;18-210;590;415;414;365;49
4;201309;201300;18-210;1087;789;783;695;88
5;201309;201300;18-210;1072;741;733;603;130
6;201309;201300;18-210;475;363;361;326;35
7;201309;201300;18-210;168;143;139;117;22
1;201310;201300;18-200;1179;863;850;688;162
2;201310;201300;18-200;1011;724;718;643;75
3;201310;201300;18-218;199;148;147;135;12
4;201310;201300;18-200;246;177;176;139;37
5;201310;201300;18-200;259;186;184;164;20
6;201310;201300;18-200;286;230;227;183;44
7;201310;201300;18-200;263;186;185;149;36
8;201310;201300;18-200;251;197;197;180;17
9;201310;201300;18-200;169;133;131;121;10
10;201310;201300;18-200;155;103;102;84;18
1;201401;201400;18-300;1565;1067;1058;669;389
2;201401;201400;18-300;1500;1071;1068;679;389
3;201401;201400;18-300;1111;673;665;453;212
4;201401;201400;18-300;1060;758;757;491;266
5;201401;201400;18-300;815;551;551;349;202
6;201401;201400;18-300;1550;1072;1064;720;344
7;201401;201400;18-300;1060;719;713;479;234
8;201401;201400;18-300;748;474;471;277;194
9;201401;201400;18-300;1574;1025;1021;638;383
10;201401;201400;18-300;573;351;351;207;144
11;201401;201400;18-300;1202;679;673;471;202
12;201401;201400;18-300;1514;851;842;592;250
13;201401;201400;18-300;1155;662;660;478;182
14;201401;201400;18-300;41;28;28;20;8
1;201402;201400;18-315;610;455;450;400;50
2;201402;201400;18-315;606;471;468;419;49
3;201402;201400;18-315;515;369;368;329;39
1;201403;201400;18-312;722;477;473;433;40
2;201403;201400;18-312;864;597;595;554;41
3;201403;201400;18-312;556;308;305;227;78
4;201403;201400;18-312;505;344;344;300;44
5;201403;201400;18-312;946;645;636;487;149
6;201403;201400;18-312;229;139;137;101;36
7;201403;201400;18-312;181;128;127;105;22
8;201403;201400;18-312;165;142;137;41;96
1;201404;201400;18-305;695;483;480;360;120
2;201404;201400;18-305;475;351;344;274;70
3;201404;201400;18-305;495;325;322;298;24
4;201404;201400;18-305;332;250;249;204;45
5;201404;201400;18-305;398;260;256;215;41
6;201404;201400;18-305;181;121;121;102;19
7;201404;201400;18-305;334;229;229;180;49
8;201404;201400;18-305;184;143;140;118;22
9;201404;201400;18-305;296;202;201;167;34
10;201404;201400;18-305;181;131;128;111;17
1;201405;201400;18-300;420;301;301;249;52
2;201405;201400;18-300;676;504;503;419;84
3;201405;201400;18-300;607;406;402;296;106
4;201405;201400;18-300;762;536;530;449;81
5;201405;201400;18-300;356;234;233;160;73
6;201405;201400;18-300;439;349;346;317;29
7;201405;201400;18-300;390;272;270;217;53
8;201405;201400;18-300;434;311;311;284;27
9;201405;201400;18-300;498;335;334;250;84
10;201405;201400;18-300;564;401;400;268;132
11;201405;201400;18-300;548;388;386;332;54
12;201405;201400;18-300;448;313;312;209;103
13;201405;201400;18-300;417;309;309;243;66
14;201405;201400;18-400;752;577;560;116;444
1;206101;206100;15-873;1110;789;778;393;385
2;206101;206100;15-873;910;675;669;338;331
3;206101;206100;15-879;1273;925;917;482;435
4;206101;206100;15-879;1110;824;815;371;444
5;206101;206100;15-873;1644;1290;1276;557;719
6;206101;206100;15-312;1210;828;817;360;457
7;206101;206100;15-312;815;597;590;281;309
8;206101;206100;15-307;1164;871;864;386;478
9;206101;206100;15-281;1657;1306;1293;473;820
10;206101;206100;15-281;1009;715;709;335;374
11;206101;206100;15-274;940;671;665;306;359
12;206101;206100;15-274;1238;898;888;354;534
13;206101;206100;15-354;1428;989;975;466;509
14;206101;206100;15-354;1383;1080;1065;446;619
15;206101;206100;15-370;1301;881;868;425;443
16;206101;206100;15-370;1481;1086;1071;495;576
17;206101;206100;15-370;1268;867;863;434;429
18;206101;206100;15-337;1314;1007;994;454;540
19;206101;206100;15-337;1411;1110;1103;494;609
20;206101;206100;15-337;1447;1137;1125;492;633
21;206101;206100;15-325;1770;1395;1382;756;626
22;206101;206100;15-349;1383;988;980;511;469
23;206101;206100;15-337;1178;883;876;480;396
24;206101;206100;15-338;1216;877;866;471;395
25;206101;206100;15-338;1388;963;957;522;435
26;206101;206100;15-338;1231;877;857;417;440
27;206101;206100;15-338;1262;931;920;376;544
28;206101;206100;15-338;1232;983;967;504;463
29;206101;206100;15-281;665;441;439;168;271
30;206101;206100;15-889;844;592;585;246;339
31;206101;206100;15-459;1020;656;650;314;336
32;206101;206100;15-459;1075;751;745;316;429
33;206101;206100;15-875;753;525;519;205;314
34;206101;206100;15-446;1039;722;717;287;430
35;206101;206100;15-461;1089;674;667;323;344
36;206101;206100;15-461;1117;733;726;400;326
37;206101;206100;15-465;1028;724;717;337;380
38;206101;206100;15-863;1257;966;960;492;468
39;206101;206100;15-868;873;648;644;333;311
40;206101;206100;15-863;1168;824;816;425;391
41;206101;206100;15-865;1194;840;831;438;393
42;206101;206100;15-865;1259;975;967;500;467
43;206101;206100;15-865;1026;765;761;378;383
44;206101;206100;15-111;1340;1082;1076;476;600
45;206101;206100;15-114;1403;1070;1056;511;545
46;206101;206100;15-114;1053;733;727;367;360
47;206101;206100;15-002;1080;850;835;331;504
48;206101;206100;15-002;774;528;526;255;271
49;206101;206100;15-472;1256;886;873;389;484
50;206101;206100;15-121;1391;1032;1025;498;527
51;206101;206100;15-182;1039;753;745;395;350
52;206101;206100;15-151;1407;975;964;523;441
53;206101;206100;15-151;1338;969;964;548;416
54;206101;206100;15-197;1311;914;905;486;419
55;206101;206100;15-197;1187;834;828;398;430
56;206101;206100;15-197;1259;1012;999;420;579
57;206101;206100;15-197;1255;947;933;504;429
58;206101;206100;15-131;1407;1065;1053;560;493
59;206101;206100;15-131;1702;1219;1206;553;653
60;206101;206100;15-131;1572;1186;1171;631;540
61;206101;206100;15-157;1485;1182;1167;539;628
62;206101;206100;15-157;924;729;721;399;322
63;206101;206100;15-157;1733;1405;1393;646;747
64;206101;206100;15-063;646;493;482;218;264
65;206101;206100;15-042;1304;1015;1004;355;649
66;206101;206100;15-017;1176;939;931;489;442
67;206101;206100;15-021;1166;918;910;356;554
68;206101;206100;15-021;1378;999;989;448;541
69;206101;206100;15-029;1588;1223;1217;564;653
70;206101;206100;15-040;996;727;720;358;362
71;206101;206100;15-040;1224;861;855;394;461
72;206101;206100;15-054;1511;1070;1059;492;567
73;206101;206100;15-054;989;791;784;377;407
74;206101;206100;15-054;1150;857;847;446;401
75;206101;206100;15-054;1276;933;931;432;499
76;206101;206100;15-054;1196;866;859;427;432
77;206101;206100;15-029;957;714;705;330;375
78;206101;206100;15-207;977;679;670;316;354
79;206101;206100;15-207;1089;761;756;385;371
80;206101;206100;15-207;1182;827;819;367;452
81;206101;206100;15-207;878;619;611;269;342
82;206101;206100;15-215;1301;938;928;409;519
83;206101;206100;15-215;1042;788;777;365;412
84;206101;206100;15-225;1184;874;864;324;540
85;206101;206100;15-225;1113;843;836;380;456
86;206101;206100;15-249;1034;783;776;399;377
87;206101;206100;15-249;1329;1001;988;473;515
88;206101;206100;15-553;1328;1061;1045;444;601
89;206101;206100;15-553;1152;851;842;370;472
90;206101;206100;15-559;1978;1434;1421;658;763
91;206101;206100;15-559;1322;1008;997;453;544
92;206101;206100;15-559;1268;872;863;434;429
93;206101;206100;15-540;1215;914;904;367;537
94;206101;206100;15-540;990;680;673;370;303
95;206101;206100;15-572;1293;980;973;574;399
96;206101;206100;15-572;1906;1473;1460;686;774
97;206101;206100;15-572;1454;1158;1148;472;676
98;206101;206100;15-720;1378;1022;1020;536;484
99;206101;206100;15-703;944;630;622;385;237
100;206101;206100;15-720;1186;880;874;468;406
101;206101;206100;15-668;1268;918;910;457;453
102;206101;206100;15-668;982;686;679;302;377
103;206101;206100;15-668;835;623;616;280;336
104;206101;206100;15-662;1258;845;837;453;384
105;206101;206100;15-662;1034;712;705;386;319
106;206101;206100;15-662;1021;757;746;347;399
107;206101;206100;15-660;1013;716;710;358;352
108;206101;206100;15-661;1371;1029;1017;489;528
109;206101;206100;15-661;1391;1017;1008;511;497
110;206101;206100;15-661;1430;1066;1058;499;559
111;206101;206100;15-661;1173;873;864;447;417
112;206101;206100;15-661;1383;1062;1045;474;571
113;206101;206100;15-665;1026;755;744;370;374
114;206101;206100;15-665;1106;804;795;388;407
115;206101;206100;15-665;1112;845;840;431;409
116;206101;206100;15-674;1273;912;900;447;453
117;206101;206100;15-669;1151;839;834;490;344
118;206101;206100;15-669;949;726;713;343;370
119;206101;206100;15-669;949;682;676;347;329
120;206101;206100;15-669;1103;790;781;407;374
121;206101;206100;15-656;1348;997;987;493;494
122;206101;206100;15-656;834;594;589;310;279
123;206101;206100;15-612;974;629;623;397;226
124;206101;206100;15-612;1378;1005;996;536;460
125;206101;206100;15-612;976;719;705;368;337
126;206101;206100;15-639;593;425;421;235;186
127;206101;206100;15-639;909;572;568;372;196
128;206101;206100;15-748;1234;841;832;441;391
129;206101;206100;15-748;1114;698;693;372;321
130;206101;206100;15-748;979;682;675;341;334
131;206101;206100;15-748;1139;791;785;391;394
132;206101;206100;15-743;1170;846;838;450;388
133;206101;206100;15-743;1022;621;613;320;293
134;206101;206100;15-827;1113;828;821;457;364
135;206101;206100;15-827;1017;768;763;379;384
136;206101;206100;15-840;958;676;667;324;343
137;206101;206100;15-840;1362;1032;1023;482;541
138;206101;206100;15-762;1337;1046;1036;533;503
139;206101;206100;15-773;1300;882;873;482;391
140;206101;206100;15-773;1137;838;825;458;367
141;206101;206100;15-773;1029;798;791;369;422
142;206101;206100;15-808;915;708;698;340;358
143;206101;206100;15-806;1055;774;761;397;364
144;206101;206100;15-806;1252;873;867;370;497
145;206101;206100;15-814;1219;839;831;446;385
146;206101;206100;15-808;1238;847;832;439;393
147;206101;206100;15-795;1258;946;937;398;539
148;206101;206100;15-795;1720;1403;1396;689;707
149;206101;206100;15-795;956;660;660;365;295
150;206101;206100;15-795;1159;783;774;400;374
151;206101;206100;15-794;701;501;497;264;233
152;206101;206100;15-815;1072;713;709;370;339
153;206101;206100;15-815;1093;768;764;397;367
154;206101;206100;15-815;1171;848;838;421;417
155;206101;206100;15-741;1280;849;844;471;373
156;206101;206100;15-741;1173;795;787;440;347
157;206101;206100;15-757;1184;845;835;438;397
158;206101;206100;15-757;1243;952;942;501;441
159;206101;206100;15-757;1175;868;862;406;456
160;206101;206100;15-757;1124;838;830;411;419
161;206101;206100;15-757;1058;787;781;357;424
162;206101;206100;15-687;1323;1012;1000;504;496
163;206101;206100;15-687;1282;982;964;510;454
164;206101;206100;15-687;1144;888;877;425;452
165;206101;206100;15-687;1543;1050;1042;555;487
166;206101;206100;15-687;956;663;656;345;311
167;206101;206100;15-687;1246;928;921;479;442
168;206101;206100;15-687;1299;868;864;456;408
169;206101;206100;15-687;1378;947;935;517;418
170;206101;206100;15-197;1196;939;922;439;483
171;206101;206100;15-370;1064;845;836;360;476
172;206101;206100;15-338;1350;1116;1105;526;579
173;206101;206100;15-111;1181;907;893;417;476
174;206101;206100;15-197;1399;1068;1056;588;468
175;206101;206100;15-054;1002;793;779;315;464
176;206101;206100;15-661;1488;1039;1030;528;502
177;206101;206100;15-687;1030;783;774;422;352
178;206101;206100;15-278;122;79;78;48;30
179;206101;206100;15-278;39;28;26;16;10
180;206101;206100;15-278;18;18;18;7;11
181;206101;206100;15-278;45;20;20;9;11
182;206101;206100;15-278;115;102;99;57;42
183;206101;206100;15-278;91;91;90;48;42
184;206101;206100;15-278;77;72;71;44;27
185;206101;206100;15-504;99;88;87;43;44
186;206101;206100;15-482;67;50;50;23;27
187;206101;206100;15-003;59;31;31;16;15
188;206101;206100;15-027;66;66;66;40;26
189;206101;206100;15-328;173;128;122;78;44
190;206101;206100;15-727;263;190;185;41;144
191;206101;206100;15-377;450;345;339;76;263
192;206101;206100;15-449;15;14;14;14;0
1;206201;206200;18-400;1638;1121;1115;646;469
2;206201;206200;18-400;1216;812;807;461;346
3;206201;206200;18-400;1717;1012;1006;615;391
4;206201;206200;18-400;488;254;251;177;74
5;206201;206200;18-400;1200;769;765;442;323
6;206201;206200;18-400;1096;637;630;397;233
7;206201;206200;18-400;1190;759;749;459;290
8;206201;206200;18-400;586;410;403;253;150
9;206201;206200;18-400;1404;1009;998;602;396
10;206201;206200;18-400;1126;797;789;569;220
11;206201;206200;18-400;2098;1553;1543;930;613
12;206201;206200;18-400;1174;698;695;457;238
13;206201;206200;18-400;1158;802;794;570;224
14;206201;206200;18-400;1398;928;916;534;382
15;206201;206200;18-400;1320;938;932;606;326
16;206201;206200;18-400;1651;1213;1204;690;514
17;206201;206200;18-400;1436;984;981;581;400
18;206201;206200;18-400;1440;1002;993;608;385
19;206201;206200;18-400;1666;1078;1071;668;403
20;206201;206200;18-400;1389;984;979;571;408
21;206201;206200;18-400;1355;983;972;607;365
22;206201;206200;18-400;1838;1375;1370;828;542
23;206201;206200;18-400;1470;1074;1068;652;416
24;206201;206200;18-400;1635;1172;1164;729;435
25;206201;206200;18-400;1271;864;858;529;329
26;206201;206200;18-400;1573;1094;1081;654;427
27;206201;206200;18-400;1790;1288;1281;791;490
28;206201;206200;18-400;1425;1002;995;646;349
29;206201;206200;18-400;649;420;413;249;164
30;206201;206200;18-400;1140;774;765;509;256
31;206201;206200;18-400;2165;1640;1627;987;640
32;206201;206200;18-400;119;119;118;70;48
1;206301;206300;16-400;2092;1440;1426;749;677
2;206301;206300;16-400;1835;1215;1197;649;548
3;206301;206300;16-400;1604;1177;1164;631;533
4;206301;206300;16-400;2165;1568;1549;786;763
5;206301;206300;16-400;1141;756;751;459;292
6;206301;206300;16-400;1027;707;699;379;320
7;206301;206300;16-400;2264;1437;1423;830;593
8;206301;206300;16-400;597;356;355;182;173
9;206301;206300;16-400;948;507;501;297;204
10;206301;206300;16-400;1470;1012;1006;633;373
11;206301;206300;16-400;620;419;413;228;185
12;206301;206300;16-400;1346;832;827;443;384
13;206301;206300;16-400;1027;679;671;377;294
14;206301;206300;16-400;1506;1021;1012;473;539
15;206301;206300;16-400;1012;708;707;377;330
16;206301;206300;16-400;1031;710;706;329;377
17;206301;206300;16-400;1402;906;897;540;357
18;206301;206300;16-400;1813;1275;1269;703;566
19;206301;206300;16-400;1887;1329;1313;721;592
20;206301;206300;16-400;1975;1404;1392;681;711
21;206301;206300;16-400;1196;775;773;455;318
22;206301;206300;16-400;2329;1656;1638;915;723
23;206301;206300;16-400;154;81;74;51;23
24;206301;206300;16-400;1529;982;975;523;452
25;206301;206300;16-400;1261;861;857;491;366
26;206301;206300;16-400;1686;1122;1120;705;415
27;206301;206300;16-400;1508;1037;1028;627;401
28;206301;206300;16-400;1128;732;725;406;319
29;206301;206300;16-400;1509;978;970;558;412
30;206301;206300;16-400;1265;836;830;467;363
31;206301;206300;16-400;1305;822;817;449;368
32;206301;206300;16-400;1366;888;878;532;346
33;206301;206300;16-400;1838;1237;1228;745;483
34;206301;206300;16-400;1341;922;911;523;388
35;206301;206300;16-400;524;388;385;86;299
36;206301;206300;16-400;211;85;84;50;34
37;206301;206300;16-400;115;78;78;44;34
38;206301;206300;16-400;46;39;39;26;13
1;220101;220100;77-141;983;687;683;366;317
2;220101;220100;77-100;489;312;310;146;164
3;220101;220100;77-141;429;271;265;163;102
4;220101;220100;77-141;164;102;100;56;44
5;220101;220100;77-141;220;145;144;80;64
6;220101;220100;77-141;156;112;111;75;36
7;220101;220100;77-141;169;122;121;78;43
1;220102;220100;77-100;789;595;587;286;301
2;220102;220100;77-100;743;532;530;271;259
3;220102;220100;77-100;553;349;345;147;198
4;220102;220100;77-100;605;402;398;181;217
5;220102;220100;77-100;785;489;481;197;284
6;220102;220100;77-100;582;361;360;182;178
7;220102;220100;77-100;586;377;377;173;204
8;220102;220100;77-100;633;434;430;213;217
9;220102;220100;77-100;684;469;465;219;246
10;220102;220100;77-100;550;406;403;137;266
11;220102;220100;77-100;535;395;391;145;246
12;220102;220100;77-100;451;324;320;129;191
13;220102;220100;77-100;516;408;405;154;251
14;220102;220100;77-100;660;405;405;194;211
15;220102;220100;77-100;678;442;436;215;221
16;220102;220100;77-100;535;378;378;166;212
17;220102;220100;77-100;621;453;451;177;274
18;220102;220100;77-100;535;396;389;181;208
19;220102;220100;77-100;507;365;363;151;212
20;220102;220100;77-114;749;466;465;306;159
21;220102;220100;77-121;870;581;577;339;238
22;220102;220100;77-100;452;358;352;127;225
23;220102;220100;77-100;498;391;388;123;265
24;220102;220100;77-100;556;426;420;162;258
25;220102;220100;77-100;285;189;189;127;62
26;220102;220100;77-100;480;323;322;136;186
27;220102;220100;77-100;739;497;493;248;245
28;220102;220100;77-132;759;487;481;291;190
29;220102;220100;77-131;363;233;230;122;108
30;220102;220100;77-131;167;109;109;60;49
31;220102;220100;77-100;130;99;96;34;62
32;220102;220100;77-100;117;86;86;61;25
33;220102;220100;77-100;49;24;23;12;11
34;220102;220100;77-100;53;53;47;25;22
1;220103;220100;77-116;1025;710;706;390;316
2;220103;220100;77-122;454;307;304;156;148
3;220103;220100;76-243;233;145;145;79;66
4;220103;220100;77-123;897;619;616;446;170
5;220103;220100;77-115;399;282;280;141;139
6;220103;220100;77-116;170;96;95;65;30
7;220103;220100;77-116;186;121;120;67;53
8;220103;220100;77-116;284;181;179;105;74
9;220103;220100;77-116;209;133;132;113;19
10;220103;220100;77-116;252;163;159;116;43
11;220103;220100;77-116;201;126;125;90;35
1;220104;220100;77-140;950;603;598;296;302
2;220104;220100;77-140;602;325;321;192;129
3;220104;220100;77-140;349;187;187;116;71
4;220104;220100;77-140;546;303;300;174;126
5;220104;220100;77-140;200;121;119;85;34
6;220104;220100;77-140;234;131;131;74;57
7;220104;220100;77-140;229;141;141;100;41
1;220105;220100;77-138;716;489;488;300;188
2;220105;220100;77-130;864;566;554;442;112
3;220105;220100;77-139;534;338;333;234;99
4;220105;220100;77-130;961;683;674;451;223
5;220105;220100;77-130;471;317;316;220;96
6;220105;220100;77-139;338;250;245;166;79
7;220105;220100;77-130;192;139;139;104;35
1;220106;220100;77-200;809;513;507;243;264
2;220106;220100;77-200;792;503;500;216;284
3;220106;220100;77-200;903;565;560;245;315
4;220106;220100;77-200;862;523;516;207;309
5;220106;220100;77-200;704;421;417;171;246
6;220106;220100;77-200;938;601;596;236;360
7;220106;220100;77-200;783;473;468;186;282
8;220106;220100;77-200;1088;694;689;278;411
9;220106;220100;77-203;967;530;524;229;295
10;220106;220100;77-211;517;235;232;111;121
11;220106;220100;77-222;495;231;227;111;116
12;220106;220100;77-200;456;258;255;140;115
13;220106;220100;77-207;540;276;274;168;106
14;220106;220100;77-200;883;485;478;213;265
15;220106;220100;77-200;968;644;635;227;408
16;220106;220100;77-200;325;172;168;99;69
17;220106;220100;77-200;369;180;177;89;88
18;220106;220100;77-200;235;121;117;49;68
19;220106;220100;77-205;303;134;133;83;50
20;220106;220100;77-207;322;154;153;91;62
21;220106;220100;77-200;92;27;27;9;18
22;220106;220100;77-200;44;23;19;4;15
1;220107;220100;77-124;973;758;750;449;301
2;220107;220100;77-127;534;385;381;243;138
3;220107;220100;77-124;250;185;185;151;34
4;220107;220100;77-121;363;259;258;143;115
5;220107;220100;77-124;314;244;240;176;64
6;220107;220100;77-124;235;176;176;120;56
7;220107;220100;77-124;230;167;165;115;50
1;220108;220100;77-143;897;650;639;298;341
2;220108;220100;77-125;632;443;442;292;150
3;220108;220100;77-142;835;553;550;256;294
4;220108;220100;77-143;304;220;219;100;119
5;220108;220100;77-143;217;133;133;83;50
1;220109;220100;77-235;826;519;509;226;283
2;220109;220100;77-235;886;508;504;244;260
3;220109;220100;77-235;226;145;145;89;56
4;220109;220100;77-235;364;189;187;119;68
5;220109;220100;77-235;351;223;222;90;132
6;220109;220100;77-203;18;18;18;6;12
1;220110;220100;77-133;1075;666;658;354;304
2;220110;220100;77-133;349;191;190;116;74
3;220110;220100;77-134;493;306;306;199;107
4;220110;220100;77-135;467;307;302;182;120
5;220110;220100;77-133;305;167;166;115;51
6;220110;220100;77-132;147;88;87;63;24
7;220110;220100;77-133;176;110;110;66;44
8;220110;220100;77-134;175;113;112;67;45
1;220201;220200;89-600;1725;1313;1297;570;727
2;220201;220200;89-600;1126;710;700;319;381
3;220201;220200;89-600;1257;903;897;399;498
4;220201;220200;89-600;764;561;557;309;248
5;220201;220200;89-600;1521;985;978;479;499
6;220201;220200;89-600;1688;1023;1016;461;555
7;220201;220200;89-600;1514;1108;1091;473;618
8;220201;220200;89-600;1017;595;592;259;333
9;220201;220200;89-600;971;598;591;275;316
10;220201;220200;89-600;822;556;550;247;303
11;220201;220200;89-600;921;681;679;262;417
12;220201;220200;89-600;1239;804;799;354;445
13;220201;220200;89-600;1425;964;958;389;569
14;220201;220200;89-600;1295;923;916;435;481
15;220201;220200;89-600;1380;952;946;400;546
16;220201;220200;89-600;1687;1219;1207;450;757
17;220201;220200;89-600;1434;1012;996;436;560
18;220201;220200;89-600;1666;1180;1168;491;677
19;220201;220200;89-600;1087;752;749;295;454
20;220201;220200;89-600;1624;1245;1234;507;727
21;220201;220200;89-600;1387;988;979;475;504
22;220201;220200;89-600;115;73;70;41;29
23;220201;220200;89-600;60;31;27;19;8
24;220201;220200;89-600;105;82;81;31;50
1;220202;220200;89-632;827;615;609;381;228
2;220202;220200;89-632;798;606;603;370;233
3;220202;220200;89-632;611;482;480;290;190
4;220202;220200;89-632;701;526;521;294;227
5;220202;220200;89-632;626;448;443;267;176
6;220202;220200;89-632;742;528;525;363;162
7;220202;220200;89-634;911;646;638;475;163
8;220202;220200;89-632;694;484;477;382;95
9;220202;220200;89-632;458;315;315;255;60
10;220202;220200;89-632;881;648;645;494;151
11;220202;220200;89-632;678;516;513;219;294
12;220202;220200;89-632;548;367;366;266;100
13;220202;220200;89-632;636;456;451;317;134
14;220202;220200;89-632;205;144;142;116;26
15;220202;220200;89-632;234;194;191;156;35
16;220202;220200;89-634;174;127;127;119;8
17;220202;220200;89-632;383;289;287;224;63
18;220202;220200;89-634;424;288;287;204;83
1;220203;220200;89-608;1128;769;762;308;454
2;220203;220200;89-606;956;730;724;200;524
3;220203;220200;89-606;1069;847;841;332;509
4;220203;220200;89-632;903;639;636;357;279
5;220203;220200;89-641;755;519;517;285;232
6;220203;220200;89-641;1199;799;792;594;198
7;220203;220200;89-620;1190;836;832;530;302
8;220203;220200;89-620;954;611;605;397;208
9;220203;220200;89-620;361;230;230;116;114
10;220203;220200;89-620;1132;709;707;397;310
11;220203;220200;89-620;391;262;259;192;67
12;220203;220200;89-665;846;545;542;350;192
13;220203;220200;89-665;247;158;157;108;49
14;220203;220200;89-620;778;496;487;269;218
15;220203;220200;89-620;359;187;186;126;60
16;220203;220200;89-620;327;152;149;94;55
17;220203;220200;89-620;379;253;251;175;76
18;220203;220200;89-620;393;328;323;157;166
19;220203;220200;89-620;186;117;117;68;49
20;220203;220200;89-620;189;118;116;77;39
21;220203;220200;89-606;895;656;648;206;442
1;220204;220200;89-650;1436;944;940;536;404
2;220204;220200;89-650;1695;1140;1129;689;440
3;220204;220200;89-650;1772;1172;1164;680;484
4;220204;220200;89-650;2200;1385;1377;882;495
5;220204;220200;89-650;510;331;331;234;97
6;220204;220200;89-642;334;221;221;154;67
7;220204;220200;89-642;504;324;317;227;90
8;220204;220200;89-642;1630;1136;1127;633;494
9;220204;220200;89-642;423;280;280;163;117
10;220204;220200;89-642;300;188;188;136;52
11;220204;220200;89-650;496;345;342;219;123
12;220204;220200;89-651;499;311;307;219;88
13;220204;220200;89-651;611;408;404;261;143
14;220204;220200;89-652;904;559;555;324;231
15;220204;220200;89-650;716;480;475;321;154
16;220204;220200;89-650;355;244;242;156;86
17;220204;220200;89-652;353;232;231;188;43
18;220204;220200;89-650;209;150;148;108;40
19;220204;220200;89-652;376;223;217;135;82
20;220204;220200;89-652;513;325;321;212;109
21;220204;220200;89-650;23;12;12;3;9
1;220205;220200;89-607;1240;811;805;484;321
2;220205;220200;89-607;448;294;290;215;75
1;220301;220300;77-300;1078;741;738;306;432
2;220301;220300;77-300;1178;790;783;292;491
3;220301;220300;77-300;1072;702;701;281;420
4;220301;220300;77-300;679;438;434;215;219
5;220301;220300;77-300;1378;949;944;365;579
6;220301;220300;77-300;1280;889;878;286;592
7;220301;220300;77-300;1368;915;911;368;543
8;220301;220300;77-300;1575;1120;1108;412;696
9;220301;220300;77-300;152;47;45;20;25
1;220302;220300;77-330;769;473;471;178;293
2;220302;220300;77-330;693;426;423;178;245
3;220302;220300;77-330;534;392;388;164;224
4;220302;220300;77-330;246;138;133;91;42
5;220302;220300;77-326;566;331;328;173;155
6;220302;220300;77-324;472;254;250;136;114
7;220302;220300;77-330;422;209;206;117;89
8;220302;220300;77-330;492;249;246;139;107
9;220302;220300;77-330;601;376;375;128;247
10;220302;220300;77-330;557;288;285;135;150
11;220302;220300;77-330;687;445;441;167;274
12;220302;220300;77-330;1066;739;729;73;656
13;220302;220300;77-330;66;48;45;9;36
14;220302;220300;77-330;29;28;28;13;15
15;220302;220300;77-330;95;38;36;15;21
1;220303;220300;77-300;1067;652;647;351;296
2;220303;220300;77-300;738;532;527;279;248
3;220303;220300;77-300;476;256;253;135;118
4;220303;220300;77-300;272;139;134;91;43
5;220303;220300;77-300;823;576;570;268;302
6;220303;220300;77-300;281;181;176;123;53
7;220303;220300;77-300;272;156;156;95;61
8;220303;220300;77-300;293;165;159;97;62
9;220303;220300;77-300;189;128;128;90;38
10;220303;220300;77-300;456;296;292;128;164
11;220303;220300;77-300;552;365;354;200;154
12;220303;220300;77-300;204;117;117;85;32
13;220303;220300;77-300;203;131;129;77;52
14;220303;220300;77-300;145;88;88;56;32
15;220303;220300;77-300;277;164;163;96;67
16;220303;220300;77-300;186;100;98;69;29
17;220303;220300;77-300;248;156;154;70;84
18;220303;220300;77-300;340;150;150;109;41
19;220303;220300;77-300;217;124;124;83;41
20;220303;220300;77-300;159;101;100;55;45
21;220303;220300;77-300;271;146;145;93;52
22;220303;220300;77-300;285;130;130;111;19
1;220304;220300;77-310;736;441;439;157;282
2;220304;220300;77-310;967;514;511;227;284
3;220304;220300;77-310;1052;633;625;309;316
4;220304;220300;77-310;744;510;503;185;318
5;220304;220300;77-310;315;124;123;52;71
6;220304;220300;77-310;483;258;257;176;81
7;220304;220300;77-310;291;158;158;103;55
8;220304;220300;77-310;413;212;211;122;89
9;220304;220300;77-310;325;181;180;96;84
10;220304;220300;77-310;361;181;180;108;72
11;220304;220300;77-310;473;228;225;123;102
12;220304;220300;77-310;152;86;86;46;40
1;220305;220300;77-220;430;246;242;150;92
2;220305;220300;77-220;684;385;383;156;227
3;220305;220300;77-220;857;507;502;188;314
4;220305;220300;77-220;395;233;231;99;132
1;220306;220300;77-320;331;145;145;74;71
2;220306;220300;77-320;549;322;319;188;131
3;220306;220300;77-320;537;341;339;196;143
4;220306;220300;77-320;847;571;567;235;332
5;220306;220300;77-320;797;499;493;204;289
6;220306;220300;77-320;694;487;483;185;298
7;220306;220300;77-320;251;159;159;96;63
8;220306;220300;77-320;219;119;118;67;51
9;220306;220300;77-320;234;138;138;96;42
10;220306;220300;77-300;127;83;83;30;53
1;220307;220300;77-304;588;349;347;191;156
2;220307;220300;77-304;708;453;448;246;202
3;220307;220300;77-304;336;196;196;124;72
4;220307;220300;77-304;355;233;232;125;107
5;220307;220300;77-304;390;235;233;136;97
6;220307;220300;77-304;238;155;153;100;53
1;220401;220400;83-000;2281;1860;1842;568;1274
2;220401;220400;83-000;1066;795;789;306;483
3;220401;220400;83-000;2213;1671;1647;551;1096
4;220401;220400;83-000;751;506;500;210;290
5;220401;220400;83-000;1748;1318;1307;445;862
6;220401;220400;83-000;1091;811;805;299;506
7;220401;220400;83-000;1723;1278;1269;447;822
8;220401;220400;83-000;773;494;488;233;255
9;220401;220400;83-000;802;639;627;175;452
10;220401;220400;83-000;1063;797;790;287;503
11;220401;220400;83-000;1851;1357;1334;437;897
12;220401;220400;83-000;1190;842;827;301;526
13;220401;220400;83-000;1043;830;827;266;561
14;220401;220400;83-000;2318;1882;1862;533;1329
15;220401;220400;83-000;1622;1272;1258;445;813
16;220401;220400;83-000;1414;1067;1052;369;683
1;220402;220400;83-020;1138;701;699;337;362
2;220402;220400;83-020;1225;798;791;334;457
3;220402;220400;83-020;752;470;469;216;253
4;220402;220400;83-011;628;427;421;164;257
5;220402;220400;83-020;307;176;174;101;73
6;220402;220400;83-020;604;383;379;264;115
7;220402;220400;83-020;557;420;414;204;210
1;220403;220400;83-050;1835;1360;1349;560;789
2;220403;220400;83-050;965;752;739;245;494
3;220403;220400;83-050;1160;877;860;350;510
4;220403;220400;83-050;1980;1680;1663;505;1158
5;220403;220400;80-180;1355;1061;1052;292;760
6;220403;220400;80-180;1132;937;929;252;677
7;220403;220400;83-050;1100;811;804;326;478
8;220403;220400;83-050;1606;1267;1255;447;808
9;220403;220400;83-050;988;773;766;234;532
10;220403;220400;83-050;474;271;270;105;165
11;220403;220400;80-180;872;712;704;185;519
12;220403;220400;80-180;1675;1349;1330;435;895
1;220404;220400;83-010;1064;822;811;309;502
2;220404;220400;83-000;754;462;460;233;227
3;220404;220400;83-010;2202;1725;1707;497;1210
4;220404;220400;83-010;2398;1916;1901;581;1320
5;220404;220400;83-010;1607;1261;1247;437;810
6;220404;220400;80-180;2265;1943;1920;459;1461
7;220404;220400;83-000;1370;1101;1085;380;705
8;220404;220400;83-011;1317;966;956;346;610
9;220404;220400;83-021;1820;1347;1331;513;818
10;220404;220400;83-031;1999;1475;1458;611;847
11;220404;220400;83-031;966;753;748;298;450
12;220404;220400;83-031;1065;768;762;306;456
13;220404;220400;83-021;1303;860;855;394;461
14;220404;220400;80-180;1660;1345;1335;384;951
15;220404;220400;83-021;482;341;340;164;176
16;220404;220400;83-010;1380;1182;1176;368;808
17;220404;220400;83-000;1649;1306;1291;382;909
1;220405;220400;83-047;617;436;431;198;233
2;220405;220400;83-047;2225;1540;1526;676;850
3;220405;220400;83-047;1240;849;841;485;356
4;220405;220400;83-047;722;551;544;213;331
1;220406;220400;83-032;1202;808;800;369;431
2;220406;220400;83-032;1042;792;784;342;442
3;220406;220400;83-032;1813;1312;1293;579;714
4;220406;220400;83-032;333;177;171;102;69
5;220406;220400;83-031;1249;954;940;440;500
6;220406;220400;83-032;997;725;716;275;441
7;220406;220400;83-032;553;401;399;170;229
8;220406;220400;83-032;242;152;150;78;72
9;220406;220400;83-032;280;204;202;112;90
10;220406;220400;83-031;464;364;362;179;183
1;220407;220400;83-022;1096;731;724;375;349
2;220407;220400;83-022;698;426;423;261;162
3;220407;220400;83-022;860;571;569;238;331
4;220407;220400;83-022;543;321;317;166;151
1;220408;220400;83-042;1617;1062;1053;454;599
2;220408;220400;83-041;1559;907;898;511;387
3;220408;220400;83-033;1589;947;931;521;410
4;220408;220400;83-034;2240;1497;1487;690;797
5;220408;220400;83-035;1891;1387;1372;620;752
6;220408;220400;83-042;520;337;334;170;164
1;220501;220500;83-333;1327;1003;992;541;451
2;220501;220500;83-334;1186;835;829;534;295
3;220501;220500;83-335;716;501;497;357;140
4;220501;220500;83-333;788;602;594;336;258
5;220501;220500;83-333;393;255;249;166;83
6;220501;220500;83-333;789;558;553;356;197
7;220501;220500;83-334;624;450;447;328;119
1;220502;220500;83-300;2209;1666;1657;731;926
2;220502;220500;83-300;2124;1488;1465;549;916
3;220502;220500;83-300;1336;922;916;371;545
4;220502;220500;83-300;1363;1026;1019;487;532
5;220502;220500;83-300;1058;724;719;307;412
6;220502;220500;83-300;911;678;671;318;353
7;220502;220500;83-300;960;716;712;300;412
8;220502;220500;83-329;1033;713;705;517;188
9;220502;220500;83-328;869;585;576;455;121
10;220502;220500;83-328;276;212;208;154;54
11;220502;220500;83-300;1080;770;756;423;333
12;220502;220500;83-300;1076;832;823;437;386
13;220502;220500;83-332;1909;1425;1411;729;682
14;220502;220500;83-332;967;720;714;302;412
15;220502;220500;83-307;1690;1249;1241;547;694
16;220502;220500;83-307;1551;1079;1071;619;452
17;220502;220500;83-300;974;725;719;421;298
18;220502;220500;83-324;1635;1210;1203;742;461
19;220502;220500;83-328;210;154;152;123;29
20;220502;220500;83-328;764;540;538;414;124
21;220502;220500;83-305;205;153;152;119;33
22;220502;220500;83-300;218;171;169;97;72
23;220502;220500;83-300;33;21;21;10;11
24;220502;220500;83-332;60;46;46;21;25
1;220503;220500;83-304;438;317;315;206;109
2;220503;220500;83-304;856;630;622;297;325
3;220503;220500;84-208;765;580;571;355;216
4;220503;220500;83-305;1144;858;841;584;257
5;220503;220500;83-304;1331;1002;986;623;363
6;220503;220500;83-304;910;708;706;373;333
7;220503;220500;83-304;412;339;332;219;113
8;220503;220500;83-304;1137;929;921;331;590
9;220503;220500;83-305;613;474;474;344;130
10;220503;220500;83-304;347;277;274;170;104
1;220504;220500;83-340;486;382;380;291;89
2;220504;220500;83-340;2097;1611;1598;1050;548
3;220504;220500;83-340;853;637;636;519;117
4;220504;220500;83-340;1058;802;793;473;320
5;220504;220500;83-340;807;646;643;489;154
6;220504;220500;83-341;1700;1272;1265;988;277
7;220504;220500;83-342;899;629;624;457;167
8;220504;220500;83-334;1013;705;697;527;170
9;220504;220500;83-335;1004;705;699;562;137
10;220504;220500;83-340;864;638;632;529;103
11;220504;220500;83-340;1034;823;815;564;251
12;220504;220500;83-340;889;710;704;516;188
13;220504;220500;83-340;477;373;368;302;66
14;220504;220500;83-340;987;747;744;489;255
1;220505;220500;83-312;533;372;367;216;151
2;220505;220500;83-311;1361;910;902;588;314
3;220505;220500;83-314;2355;1703;1676;934;742
4;220505;220500;83-312;353;230;230;113;117
5;220505;220500;83-314;413;284;284;196;88
6;220505;220500;83-315;239;131;131;103;28
7;220505;220500;83-315;214;138;133;82;51
8;220505;220500;83-312;294;192;191;134;57
9;220505;220500;83-315;282;192;189;134;55
10;220505;220500;83-311;525;392;391;192;199
11;220505;220500;83-314;474;323;319;200;119
12;220505;220500;83-312;251;178;177;116;61
13;220505;220500;83-314;355;209;208;146;62
14;220505;220500;83-312;508;328;325;215;110
1;220506;220500;83-322;1248;969;960;485;475
2;220506;220500;83-322;1155;861;855;496;359
3;220506;220500;83-323;864;613;608;438;170
4;220506;220500;83-322;955;728;724;538;186
5;220506;220500;83-316;613;468;465;273;192
6;220506;220500;83-316;675;553;549;308;241
7;220506;220500;83-315;1235;931;924;494;430
8;220506;220500;83-322;331;243;241;151;90
9;220506;220500;83-323;322;236;236;170;66
10;220506;220500;83-323;532;417;416;299;117
11;220506;220500;83-323;193;155;155;134;21
12;220506;220500;83-316;495;361;357;211;146
1;220507;220500;83-320;1454;1100;1089;535;554
2;220507;220500;83-321;959;638;633;494;139
3;220507;220500;83-320;681;501;494;365;129
4;220507;220500;83-320;338;264;263;171;92
5;220507;220500;83-320;495;361;359;229;130
6;220507;220500;83-320;525;386;384;238;146
1;220508;220500;80-209;1515;1202;1190;435;755
2;220508;220500;80-209;1750;1443;1431;522;909
3;220508;220500;80-209;1288;1015;1007;324;683
4;220508;220500;80-297;1315;997;994;389;605
5;220508;220500;83-330;644;529;524;236;288
6;220508;220500;83-330;2721;2245;2217;850;1367
7;220508;220500;80-297;1603;1274;1259;459;800
8;220508;220500;80-297;2508;2035;2008;599;1409
9;220508;220500;80-297;2080;1642;1626;561;1065
10;220508;220500;80-298;1912;1465;1442;626;816
11;220508;220500;83-331;1118;870;862;459;403
12;220508;220500;83-331;1830;1362;1351;646;705
13;220508;220500;83-330;1200;792;786;438;348
14;220508;220500;83-330;1448;1076;1060;573;487
15;220508;220500;83-330;1170;926;920;395;525
16;220508;220500;83-330;2134;1602;1584;746;838
17;220508;220500;83-330;1256;928;917;445;472
18;220508;220500;83-330;1288;979;969;448;521
19;220508;220500;83-330;1762;1389;1372;592;780
20;220508;220500;83-331;575;456;452;165;287
21;220508;220500;83-331;463;356;355;167;188
22;220508;220500;83-330;196;104;103;53;50
23;220508;220500;83-330;161;134;131;64;67
24;220508;220500;83-331;195;150;149;109;40
25;220508;220500;80-297;2583;2057;2035;594;1441
1;220601;220600;83-400;1764;1266;1253;594;659
2;220601;220600;83-400;1227;863;857;363;494
3;220601;220600;83-400;1467;1001;992;456;536
4;220601;220600;83-400;1876;1429;1421;597;824
5;220601;220600;83-400;1306;980;975;401;574
6;220601;220600;83-400;1439;1099;1091;455;636
7;220601;220600;83-400;1947;1374;1360;533;827
8;220601;220600;83-400;1348;920;908;406;502
9;220601;220600;83-400;1337;843;840;336;504
10;220601;220600;83-400;1529;1111;1103;527;576
11;220601;220600;83-400;1598;1077;1067;506;561
12;220601;220600;83-400;391;179;175;96;79
1;220602;220600;83-425;1475;1117;1097;665;432
2;220602;220600;83-425;841;600;592;384;208
3;220602;220600;83-425;402;283;280;176;104
4;220602;220600;83-425;361;260;256;164;92
5;220602;220600;83-425;335;225;223;162;61
1;220603;220600;83-440;1908;1321;1312;832;480
2;220603;220600;83-441;2021;1450;1437;794;643
3;220603;220600;83-440;632;426;420;320;100
4;220603;220600;83-442;290;226;226;107;119
5;220603;220600;83-440;57;41;39;30;9
1;220604;220600;83-423;1711;1227;1217;770;447
2;220604;220600;83-423;682;482;478;333;145
3;220604;220600;83-400;639;478;474;291;183
4;220604;220600;83-400;751;536;530;279;251
5;220604;220600;83-407;1652;1225;1220;614;606
6;220604;220600;83-400;1197;867;857;530;327
7;220604;220600;83-406;917;676;666;357;309
8;220604;220600;83-400;381;276;272;136;136
9;220604;220600;83-400;749;519;511;200;311
10;220604;220600;83-407;761;554;551;316;235
11;220604;220600;83-400;372;278;278;181;97
12;220604;220600;83-423;818;612;607;411;196
13;220604;220600;83-400;570;408;405;234;171
14;220604;220600;83-315;428;281;279;166;113
15;220604;220600;83-400;314;241;238;91;147
1;220605;220600;83-420;1103;784;780;459;321
2;220605;220600;83-421;648;429;426;310;116
3;220605;220600;83-412;444;289;284;212;72
4;220605;220600;83-420;214;141;140;76;64
5;220605;220600;83-420;230;163;161;106;55
6;220605;220600;83-412;165;115;115;72;43
7;220605;220600;83-420;452;292;289;175;114
8;220605;220600;83-422;231;172;171;77;94
1;220606;220600;83-424;1045;752;741;455;286
2;220606;220600;83-424;884;690;685;436;249
3;220606;220600;83-424;908;659;651;417;234
1;220607;220600;83-404;1165;864;860;499;361
2;220607;220600;83-404;579;402;398;229;169
3;220607;220600;83-422;722;448;441;254;187
4;220607;220600;83-422;346;247;246;137;109
5;220607;220600;83-403;843;557;555;361;194
6;220607;220600;83-421;581;364;360;242;118
7;220607;220600;83-422;756;545;540;356;184
8;220607;220600;83-403;368;247;247;188;59
1;220608;220600;83-430;1274;908;898;463;435
2;220608;220600;83-430;612;422;419;293;126
3;220608;220600;83-430;691;470;466;328;138
4;220608;220600;83-430;685;458;453;287;166
5;220608;220600;83-430;1127;737;731;385;346
6;220608;220600;83-430;513;382;377;206;171
7;220608;220600;83-430;421;316;315;217;98
1;220701;220700;82-500;1159;828;821;334;487
2;220701;220700;82-500;1495;1101;1094;430;664
3;220701;220700;82-500;1341;943;934;354;580
4;220701;220700;82-500;1260;872;866;335;531
5;220701;220700;82-500;1081;756;744;336;408
6;220701;220700;82-500;1214;831;824;327;497
7;220701;220700;82-500;878;614;610;233;377
8;220701;220700;82-500;1071;724;716;294;422
9;220701;220700;82-500;1293;915;909;332;577
10;220701;220700;82-500;1340;943;937;385;552
11;220701;220700;82-500;1209;831;825;381;444
12;220701;220700;82-500;1462;1006;997;392;605
13;220701;220700;82-500;1186;823;811;306;505
14;220701;220700;82-500;1199;823;816;335;481
15;220701;220700;82-500;1105;599;595;280;315
16;220701;220700;82-500;955;595;582;241;341
17;220701;220700;82-500;1246;750;744;327;417
18;220701;220700;82-500;1112;602;601;259;342
19;220701;220700;82-500;1350;921;910;364;546
20;220701;220700;82-500;1106;713;709;261;448
21;220701;220700;82-500;1636;1246;1239;486;753
22;220701;220700;82-500;60;13;13;4;9
23;220701;220700;82-500;91;48;45;31;14
24;220701;220700;82-500;557;454;447;51;396
1;220702;220700;82-520;1699;1021;1012;633;379
2;220702;220700;82-520;1140;660;652;481;171
3;220702;220700;82-520;786;470;462;285;177
4;220702;220700;82-520;617;305;297;208;89
5;220702;220700;82-520;730;400;396;230;166
6;220702;220700;82-520;751;455;451;264;187
7;220702;220700;82-520;398;197;197;134;63
1;220703;220700;82-500;401;207;206;116;90
2;220703;220700;82-500;539;319;314;226;88
3;220703;220700;82-500;523;334;332;166;166
4;220703;220700;82-500;867;562;558;282;276
5;220703;220700;82-500;943;639;627;296;331
6;220703;220700;82-500;508;358;353;138;215
7;220703;220700;82-500;1344;921;915;411;504
8;220703;220700;82-500;601;338;338;229;109
9;220703;220700;82-500;632;364;363;197;166
10;220703;220700;82-500;1246;815;810;476;334
11;220703;220700;82-500;240;128;127;85;42
12;220703;220700;82-500;227;114;114;67;47
13;220703;220700;82-500;208;119;118;86;32
1;220704;220700;82-550;584;302;300;180;120
2;220704;220700;82-550;728;482;479;226;253
3;220704;220700;82-550;641;379;368;210;158
4;220704;220700;82-550;521;329;329;153;176
5;220704;220700;82-550;561;325;325;176;149
6;220704;220700;82-550;568;377;373;164;209
7;220704;220700;82-550;442;286;282;133;149
8;220704;220700;82-550;756;426;422;230;192
9;220704;220700;82-550;825;504;500;241;259
10;220704;220700;82-550;854;579;576;295;281
11;220704;220700;82-550;760;435;433;322;111
12;220704;220700;82-550;546;348;347;230;117
13;220704;220700;82-550;398;265;264;175;89
14;220704;220700;82-550;439;225;225;162;63
15;220704;220700;82-550;263;138;137;115;22
16;220704;220700;82-550;149;88;86;51;35
17;220704;220700;82-550;160;87;85;66;19
18;220704;220700;82-550;71;28;28;10;18
19;220704;220700;82-550;36;27;26;9;17
20;220704;220700;82-550;51;3;3;0;3
1;220705;220700;82-420;549;320;319;160;159
2;220705;220700;82-420;1421;813;802;350;452
3;220705;220700;82-420;836;516;508;243;265
4;220705;220700;82-420;609;318;317;191;126
5;220705;220700;82-420;253;155;155;87;68
6;220705;220700;82-420;333;183;183;110;73
7;220705;220700;82-420;48;28;27;12;15
1;220706;220700;82-522;969;614;605;363;242
2;220706;220700;82-522;751;423;418;278;140
3;220706;220700;82-522;939;630;618;382;236
4;220706;220700;82-522;570;330;324;223;101
5;220706;220700;82-522;500;299;293;204;89
6;220706;220700;82-522;586;338;334;220;114
1;220801;220800;84-300;1233;930;922;361;561
2;220801;220800;84-300;926;646;637;260;377
3;220801;220800;84-300;954;681;675;311;364
4;220801;220800;84-300;939;715;706;231;475
5;220801;220800;84-300;1953;1381;1372;507;865
6;220801;220800;84-300;847;646;645;233;412
7;220801;220800;84-300;1692;1225;1217;492;725
8;220801;220800;84-300;793;609;605;247;358
9;220801;220800;84-300;899;605;599;284;315
10;220801;220800;84-300;1001;626;618;271;347
11;220801;220800;84-300;1448;965;959;405;554
12;220801;220800;84-300;2150;1498;1492;553;939
13;220801;220800;84-300;1343;943;938;359;579
14;220801;220800;84-300;974;619;610;256;354
15;220801;220800;84-300;979;681;678;269;409
16;220801;220800;84-300;1118;759;752;287;465
17;220801;220800;84-300;1090;744;737;288;449
18;220801;220800;84-300;1077;780;763;303;460
19;220801;220800;84-300;1213;776;771;308;463
20;220801;220800;84-300;1476;1078;1073;541;532
21;220801;220800;84-300;84;52;50;19;31
22;220801;220800;84-300;45;37;36;25;11
23;220801;220800;84-300;47;26;22;13;9
1;220802;220800;84-360;2074;1790;1781;601;1180
2;220802;220800;84-360;1326;1069;1062;398;664
3;220802;220800;84-360;1250;971;962;314;648
1;220803;220800;84-312;1463;1019;1016;488;528
2;220803;220800;84-315;640;433;429;229;200
3;220803;220800;84-313;1060;767;762;454;308
4;220803;220800;84-311;1050;666;659;422;237
5;220803;220800;84-312;250;171;171;95;76
6;220803;220800;84-315;190;117;116;75;41
7;220803;220800;84-311;533;397;390;244;146
1;220804;220800;84-351;2032;1486;1475;678;797
2;220804;220800;84-353;1252;947;935;393;542
3;220804;220800;84-353;584;407;403;181;222
4;220804;220800;84-342;519;305;304;145;159
5;220804;220800;84-351;423;274;272;200;72
6;220804;220800;84-351;436;266;261;121;140
7;220804;220800;84-351;471;268;268;174;94
8;220804;220800;84-351;478;314;312;175;137
9;220804;220800;84-351;743;463;458;246;212
10;220804;220800;84-351;440;281;281;149;132
11;220804;220800;84-350;648;405;402;189;213
12;220804;220800;84-351;508;272;271;177;94
13;220804;220800;84-342;485;284;282;156;126
14;220804;220800;84-342;154;81;79;43;36
15;220804;220800;84-351;212;140;139;78;61
16;220804;220800;84-351;192;117;115;69;46
17;220804;220800;84-351;346;258;256;124;132
1;220805;220800;84-352;670;415;412;157;255
2;220805;220800;84-360;456;265;263;126;137
3;220805;220800;84-352;704;377;372;223;149
4;220805;220800;84-352;341;197;194;110;84
5;220805;220800;84-352;563;354;352;137;215
6;220805;220800;84-360;556;376;372;132;240
7;220805;220800;84-352;288;200;198;107;91
8;220805;220800;84-360;277;174;172;80;92
9;220805;220800;84-360;279;184;183;94;89
10;220805;220800;84-352;180;103;101;54;47
1;220901;220900;82-200;2007;1537;1529;528;1001
2;220901;220900;82-200;1536;1111;1099;343;756
3;220901;220900;82-200;1380;848;842;365;477
4;220901;220900;82-200;1473;1035;1027;384;643
5;220901;220900;82-200;1792;1204;1201;453;748
6;220901;220900;82-200;1026;642;638;248;390
7;220901;220900;82-200;1635;1161;1153;455;698
8;220901;220900;82-200;1873;1320;1313;463;850
9;220901;220900;82-200;1459;1054;1050;420;630
10;220901;220900;82-200;1286;976;972;323;649
11;220901;220900;82-200;1591;1083;1076;452;624
12;220901;220900;82-200;1554;969;963;353;610
13;220901;220900;82-200;1525;1004;995;418;577
14;220901;220900;82-200;1633;1014;1006;417;589
15;220901;220900;82-200;1578;1043;1035;433;602
16;220901;220900;82-200;1039;669;664;258;406
17;220901;220900;82-200;1055;706;694;259;435
18;220901;220900;82-200;1234;823;813;328;485
19;220901;220900;82-200;56;25;25;7;18
20;220901;220900;82-200;161;135;133;34;99
21;220901;220900;82-200;39;19;19;6;13
1;220903;220900;82-224;1087;678;668;392;276
2;220903;220900;82-224;1228;664;662;359;303
3;220903;220900;82-224;723;431;428;245;183
4;220903;220900;82-224;199;120;119;69;50
1;220904;220900;82-200;1048;692;685;304;381
2;220904;220900;82-200;823;447;443;191;252
3;220904;220900;82-200;1236;900;898;327;571
4;220904;220900;82-200;642;395;394;189;205
1;220906;220900;82-213;913;584;581;309;272
2;220906;220900;82-213;957;603;600;335;265
3;220906;220900;82-113;363;222;220;154;66
4;220906;220900;82-113;286;164;164;79;85
1;220907;220900;82-230;839;562;556;240;316
2;220907;220900;82-230;1286;755;745;352;393
3;220907;220900;82-230;1191;735;728;392;336
4;220907;220900;82-230;853;437;433;248;185
5;220907;220900;82-230;481;259;254;142;112
6;220907;220900;82-230;225;115;114;67;47
7;220907;220900;82-230;271;166;165;72;93
1;220908;220900;82-220;1158;673;670;315;355
2;220908;220900;82-220;994;640;634;270;364
3;220908;220900;82-220;921;497;492;230;262
4;220908;220900;82-220;281;177;176;82;94
1;221001;221000;82-120;3390;2999;2971;1096;1875
1;221002;221000;82-100;1024;608;605;237;368
2;221002;221000;82-100;918;675;674;248;426
3;221002;221000;82-100;678;515;513;178;335
4;221002;221000;82-100;1212;816;811;346;465
5;221002;221000;82-100;982;649;646;214;432
6;221002;221000;82-100;673;446;440;152;288
7;221002;221000;82-100;862;629;625;215;410
8;221002;221000;82-100;793;475;472;263;209
9;221002;221000;82-100;625;356;355;175;180
10;221002;221000;82-100;372;224;219;103;116
11;221002;221000;82-100;789;426;424;267;157
12;221002;221000;82-100;798;534;525;234;291
13;221002;221000;82-100;722;406;400;188;212
14;221002;221000;82-100;1037;558;553;289;264
15;221002;221000;82-100;282;149;148;83;65
16;221002;221000;82-100;198;134;131;70;61
17;221002;221000;82-100;546;396;393;132;261
18;221002;221000;82-100;64;8;8;5;3
1;221003;221000;82-112;712;494;493;241;252
2;221003;221000;82-112;279;166;166;105;61
3;221003;221000;82-112;276;183;183;113;70
4;221003;221000;82-112;332;170;169;99;70
5;221003;221000;82-112;150;77;75;40;35
6;221003;221000;82-112;169;95;92;57;35
7;221003;221000;82-112;339;237;235;112;123
1;221004;221000;82-103;2162;1641;1636;626;1010
2;221004;221000;82-103;461;295;289;158;131
3;221004;221000;82-103;569;337;337;166;171
4;221004;221000;82-103;439;257;254;134;120
5;221004;221000;82-103;418;207;202;105;97
6;221004;221000;82-103;1845;1405;1397;526;871
7;221004;221000;82-103;804;590;589;206;383
8;221004;221000;82-103;1005;689;683;299;384
9;221004;221000;82-103;311;154;154;68;86
10;221004;221000;82-103;451;315;310;146;164
11;221004;221000;82-103;150;81;80;39;41
1;221005;221000;82-110;2418;1617;1605;615;990
2;221005;221000;82-110;814;669;659;174;485
1;221101;221100;84-150;1679;1249;1237;383;854
2;221101;221100;84-150;1381;979;971;339;632
3;221101;221100;84-150;87;65;63;29;34
1;221102;221100;84-140;3864;3274;3242;1286;1956
2;221102;221100;84-130;707;594;586;196;390
3;221102;221100;84-141;1105;994;992;231;761
1;221103;221100;84-100;1387;953;945;336;609
2;221103;221100;84-100;1626;1163;1159;412;747
3;221103;221100;84-100;1642;1116;1108;387;721
4;221103;221100;84-100;1609;1095;1083;413;670
5;221103;221100;84-100;1864;1345;1338;514;824
6;221103;221100;84-100;81;35;35;18;17
7;221103;221100;84-100;38;4;4;0;4
1;221104;221100;84-120;1497;1137;1129;352;777
2;221104;221100;84-120;1315;993;979;336;643
3;221104;221100;84-120;1781;1377;1366;530;836
4;221104;221100;84-120;2284;1886;1867;681;1186
5;221104;221100;84-120;2042;1549;1543;605;938
6;221104;221100;84-120;822;747;736;166;570
7;221104;221100;84-120;1227;975;967;444;523
8;221104;221100;84-104;439;332;329;160;169
9;221104;221100;84-104;314;268;265;91;174
10;221104;221100;84-104;1980;1753;1742;605;1137
11;221104;221100;84-105;714;556;552;220;332
12;221104;221100;84-105;1446;1248;1240;478;762
1;221105;221100;81-198;3161;2535;2504;807;1697
2;221105;221100;81-198;800;714;703;272;431
3;221105;221100;81-198;1065;866;848;270;578
4;221105;221100;81-198;1969;1652;1645;525;1120
5;221105;221100;81-198;1878;1471;1455;550;905
6;221105;221100;81-198;3035;2585;2549;713;1836
7;221105;221100;81-198;1472;1276;1269;318;951
8;221105;221100;84-230;187;121;119;63;56
9;221105;221100;81-198;1660;1374;1359;447;912
1;221106;221100;84-113;1164;699;690;391;299
2;221106;221100;84-110;617;460;454;298;156
3;221106;221100;84-110;1097;737;730;382;348
4;221106;221100;84-110;481;332;328;157;171
5;221106;221100;84-110;362;257;256;172;84
6;221106;221100;84-113;621;507;503;195;308
7;221106;221100;84-113;220;132;130;70;60
8;221106;221100;84-113;265;164;161;91;70
9;221106;221100;84-110;697;645;641;189;452
10;221106;221100;84-110;274;208;207;125;82
11;221106;221100;84-110;295;220;218;135;83
12;221106;221100;84-110;201;134;133;75;58
13;221106;221100;84-110;422;296;291;199;92
14;221106;221100;84-110;342;207;207;128;79
15;221106;221100;84-110;452;327;325;188;137
16;221106;221100;84-110;269;181;181;118;63
17;221106;221100;84-107;456;313;312;216;96
18;221106;221100;84-105;747;544;541;290;251
19;221106;221100;84-110;54;13;13;7;6
1;221107;221100;84-106;1431;1003;994;570;424
2;221107;221100;84-123;1977;1381;1358;724;634
3;221107;221100;84-123;1120;803;791;317;474
4;221107;221100;84-100;1286;971;962;429;533
5;221107;221100;84-107;1447;937;922;540;382
6;221107;221100;84-103;843;603;600;426;174
7;221107;221100;84-100;836;656;646;325;321
8;221107;221100;84-122;2107;1604;1585;759;826
9;221107;221100;84-123;1020;727;715;318;397
10;221107;221100;84-100;438;299;296;168;128
11;221107;221100;84-103;1611;1079;1065;598;467
12;221107;221100;84-100;984;705;697;418;279
13;221107;221100;84-122;220;131;129;72;57
14;221107;221100;84-122;740;525;521;272;249
15;221107;221100;84-100;704;518;507;329;178
16;221107;221100;84-103;860;640;639;406;233
17;221107;221100;84-106;673;468;467;305;162
18;221107;221100;84-106;655;436;432;226;206
19;221107;221100;84-106;336;233;233;148;85
20;221107;221100;84-107;489;372;367;254;113
21;221107;221100;84-100;256;192;189;99;90
22;221107;221100;84-122;341;240;235;156;79
23;221107;221100;84-100;258;209;205;90;115
24;221107;221100;84-122;244;156;152;103;49
1;221201;221200;76-270;1017;1017;1007;370;637
2;221201;221200;76-270;1577;1127;1118;389;729
3;221201;221200;76-270;1493;1048;1043;399;644
4;221201;221200;76-270;1511;1012;1005;391;614
5;221201;221200;76-270;1501;1052;1044;329;715
6;221201;221200;76-270;2444;1933;1919;720;1199
7;221201;221200;76-270;2000;1843;1826;620;1206
8;221201;221200;76-270;236;183;180;40;140
9;221201;221200;76-270;46;15;14;6;8
1;221202;221200;76-231;945;671;659;311;348
2;221202;221200;76-231;473;244;244;134;110
3;221202;221200;76-231;259;170;169;98;71
4;221202;221200;76-231;340;200;199;122;77
5;221202;221200;76-231;1052;543;539;285;254
6;221202;221200;76-231;324;228;227;106;121
7;221202;221200;76-231;227;152;150;96;54
8;221202;221200;76-231;520;318;311;199;112
1;221203;221200;76-248;867;558;544;190;354
2;221203;221200;76-248;1421;958;950;398;552
3;221203;221200;76-248;1103;713;703;309;394
4;221203;221200;76-248;283;132;130;74;56
5;221203;221200;76-248;612;328;322;202;120
6;221203;221200;76-248;471;235;232;149;83
7;221203;221200;76-248;706;393;388;246;142
8;221203;221200;76-248;192;96;95;57;38
9;221203;221200;76-248;177;84;82;48;34
10;221203;221200;76-248;414;222;218;134;84
11;221203;221200;76-248;164;104;102;62;40
12;221203;221200;76-248;220;118;117;76;41
13;221203;221200;76-248;147;85;85;55;30
1;221204;221200;76-220;429;247;245;121;124
2;221204;221200;76-220;442;299;298;130;168
3;221204;221200;76-220;430;261;261;133;128
4;221204;221200;76-220;269;117;115;74;41
5;221204;221200;76-220;304;180;180;98;82
6;221204;221200;76-220;436;228;227;118;109
7;221204;221200;76-220;393;185;183;106;77
8;221204;221200;76-220;345;181;180;102;78
9;221204;221200;76-220;343;160;156;106;50
10;221204;221200;76-220;547;315;310;149;161
11;221204;221200;76-220;240;117;116;68;48
12;221204;221200;76-220;229;143;143;91;52
13;221204;221200;76-220;381;208;207;86;121
14;221204;221200;76-220;329;160;158;92;66
15;221204;221200;76-220;333;154;152;87;65
16;221204;221200;76-220;186;105;104;70;34
17;221204;221200;76-220;215;126;125;57;68
18;221204;221200;76-220;241;123;120;87;33
19;221204;221200;76-220;168;75;72;48;24
1;221205;221200;77-230;546;337;334;113;221
2;221205;221200;77-230;454;250;248;141;107
3;221205;221200;77-230;327;171;169;94;75
4;221205;221200;77-230;301;170;168;85;83
5;221205;221200;77-230;611;370;365;131;234
6;221205;221200;77-230;584;285;282;118;164
7;221205;221200;77-230;368;231;227;77;150
8;221205;221200;77-230;470;251;250;97;153
9;221205;221200;77-230;318;160;158;67;91
10;221205;221200;77-230;436;282;281;123;158
11;221205;221200;77-230;407;256;254;105;149
12;221205;221200;77-230;232;126;125;55;70
13;221205;221200;77-230;251;133;133;82;51
14;221205;221200;77-230;282;146;145;63;82
15;221205;221200;77-230;282;125;124;73;51
16;221205;221200;77-230;212;117;114;62;52
1;221206;221200;76-251;614;333;332;174;158
2;221206;221200;76-251;1044;830;825;269;556
3;221206;221200;76-251;766;436;433;203;230
4;221206;221200;76-251;1077;606;599;290;309
5;221206;221200;76-251;439;243;243;137;106
6;221206;221200;76-251;1772;1334;1326;450;876
7;221206;221200;76-251;1773;1388;1374;455;919
8;221206;221200;76-251;382;255;251;126;125
9;221206;221200;76-251;886;690;683;214;469
10;221206;221200;76-251;703;412;411;210;201
11;221206;221200;76-251;192;146;145;91;54
12;221206;221200;76-251;410;204;203;115;88
1;221207;221200;76-242;457;280;279;136;143
2;221207;221200;76-230;646;404;403;189;214
3;221207;221200;76-230;694;377;369;204;165
4;221207;221200;76-230;220;89;88;55;33
5;221207;221200;76-230;214;137;137;84;53
6;221207;221200;76-230;179;114;113;70;43
7;221207;221200;76-230;469;272;272;164;108
8;221207;221200;76-230;307;189;187;94;93
9;221207;221200;76-230;159;81;81;59;22
10;221207;221200;76-230;337;168;167;94;73
11;221207;221200;76-230;695;461;460;183;277
12;221207;221200;76-230;359;188;186;123;63
1;221208;221200;76-200;1538;876;866;440;426
2;221208;221200;76-200;401;257;255;112;143
3;221208;221200;76-200;908;657;655;254;401
4;221208;221200;76-200;877;689;684;193;491
5;221208;221200;76-200;965;749;743;248;495
6;221208;221200;76-200;848;589;584;275;309
7;221208;221200;76-200;678;398;394;246;148
8;221208;221200;76-200;1410;927;921;362;559
9;221208;221200;76-200;1238;893;883;297;586
10;221208;221200;76-200;303;172;172;100;72
11;221208;221200;76-200;415;250;250;119;131
12;221208;221200;76-200;218;125;125;65;60
13;221208;221200;76-200;189;108;108;55;53
14;221208;221200;76-200;583;346;343;189;154
15;221208;221200;76-200;416;317;316;108;208
16;221208;221200;76-200;671;473;469;190;279
17;221208;221200;76-200;374;276;276;143;133
18;221208;221200;76-200;236;154;154;80;74
19;221208;221200;76-200;1346;1037;1028;333;695
20;221208;221200;76-200;46;36;36;12;24
1;221209;221200;76-214;663;442;435;209;226
2;221209;221200;76-213;883;544;540;252;288
3;221209;221200;76-214;513;322;320;163;157
4;221209;221200;76-214;460;329;326;144;182
1;221210;221200;76-270;323;194;193;81;112
2;221210;221200;76-270;641;420;416;249;167
3;221210;221200;76-270;529;353;353;153;200
4;221210;221200;76-270;688;424;421;177;244
5;221210;221200;76-270;244;151;149;74;75
6;221210;221200;76-270;1004;821;816;290;526
7;221210;221200;76-270;477;338;335;130;205
8;221210;221200;76-270;151;124;124;98;26
9;221210;221200;76-270;170;117;116;89;27
10;221210;221200;76-270;259;150;147;91;56
11;221210;221200;76-270;454;308;301;132;169
12;221210;221200;76-270;434;283;280;105;175
13;221210;221200;76-270;405;225;224;135;89
14;221210;221200;76-212;1722;1722;1714;623;1091
15;221210;221200;76-270;157;98;98;45;53
1;221301;221300;83-262;1203;780;771;448;323
2;221301;221300;83-262;742;523;520;271;249
3;221301;221300;83-261;314;198;196;153;43
1;221302;221300;83-220;1293;846;842;463;379
2;221302;221300;83-220;1196;828;825;496;329
1;221303;221300;83-200;1622;982;972;502;470
2;221303;221300;83-200;2203;1578;1561;824;737
3;221303;221300;83-200;1416;955;947;421;526
4;221303;221300;83-200;1851;1304;1288;635;653
5;221303;221300;83-200;1584;1004;999;527;472
6;221303;221300;83-200;1374;931;927;480;447
7;221303;221300;83-200;1426;717;709;384;325
8;221303;221300;83-200;1492;904;896;445;451
9;221303;221300;83-200;1453;833;826;433;393
10;221303;221300;83-200;988;681;678;336;342
11;221303;221300;83-200;1821;1258;1244;597;647
12;221303;221300;83-200;1131;756;753;348;405
13;221303;221300;83-200;1213;793;787;401;386
14;221303;221300;83-200;1174;829;828;373;455
15;221303;221300;83-200;2158;1480;1467;727;740
16;221303;221300;83-200;1429;1021;1008;503;505
17;221303;221300;83-200;1635;1162;1153;536;617
18;221303;221300;83-200;2026;1531;1521;657;864
19;221303;221300;83-200;1875;1160;1157;493;664
20;221303;221300;83-200;1084;817;809;397;412
21;221303;221300;83-200;1397;1017;1008;463;545
22;221303;221300;83-200;70;70;67;36;31
23;221303;221300;83-200;543;247;236;123;113
24;221303;221300;83-200;260;187;185;47;138
25;221303;221300;83-200;50;42;42;23;19
1;221304;221300;83-212;1195;785;776;526;250
2;221304;221300;83-212;360;237;231;150;81
3;221304;221300;83-212;442;256;254;185;69
4;221304;221300;83-212;369;206;203;142;61
1;221305;221300;83-260;1693;1087;1069;579;490
2;221305;221300;83-261;1017;681;675;453;222
3;221305;221300;83-260;1362;882;879;486;393
1;221306;221300;83-240;1754;1196;1191;652;539
2;221306;221300;83-240;1329;887;877;507;370
3;221306;221300;83-208;657;420;415;276;139
4;221306;221300;83-240;548;376;370;209;161
5;221306;221300;83-240;597;415;409;197;212
6;221306;221300;83-240;417;256;255;161;94
1;221307;221300;83-242;1220;802;795;490;305
2;221307;221300;83-243;933;629;624;466;158
1;221308;221300;83-221;259;179;178;107;71
2;221308;221300;83-221;572;401;396;190;206
3;221308;221300;83-221;626;466;464;232;232
4;221308;221300;83-221;322;198;197;103;94
5;221308;221300;83-221;258;181;180;101;79
1;221309;221300;83-250;1899;1236;1227;670;557
2;221309;221300;83-250;1655;1077;1068;560;508
3;221309;221300;83-250;1202;752;745;378;367
4;221309;221300;83-250;362;225;224;156;68
5;221309;221300;83-250;615;423;414;303;111
6;221309;221300;83-236;597;420;417;268;149
7;221309;221300;83-209;670;420;418;178;240
8;221309;221300;83-250;293;195;195;113;82
9;221309;221300;83-250;744;476;471;245;226
10;221309;221300;83-250;298;191;188;113;75
11;221309;221300;83-250;382;232;232;165;67
12;221309;221300;83-241;283;175;173;101;72
13;221309;221300;83-236;345;211;210;157;53
14;221309;221300;83-209;453;326;326;141;185
15;221309;221300;83-250;163;131;130;92;38
16;221309;221300;83-250;192;125;125;74;51
17;221309;221300;83-236;382;273;272;170;102
1;221310;221300;83-220;709;485;484;353;131
2;221310;221300;83-225;958;592;587;426;161
3;221310;221300;83-213;848;536;530;404;126
4;221310;221300;83-220;757;448;446;310;136
1;221311;221300;83-230;1194;848;832;472;360
2;221311;221300;83-230;534;305;302;212;90
3;221311;221300;83-230;376;222;221;173;48
4;221311;221300;83-230;168;101;99;65;34
5;221311;221300;83-230;450;272;272;190;82
6;221311;221300;83-230;564;364;363;253;110
7;221311;221300;83-230;237;142;141;101;40
8;221311;221300;83-230;199;131;129;86;43
1;221312;221300;83-212;696;466;462;251;211
2;221312;221300;83-211;594;410;406;261;145
3;221312;221300;83-211;545;386;380;205;175
4;221312;221300;83-211;698;506;504;270;234
5;221312;221300;83-211;381;290;285;144;141
6;221312;221300;83-130;283;172;169;120;49
7;221312;221300;83-200;768;528;525;292;233
8;221312;221300;83-115;438;267;266;159;107
9;221312;221300;83-200;328;238;237;118;119
10;221312;221300;83-209;503;319;317;207;110
11;221312;221300;83-207;1432;1044;1033;389;644
12;221312;221300;83-200;338;240;236;143;93
13;221312;221300;83-200;455;354;350;219;131
14;221312;221300;83-200;755;545;543;221;322
15;221312;221300;83-200;1031;764;759;413;346
16;221312;221300;83-200;461;331;330;220;110
17;221312;221300;83-200;515;359;357;270;87
18;221312;221300;83-200;690;511;508;303;205
19;221312;221300;83-211;394;288;281;150;131
20;221312;221300;83-209;223;174;174;73;101
21;221312;221300;83-200;488;369;368;148;220
22;221312;221300;83-200;88;38;38;32;6
23;221312;221300;83-200;82;44;44;20;24
1;221313;221300;83-206;921;595;588;400;188
2;221313;221300;83-251;1362;904;900;520;380
3;221313;221300;83-224;886;613;608;331;277
4;221313;221300;83-210;1345;936;928;582;346
5;221313;221300;83-210;1753;1188;1180;708;472
6;221313;221300;83-210;716;437;433;267;166
7;221313;221300;83-251;1077;711;708;506;202
8;221313;221300;83-206;359;250;248;155;93
9;221313;221300;83-210;227;161;161;114;47
10;221313;221300;83-224;250;165;161;98;63
1;221401;221400;83-110;2059;1373;1359;633;726
2;221401;221400;83-110;1538;989;982;531;451
3;221401;221400;83-110;1787;1101;1088;596;492
4;221401;221400;83-110;1608;995;982;490;492
5;221401;221400;83-110;1313;893;883;367;516
6;221401;221400;83-110;1369;951;940;368;572
7;221401;221400;83-110;1713;1262;1253;511;742
8;221401;221400;83-110;1894;1255;1245;549;696
9;221401;221400;83-110;1670;1101;1089;516;573
10;221401;221400;83-110;2228;1736;1719;682;1037
11;221401;221400;83-110;1457;1058;1045;434;611
12;221401;221400;83-110;2017;1334;1316;632;684
13;221401;221400;83-110;1691;1168;1162;498;664
14;221401;221400;83-110;1914;1297;1290;579;711
15;221401;221400;83-110;1814;1281;1272;585;687
16;221401;221400;83-110;1615;1159;1147;494;653
17;221401;221400;83-110;1408;985;978;430;548
18;221401;221400;83-110;1117;835;827;352;475
19;221401;221400;83-110;1682;1196;1187;516;671
20;221401;221400;83-110;1836;1421;1409;541;868
21;221401;221400;83-110;1319;908;903;407;496
22;221401;221400;83-110;1813;1259;1254;588;666
23;221401;221400;83-110;1349;1003;995;373;622
24;221401;221400;83-110;1076;879;868;313;555
25;221401;221400;83-110;1475;1178;1166;390;776
26;221401;221400;83-110;56;35;33;13;20
27;221401;221400;83-110;34;11;10;3;7
28;221401;221400;83-110;53;47;45;16;29
1;221402;221400;83-140;697;465;461;177;284
2;221402;221400;83-140;671;404;401;190;211
3;221402;221400;83-140;685;401;398;204;194
4;221402;221400;83-140;969;547;542;307;235
5;221402;221400;83-140;730;484;482;233;249
6;221402;221400;83-140;789;498;496;234;262
7;221402;221400;83-123;403;218;216;141;75
8;221402;221400;83-140;395;223;223;134;89
9;221402;221400;83-140;555;308;306;204;102
10;221402;221400;83-123;495;312;310;208;102
11;221402;221400;83-136;833;526;520;224;296
12;221402;221400;83-135;481;240;238;157;81
13;221402;221400;83-135;496;262;259;168;91
14;221402;221400;83-140;531;315;312;164;148
15;221402;221400;83-140;401;306;301;182;119
16;221402;221400;83-140;164;92;91;69;22
17;221402;221400;83-140;227;149;147;100;47
18;221402;221400;83-122;296;161;159;112;47
19;221402;221400;83-140;260;166;164;105;59
20;221402;221400;83-136;322;198;194;130;64
21;221402;221400;83-135;494;276;275;187;88
22;221402;221400;83-140;88;48;48;29;19
23;221402;221400;83-140;41;5;5;4;1
1;221403;221400;83-132;712;435;430;232;198
2;221403;221400;83-132;428;257;255;167;88
3;221403;221400;83-132;763;388;381;284;97
4;221403;221400;83-132;211;137;136;85;51
5;221403;221400;83-132;201;124;124;78;46
6;221403;221400;83-132;243;122;120;96;24
1;221404;221400;83-130;1461;915;903;436;467
2;221404;221400;83-130;1335;817;812;451;361
3;221404;221400;83-130;679;391;389;223;166
4;221404;221400;83-130;926;564;551;266;285
5;221404;221400;83-130;1038;661;653;332;321
6;221404;221400;83-121;479;317;316;210;106
7;221404;221400;83-121;613;364;359;222;137
8;221404;221400;83-121;731;438;428;239;189
9;221404;221400;83-130;530;302;295;192;103
10;221404;221400;83-130;1119;612;602;363;239
11;221404;221400;83-130;639;424;423;212;211
12;221404;221400;83-130;883;595;592;294;298
13;221404;221400;83-130;183;90;89;56;33
14;221404;221400;83-122;210;114;113;78;35
15;221404;221400;83-121;215;142;140;108;32
16;221404;221400;83-122;252;148;146;93;53
17;221404;221400;83-130;136;60;55;33;22
1;221405;221400;83-120;1113;825;814;412;402
2;221405;221400;83-120;606;325;323;203;120
3;221405;221400;83-120;551;388;385;229;156
4;221405;221400;83-120;816;504;495;286;209
5;221405;221400;83-120;412;257;254;139;115
6;221405;221400;83-120;368;192;188;93;95
7;221405;221400;83-115;187;109;108;48;60
1;221406;221400;83-110;707;496;489;232;257
2;221406;221400;83-110;706;555;550;263;287
3;221406;221400;83-110;713;519;518;255;263
4;221406;221400;83-115;1250;794;786;434;352
5;221406;221400;83-115;564;367;363;192;171
6;221406;221400;83-113;748;509;508;237;271
7;221406;221400;83-113;499;313;310;157;153
8;221406;221400;83-112;993;744;740;273;467
9;221406;221400;83-111;460;325;322;143;179
10;221406;221400;83-112;1548;1198;1182;476;706
11;221406;221400;83-111;1174;747;737;358;379
12;221406;221400;83-113;415;239;238;156;82
13;221406;221400;83-113;218;151;150;72;78
14;221406;221400;83-112;520;429;426;154;272
15;221406;221400;83-110;246;176;173;91;82
16;221406;221400;83-110;304;229;226;114;112
17;221406;221400;83-111;300;205;204;121;83
18;221406;221400;83-111;209;127;127;71;56
19;221406;221400;83-209;60;34;29;13;16
1;221501;221500;84-240;1886;1431;1417;549;868
2;221501;221500;84-240;1746;1305;1292;493;799
3;221501;221500;84-240;2885;2252;2223;691;1532
4;221501;221500;84-240;1048;732;718;263;455
5;221501;221500;84-240;2541;1923;1897;695;1202
6;221501;221500;84-240;2044;1537;1514;508;1006
7;221501;221500;84-240;2553;1893;1867;752;1115
8;221501;221500;84-240;2437;1913;1890;664;1226
9;221501;221500;84-240;2389;1741;1718;659;1059
1;221502;221500;84-230;2436;1936;1916;657;1259
2;221502;221500;84-230;1417;1018;1010;377;633
3;221502;221500;84-230;2173;1634;1623;677;946
4;221502;221500;84-230;1148;951;938;313;625
5;221502;221500;84-230;1328;955;946;385;561
6;221502;221500;84-230;1964;1520;1506;524;982
7;221502;221500;84-230;1662;1290;1279;478;801
8;221502;221500;84-230;1793;1343;1330;499;831
9;221502;221500;84-230;2219;1772;1750;584;1166
10;221502;221500;84-230;1631;1251;1237;414;823
11;221502;221500;84-230;2453;1974;1951;670;1281
12;221502;221500;84-230;2311;1845;1830;600;1230
13;221502;221500;84-230;1606;1234;1221;458;763
14;221502;221500;84-230;1970;1578;1566;494;1072
15;221502;221500;84-230;1525;1103;1091;510;581
16;221502;221500;84-230;2250;1751;1735;609;1126
17;221502;221500;84-230;1327;1006;995;393;602
18;221502;221500;84-230;1380;1025;1016;466;550
19;221502;221500;84-230;2064;1533;1514;626;888
20;221502;221500;84-230;1890;1485;1468;515;953
21;221502;221500;84-230;2067;1588;1570;503;1067
1;221503;221500;84-200;1899;1336;1325;543;782
2;221503;221500;84-200;1976;1454;1438;562;876
3;221503;221500;84-200;1880;1388;1376;566;810
4;221503;221500;84-200;2540;1859;1841;759;1082
5;221503;221500;84-200;1277;857;849;396;453
6;221503;221500;84-200;2086;1459;1441;624;817
7;221503;221500;84-200;1993;1442;1425;565;860
8;221503;221500;84-200;2047;1460;1447;627;820
9;221503;221500;84-200;1916;1309;1300;480;820
10;221503;221500;84-200;2170;1521;1506;608;898
11;221503;221500;84-200;2081;1490;1477;658;819
12;221503;221500;84-200;1648;1072;1066;515;551
13;221503;221500;84-200;1528;1075;1066;452;614
14;221503;221500;84-200;1504;1008;1003;427;576
15;221503;221500;84-200;2083;1489;1475;606;869
16;221503;221500;84-200;1854;1341;1334;560;774
17;221503;221500;84-200;1647;1263;1251;516;735
18;221503;221500;84-200;354;324;318;75;243
19;221503;221500;84-200;244;142;141;56;85
20;221503;221500;84-200;83;49;44;31;13
21;221503;221500;84-200;54;22;21;8;13
1;221504;221500;84-210;1018;733;727;291;436
2;221504;221500;84-210;559;274;269;164;105
3;221504;221500;84-210;445;260;258;147;111
4;221504;221500;84-210;520;290;289;166;123
5;221504;221500;84-210;437;276;275;120;155
6;221504;221500;84-210;516;394;384;121;263
7;221504;221500;84-210;164;82;81;40;41
8;221504;221500;84-210;578;466;464;119;345
9;221504;221500;84-210;331;202;200;89;111
1;221505;221500;84-250;1614;1058;1048;571;477
2;221505;221500;84-250;278;193;191;98;93
3;221505;221500;84-251;1021;601;597;278;319
4;221505;221500;84-250;338;260;259;105;154
5;221505;221500;84-251;634;398;394;247;147
6;221505;221500;84-250;266;177;175;99;76
7;221505;221500;84-250;237;157;156;89;67
8;221505;221500;84-250;318;227;227;114;113
9;221505;221500;84-251;337;191;189;122;67
10;221505;221500;84-251;340;182;180;139;41
11;221505;221500;84-250;95;38;35;17;18
1;221506;221500;84-223;1413;960;949;598;351
2;221506;221500;84-223;646;450;446;355;91
3;221506;221500;84-223;1119;779;774;560;214
4;221506;221500;84-223;574;440;440;331;109
5;221506;221500;84-223;786;584;579;425;154
6;221506;221500;84-223;231;153;152;105;47
7;221506;221500;84-223;41;31;29;3;26
1;221507;221500;84-242;1061;828;824;546;278
2;221507;221500;84-242;1125;806;796;511;285
3;221507;221500;84-242;1282;942;931;555;376
4;221507;221500;84-242;598;382;374;289;85
5;221507;221500;84-242;700;484;480;348;132
6;221507;221500;84-242;1656;1183;1170;644;526
7;221507;221500;84-242;1684;1166;1157;624;533
8;221507;221500;84-242;491;343;339;224;115
9;221507;221500;84-242;880;674;670;461;209
10;221507;221500;84-242;324;247;246;187;59
11;221507;221500;84-252;441;330;328;235;93
12;221507;221500;84-242;1119;820;816;511;305
13;221507;221500;84-242;1300;969;956;504;452
1;221508;221500;84-214;903;569;562;341;221
2;221508;221500;84-214;1019;694;681;390;291
3;221508;221500;84-213;814;495;489;320;169
4;221508;221500;84-218;562;389;388;253;135
5;221508;221500;84-218;674;440;434;241;193
6;221508;221500;84-218;862;584;580;367;213
7;221508;221500;84-218;273;177;176;130;46
8;221508;221500;84-220;1176;792;783;463;320
9;221508;221500;84-220;1209;859;855;494;361
10;221508;221500;84-218;174;112;112;80;32
11;221508;221500;84-218;227;149;146;100;46
12;221508;221500;84-218;759;461;460;255;205
1;221509;221500;84-217;2451;1754;1739;1004;735
2;221509;221500;84-208;2721;2037;2007;1022;985
3;221509;221500;84-217;1036;745;735;514;221
4;221509;221500;84-207;2044;1690;1666;636;1030
5;221509;221500;84-208;1337;1075;1064;362;702
6;221509;221500;84-217;1567;1130;1123;709;414
7;221509;221500;84-207;1569;1249;1234;429;805
8;221509;221500;84-207;1502;1254;1243;466;777
9;221509;221500;84-217;353;263;261;161;100
10;221509;221500;84-217;521;359;357;238;119
11;221509;221500;84-217;667;470;468;381;87
1;221510;221500;84-239;1736;1252;1242;576;666
2;221510;221500;84-239;1867;1355;1342;642;700
3;221510;221500;84-239;1524;1102;1093;552;541
4;221510;221500;84-239;1724;1329;1317;602;715
5;221510;221500;84-241;1552;1087;1073;580;493
6;221510;221500;84-241;1640;1192;1173;683;490
7;221510;221500;84-241;1605;1123;1112;494;618
8;221510;221500;84-252;1640;1239;1224;584;640
9;221510;221500;84-252;657;433;429;282;147
10;221510;221500;84-206;1246;957;947;419;528
11;221510;221500;84-206;522;393;390;161;229
12;221510;221500;84-215;2450;1816;1801;825;976
13;221510;221500;84-215;597;435;434;254;180
14;221510;221500;84-200;1046;875;868;259;609
15;221510;221500;84-252;711;518;509;263;246
16;221510;221500;84-206;410;316;315;145;170
17;221510;221500;84-207;450;311;307;137;170
1;221601;221600;82-440;1601;914;907;420;487
2;221601;221600;82-440;1166;734;724;298;426
3;221601;221600;82-440;218;130;129;75;54
4;221601;221600;82-440;268;156;155;97;58
5;221601;221600;82-440;405;216;215;129;86
6;221601;221600;82-440;329;215;213;123;90
7;221601;221600;82-440;326;170;170;89;81
8;221601;221600;82-440;255;110;109;66;43
9;221601;221600;82-440;342;169;167;92;75
10;221601;221600;82-440;166;83;83;48;35
11;221601;221600;82-440;273;146;145;56;89
12;221601;221600;82-440;1055;616;606;273;333
1;221602;221600;82-433;1048;696;693;341;352
2;221602;221600;82-433;581;317;307;208;99
3;221602;221600;82-433;396;225;222;155;67
4;221602;221600;82-433;518;237;236;166;70
1;221603;221600;82-450;458;227;224;146;78
2;221603;221600;82-450;606;325;317;178;139
3;221603;221600;82-450;750;385;385;255;130
4;221603;221600;82-450;463;238;234;164;70
5;221603;221600;82-450;509;292;290;145;145
1;221604;221600;82-410;852;460;451;267;184
2;221604;221600;82-410;579;274;272;161;111
3;221604;221600;82-410;781;471;465;299;166
4;221604;221600;82-410;873;429;415;211;204
5;221604;221600;82-410;687;366;365;195;170
6;221604;221600;82-410;379;208;205;132;73
7;221604;221600;82-410;297;140;139;95;44
1;221605;221600;82-400;361;194;189;111;78
2;221605;221600;82-400;740;468;459;177;282
3;221605;221600;82-400;1437;831;825;388;437
4;221605;221600;82-400;651;380;378;209;169
5;221605;221600;82-400;481;245;243;122;121
6;221605;221600;82-400;1217;831;823;357;466
7;221605;221600;82-400;1573;1034;1015;432;583
8;221605;221600;82-400;798;468;464;176;288
9;221605;221600;82-400;606;413;411;146;265
10;221605;221600;82-400;1446;952;936;299;637
11;221605;221600;82-400;1271;808;796;371;425
12;221605;221600;82-400;1000;640;636;249;387
13;221605;221600;82-400;521;301;299;173;126
14;221605;221600;82-400;470;299;295;127;168
15;221605;221600;82-400;180;92;91;38;53
16;221605;221600;82-400;836;725;720;38;682
1;226101;226100;80-509;1547;1228;1220;460;760
2;226101;226100;80-506;1590;1203;1183;362;821
3;226101;226100;80-506;3377;2604;2583;874;1709
4;226101;226100;80-515;1740;1342;1333;420;913
5;226101;226100;80-515;1481;1140;1133;417;716
6;226101;226100;80-537;1914;1433;1421;508;913
7;226101;226100;80-546;2353;1664;1648;638;1010
8;226101;226100;80-538;2450;1594;1577;598;979
9;226101;226100;80-531;4016;3290;3252;957;2295
10;226101;226100;80-625;1634;1134;1124;488;636
11;226101;226100;80-625;1683;1159;1141;493;648
12;226101;226100;80-620;1565;1050;1041;437;604
13;226101;226100;80-620;1413;976;966;422;544
14;226101;226100;80-627;1450;1019;1007;417;590
15;226101;226100;80-605;1440;989;980;356;624
16;226101;226100;80-605;1480;1068;1056;458;598
17;226101;226100;80-635;1399;943;931;585;346
18;226101;226100;80-680;1417;1157;1151;357;794
19;226101;226100;80-690;1631;1242;1227;437;790
20;226101;226100;80-717;760;498;492;213;279
21;226101;226100;80-724;575;398;394;159;235
22;226101;226100;80-736;1781;1267;1255;562;693
23;226101;226100;80-037;1870;1343;1321;512;809
24;226101;226100;80-037;1941;1351;1336;491;845
25;226101;226100;80-052;1110;654;649;328;321
26;226101;226100;80-052;1236;775;761;304;457
27;226101;226100;80-058;2657;1822;1806;708;1098
28;226101;226100;80-001;744;515;510;169;341
29;226101;226100;80-012;672;523;516;180;336
30;226101;226100;80-855;2376;1879;1859;493;1366
31;226101;226100;80-851;1040;849;838;276;562
32;226101;226100;80-882;1578;1207;1197;358;839
33;226101;226100;80-837;2211;1692;1670;507;1163
34;226101;226100;80-830;1579;1245;1235;411;824
35;226101;226100;80-822;2572;2020;1992;511;1481
36;226101;226100;80-770;2752;1905;1892;674;1218
37;226101;226100;80-769;1600;1134;1124;385;739
38;226101;226100;80-753;3005;2333;2307;688;1619
39;226101;226100;80-759;1161;876;866;289;577
40;226101;226100;80-806;657;439;437;140;297
41;226101;226100;80-811;1317;865;857;342;515
42;226101;226100;80-180;2178;1774;1764;438;1326
43;226101;226100;80-180;3070;2533;2503;717;1786
44;226101;226100;80-180;2333;1898;1879;474;1405
45;226101;226100;80-180;2571;1870;1851;672;1179
46;226101;226100;80-180;1967;1630;1615;381;1234
47;226101;226100;80-180;2093;1623;1606;494;1112
48;226101;226100;80-180;2941;2476;2458;711;1747
49;226101;226100;80-180;1103;891;881;261;620
50;226101;226100;80-126;1771;1567;1551;336;1215
51;226101;226100;80-177;2526;2126;2101;483;1618
52;226101;226100;80-180;2906;2279;2243;693;1550
53;226101;226100;80-180;3312;2709;2672;722;1950
54;226101;226100;80-180;1558;1304;1295;366;929
55;226101;226100;80-041;2173;1806;1784;612;1172
56;226101;226100;80-041;2574;2118;2099;654;1445
57;226101;226100;80-041;2665;2207;2185;621;1564
58;226101;226100;80-809;2575;2216;2181;500;1681
59;226101;226100;80-809;2585;2224;2199;510;1689
60;226101;226100;80-809;2410;1839;1820;558;1262
61;226101;226100;80-808;2933;2232;2201;732;1469
62;226101;226100;80-807;1500;1158;1151;403;748
63;226101;226100;80-807;2419;1931;1916;614;1302
64;226101;226100;80-807;2387;1998;1974;600;1374
65;226101;226100;80-807;1980;1556;1540;567;973
66;226101;226100;80-807;1860;1505;1486;540;946
67;226101;226100;80-807;2025;1627;1617;609;1008
68;226101;226100;80-807;1973;1591;1577;537;1040
69;226101;226100;80-177;2254;1959;1932;384;1548
70;226101;226100;80-177;2726;2398;2364;495;1869
71;226101;226100;80-177;3218;2717;2676;721;1955
72;226101;226100;80-177;1973;1627;1605;421;1184
73;226101;226100;80-175;3259;2757;2729;671;2058
74;226101;226100;80-175;2272;1791;1776;486;1290
75;226101;226100;80-175;3121;2538;2510;686;1824
76;226101;226100;80-807;1877;1589;1575;469;1106
77;226101;226100;80-122;2232;1781;1770;485;1285
78;226101;226100;80-104;1551;1196;1189;368;821
79;226101;226100;80-104;1629;1289;1282;386;896
80;226101;226100;80-145;2770;2184;2171;679;1492
81;226101;226100;80-145;2532;1942;1922;607;1315
82;226101;226100;80-171;1249;971;966;362;604
83;226101;226100;80-171;2601;2099;2087;702;1385
84;226101;226100;80-169;2118;1657;1644;530;1114
85;226101;226100;80-169;2101;1629;1588;542;1046
86;226101;226100;80-286;2302;1860;1840;583;1257
87;226101;226100;80-286;2945;2457;2439;641;1798
88;226101;226100;80-286;3419;2869;2826;671;2155
89;226101;226100;80-288;2522;2140;2123;439;1684
90;226101;226100;80-288;2676;2240;2212;506;1706
91;226101;226100;80-288;2536;2064;2046;580;1466
92;226101;226100;80-288;2698;2174;2154;649;1505
93;226101;226100;80-288;2299;1899;1872;573;1299
94;226101;226100;80-286;1731;1401;1392;453;939
95;226101;226100;80-156;1772;1514;1490;362;1128
96;226101;226100;80-214;1894;1453;1443;389;1054
97;226101;226100;80-869;2327;1731;1708;580;1128
98;226101;226100;80-281;2030;1665;1648;495;1153
99;226101;226100;80-281;1952;1521;1509;477;1032
100;226101;226100;80-281;1778;1489;1479;413;1066
101;226101;226100;80-282;1751;1398;1381;410;971
102;226101;226100;80-259;2085;1582;1570;428;1142
103;226101;226100;80-259;2734;2246;2222;538;1684
104;226101;226100;80-255;1452;1170;1155;320;835
105;226101;226100;80-251;1835;1440;1425;374;1051
106;226101;226100;80-254;1343;1045;1030;251;779
107;226101;226100;80-252;1299;996;986;280;706
108;226101;226100;80-286;1686;1367;1353;384;969
109;226101;226100;80-226;1278;993;980;262;718
110;226101;226100;80-216;843;708;699;197;502
111;226101;226100;80-218;1005;745;741;236;505
112;226101;226100;80-239;1353;1017;1012;267;745
113;226101;226100;80-426;2421;1878;1860;563;1297
114;226101;226100;80-406;1357;1027;1007;325;682
115;226101;226100;80-427;1680;1297;1275;418;857
116;226101;226100;80-427;2611;2123;2101;584;1517
117;226101;226100;80-409;1416;1046;1038;326;712
118;226101;226100;80-419;1698;1391;1380;353;1027
119;226101;226100;80-441;1857;1474;1460;430;1030
120;226101;226100;80-441;1853;1379;1368;415;953
121;226101;226100;80-441;1535;1170;1160;399;761
122;226101;226100;80-445;1754;1383;1370;393;977
123;226101;226100;80-445;1295;951;944;261;683
124;226101;226100;80-271;1865;1500;1465;374;1091
125;226101;226100;80-276;1323;1109;1102;251;851
126;226101;226100;80-266;1099;899;894;231;663
127;226101;226100;80-462;2534;2055;2033;585;1448
128;226101;226100;80-462;2683;2146;2124;645;1479
129;226101;226100;80-463;1782;1420;1400;421;979
130;226101;226100;80-462;1714;1345;1338;464;874
131;226101;226100;80-462;1951;1686;1668;406;1262
132;226101;226100;80-460;1572;1238;1218;380;838
133;226101;226100;80-460;1902;1538;1523;425;1098
134;226101;226100;80-461;1486;1193;1181;379;802
135;226101;226100;80-461;1403;1162;1146;334;812
136;226101;226100;80-462;2181;1796;1773;484;1289
137;226101;226100;80-462;2322;1919;1899;540;1359
138;226101;226100;80-395;1589;1216;1200;445;755
139;226101;226100;80-395;1495;1115;1099;367;732
140;226101;226100;80-391;1466;1194;1183;375;808
141;226101;226100;80-391;1635;1234;1219;407;812
142;226101;226100;80-396;2442;1931;1915;486;1429
143;226101;226100;80-396;1716;1283;1273;466;807
144;226101;226100;80-396;2138;1701;1682;539;1143
145;226101;226100;80-365;1877;1539;1523;407;1116
146;226101;226100;80-366;1276;983;975;307;668
147;226101;226100;80-371;1762;1352;1342;430;912
148;226101;226100;80-371;1867;1429;1408;415;993
149;226101;226100;80-371;1538;1139;1126;370;756
150;226101;226100;80-371;1428;1063;1056;374;682
151;226101;226100;80-376;1893;1475;1461;425;1036
152;226101;226100;80-376;1922;1515;1502;388;1114
153;226101;226100;80-380;2812;2346;2324;542;1782
154;226101;226100;80-380;2399;1914;1902;544;1358
155;226101;226100;80-390;2352;1953;1940;493;1447
156;226101;226100;80-387;2011;1644;1631;488;1143
157;226101;226100;80-298;2745;2278;2260;701;1559
158;226101;226100;80-298;2347;1898;1885;510;1375
159;226101;226100;80-177;2670;2288;2256;633;1623
160;226101;226100;80-178;2524;2253;2241;552;1689
161;226101;226100;80-298;2960;2270;2238;838;1400
162;226101;226100;80-350;1752;1370;1367;375;992
163;226101;226100;80-350;1993;1517;1502;472;1030
164;226101;226100;80-347;3316;2519;2497;754;1743
165;226101;226100;80-354;1643;1327;1310;426;884
166;226101;226100;80-354;1650;1302;1288;368;920
167;226101;226100;80-335;1762;1432;1414;427;987
168;226101;226100;80-335;1630;1321;1308;416;892
169;226101;226100;80-336;1499;1161;1140;368;772
170;226101;226100;80-336;1767;1401;1385;387;998
171;226101;226100;80-336;1761;1328;1304;432;872
172;226101;226100;80-330;1969;1583;1563;403;1160
173;226101;226100;80-330;1229;901;890;282;608
174;226101;226100;80-322;1302;1015;1005;304;701
175;226101;226100;80-318;1534;1200;1185;333;852
176;226101;226100;80-312;1168;936;926;210;716
177;226101;226100;80-309;649;505;496;130;366
178;226101;226100;80-301;2937;2399;2371;644;1727
179;226101;226100;80-299;2510;2133;2099;582;1517
180;226101;226100;80-299;2281;1870;1856;506;1350
181;226101;226100;80-299;2562;2186;2171;586;1585
182;226101;226100;80-299;2796;2387;2362;575;1787
183;226101;226100;80-299;2728;2337;2320;574;1746
184;226101;226100;80-180;2661;2067;2041;695;1346
185;226101;226100;80-180;2531;2093;2076;531;1545
186;226101;226100;80-175;2497;2001;1977;541;1436
187;226101;226100;80-180;1678;1391;1371;368;1003
188;226101;226100;80-803;803;678;662;70;592
189;226101;226100;80-803;224;85;83;24;59
190;226101;226100;80-104;35;18;18;5;13
191;226101;226100;80-152;92;31;30;16;14
192;226101;226100;80-214;1016;448;443;143;300
193;226101;226100;80-628;43;19;19;13;6
194;226101;226100;80-282;327;146;140;55;85
195;226101;226100;80-219;92;42;42;16;26
196;226101;226100;80-462;461;206;205;57;148
197;226101;226100;80-465;64;49;48;31;17
198;226101;226100;80-389;112;53;53;30;23
199;226101;226100;80-308;87;59;54;24;30
200;226101;226100;80-180;105;47;47;12;35
201;226101;226100;80-308;135;66;66;15;51
202;226101;226100;80-758;390;351;347;40;307
203;226101;226100;80-204;253;234;233;48;185
204;226101;226100;80-227;86;82;80;16;64
205;226101;226100;80-432;225;216;212;72;140
1;226201;226200;81-007;1360;1029;1024;381;643
2;226201;226200;81-007;1351;1046;1037;370;667
3;226201;226200;81-007;1612;1266;1250;430;820
4;226201;226200;81-007;1229;864;857;325;532
5;226201;226200;81-068;1583;1159;1152;388;764
6;226201;226200;81-005;1730;1359;1349;419;930
7;226201;226200;81-079;2014;1574;1555;537;1018
8;226201;226200;81-079;1302;1049;1034;332;702
9;226201;226200;81-078;1616;1279;1268;461;807
10;226201;226200;81-094;1132;879;867;277;590
11;226201;226200;81-057;1474;1103;1091;458;633
12;226201;226200;81-055;1653;1236;1222;393;829
13;226201;226200;81-055;1612;1211;1200;372;828
14;226201;226200;81-049;1275;932;924;320;604
15;226201;226200;81-068;1464;1020;1011;430;581
16;226201;226200;81-049;1794;1344;1331;452;879
17;226201;226200;81-049;1749;1271;1255;470;785
18;226201;226200;81-049;1143;806;794;314;480
19;226201;226200;81-222;1363;1048;1040;414;626
20;226201;226200;81-225;1603;1042;1032;409;623
21;226201;226200;81-222;1493;989;981;382;599
22;226201;226200;81-225;1279;938;928;305;623
23;226201;226200;81-225;929;677;669;207;462
24;226201;226200;81-257;1742;1267;1249;425;824
25;226201;226200;81-201;1702;1347;1333;424;909
26;226201;226200;81-228;1863;1335;1313;443;870
27;226201;226200;81-201;854;661;658;177;481
28;226201;226200;81-265;1968;1532;1519;427;1092
29;226201;226200;81-222;2027;1574;1564;452;1112
30;226201;226200;81-327;1396;1123;1107;321;786
31;226201;226200;81-327;889;668;659;172;487
32;226201;226200;81-311;1573;1195;1175;328;847
33;226201;226200;81-313;965;765;752;202;550
34;226201;226200;81-311;1420;1104;1086;335;751
35;226201;226200;81-653;1820;1422;1404;409;995
36;226201;226200;81-653;1436;1079;1065;303;762
37;226201;226200;81-616;1485;937;927;372;555
38;226201;226200;81-647;1366;961;949;349;600
39;226201;226200;81-647;970;702;695;258;437
40;226201;226200;81-629;1943;1544;1531;494;1037
41;226201;226200;81-629;1659;1251;1244;391;853
42;226201;226200;81-629;1584;1296;1283;333;950
43;226201;226200;81-647;911;728;721;221;500
44;226201;226200;81-601;1309;1032;1024;275;749
45;226201;226200;81-601;2479;2051;2035;539;1496
46;226201;226200;81-578;2723;2279;2255;568;1687
47;226201;226200;81-578;2812;2415;2390;528;1862
48;226201;226200;81-578;2505;2148;2126;542;1584
49;226201;226200;81-589;1757;1416;1402;360;1042
50;226201;226200;81-589;1869;1557;1547;376;1171
51;226201;226200;81-589;1926;1605;1586;413;1173
52;226201;226200;81-578;1460;1213;1201;316;885
53;226201;226200;81-578;1863;1455;1434;424;1010
54;226201;226200;81-578;1591;1240;1231;312;919
55;226201;226200;81-572;2229;1892;1869;378;1491
56;226201;226200;81-572;2303;1945;1926;416;1510
57;226201;226200;81-575;2589;2110;2094;600;1494
58;226201;226200;81-575;1572;1341;1325;305;1020
59;226201;226200;81-591;2217;1803;1787;532;1255
60;226201;226200;81-597;2043;1646;1621;478;1143
61;226201;226200;81-597;1610;1276;1264;316;948
62;226201;226200;81-571;1849;1457;1434;404;1030
63;226201;226200;81-597;2832;2404;2383;420;1963
64;226201;226200;81-553;2812;2287;2269;571;1698
65;226201;226200;81-506;2218;1634;1614;536;1078
66;226201;226200;81-553;1104;901;893;261;632
67;226201;226200;81-542;1612;1345;1331;314;1017
68;226201;226200;81-542;1236;1034;1027;296;731
69;226201;226200;81-522;1861;1563;1553;375;1178
70;226201;226200;81-465;2129;1686;1678;459;1219
71;226201;226200;81-473;2522;2089;2068;456;1612
72;226201;226200;81-465;1867;1470;1458;383;1075
73;226201;226200;81-453;1389;1101;1080;286;794
74;226201;226200;81-428;1233;910;896;267;629
75;226201;226200;81-402;1495;1107;1098;293;805
76;226201;226200;81-424;1084;841;830;246;584
77;226201;226200;81-438;907;698;687;185;502
78;226201;226200;81-405;1169;933;921;238;683
79;226201;226200;81-405;1302;1007;1001;263;738
80;226201;226200;81-384;723;562;559;136;423
81;226201;226200;81-385;1289;1057;1045;273;772
82;226201;226200;81-385;1074;888;884;199;685
83;226201;226200;81-384;1109;876;866;232;634
84;226201;226200;81-384;1569;1249;1239;355;884
85;226201;226200;81-384;955;723;718;171;547
86;226201;226200;81-351;1237;962;953;256;697
87;226201;226200;81-364;918;768;758;214;544
88;226201;226200;81-351;884;724;716;198;518
89;226201;226200;81-354;1053;798;791;200;591
90;226201;226200;81-384;840;656;647;166;481
91;226201;226200;81-351;2058;1619;1604;434;1170
92;226201;226200;81-127;1085;719;715;338;377
93;226201;226200;81-134;2185;1733;1722;583;1139
94;226201;226200;81-167;1608;1197;1187;381;806
95;226201;226200;81-134;2093;1721;1716;489;1227
96;226201;226200;81-134;1083;832;817;243;574
97;226201;226200;81-134;1978;1464;1454;420;1034
98;226201;226200;81-109;1573;1174;1154;415;739
99;226201;226200;81-197;1466;1137;1129;280;849
100;226201;226200;81-167;1107;834;831;287;544
101;226201;226200;81-155;978;761;755;258;497
102;226201;226200;81-167;1563;1189;1178;382;796
103;226201;226200;81-194;1940;1492;1474;501;973
104;226201;226200;81-178;1781;1336;1324;481;843
105;226201;226200;81-181;2125;1640;1620;607;1013
106;226201;226200;81-181;959;763;758;297;461
107;226201;226200;81-181;1290;1028;1019;347;672
108;226201;226200;81-157;1878;1458;1444;516;928
109;226201;226200;81-185;1395;1101;1084;399;685
110;226201;226200;81-181;1851;1438;1425;459;966
111;226201;226200;81-185;1230;969;957;383;574
112;226201;226200;81-185;1665;1298;1289;461;828
113;226201;226200;81-153;1677;1217;1206;516;690
114;226201;226200;81-153;1434;981;971;405;566
115;226201;226200;81-348;157;86;84;38;46
116;226201;226200;81-519;169;104;104;35;69
117;226201;226200;81-519;38;33;33;12;21
118;226201;226200;81-078;62;54;50;14;36
1;226301;226300;76-200;1139;863;853;279;574
2;226301;226300;76-200;1490;1077;1067;389;678
3;226301;226300;76-200;1671;1248;1234;483;751
4;226301;226300;76-200;2376;1820;1803;653;1150
5;226301;226300;76-200;1679;1257;1251;450;801
6;226301;226300;76-200;1356;1090;1081;407;674
7;226301;226300;76-200;1487;1115;1102;404;698
8;226301;226300;76-200;1763;1340;1326;492;834
9;226301;226300;76-200;1490;1064;1054;496;558
10;226301;226300;76-200;1077;754;743;254;489
11;226301;226300;76-200;1756;1234;1225;505;720
12;226301;226300;76-200;1435;972;960;406;554
13;226301;226300;76-200;1671;1206;1196;436;760
14;226301;226300;76-200;917;602;598;271;327
15;226301;226300;76-200;1251;892;887;339;548
16;226301;226300;76-200;978;683;671;223;448
17;226301;226300;76-200;873;617;615;230;385
18;226301;226300;76-200;1562;1154;1143;395;748
19;226301;226300;76-200;1258;929;924;283;641
20;226301;226300;76-200;1139;819;817;314;503
21;226301;226300;76-200;1480;1003;995;394;601
22;226301;226300;76-200;1524;1125;1122;426;696
23;226301;226300;76-200;1476;887;877;373;504
24;226301;226300;76-200;1398;809;798;367;431
25;226301;226300;76-200;1390;819;807;356;451
26;226301;226300;76-200;1354;851;841;384;457
27;226301;226300;76-200;1201;712;705;307;398
28;226301;226300;76-200;793;563;559;200;359
29;226301;226300;76-200;868;511;507;205;302
30;226301;226300;76-200;1134;704;698;302;396
31;226301;226300;76-200;1240;756;751;316;435
32;226301;226300;76-200;1547;1044;1034;406;628
33;226301;226300;76-200;1574;1110;1099;418;681
34;226301;226300;76-200;1086;671;660;313;347
35;226301;226300;76-200;1357;862;852;375;477
36;226301;226300;76-200;718;490;490;177;313
37;226301;226300;76-200;1507;1059;1048;332;716
38;226301;226300;76-200;2289;1633;1619;610;1009
39;226301;226300;76-200;1910;1328;1319;501;818
40;226301;226300;76-200;1736;1336;1328;415;913
41;226301;226300;76-200;1215;917;907;293;614
42;226301;226300;76-200;1942;1587;1572;548;1024
43;226301;226300;76-200;1886;1376;1370;435;935
44;226301;226300;76-200;485;180;176;69;107
45;226301;226300;76-200;168;129;126;22;104
46;226301;226300;76-200;55;32;29;14;15
47;226301;226300;76-200;73;36;36;18;18
1;226401;226400;81-715;1029;846;839;252;587
2;226401;226400;81-720;1072;916;904;244;660
3;226401;226400;81-703;851;667;663;172;491
4;226401;226400;81-720;1335;1100;1089;288;801
5;226401;226400;81-704;1137;935;921;283;638
6;226401;226400;81-780;1563;1211;1198;322;876
7;226401;226400;81-724;1515;1229;1217;313;904
8;226401;226400;81-743;1559;1270;1261;327;934
9;226401;226400;81-746;2349;1908;1888;440;1448
10;226401;226400;81-843;1555;1241;1230;379;851
11;226401;226400;81-843;1170;961;955;238;717
12;226401;226400;81-866;1108;919;904;245;659
13;226401;226400;81-838;1614;1182;1173;345;828
14;226401;226400;81-824;1497;1181;1170;273;897
15;226401;226400;81-820;1530;1198;1190;339;851
16;226401;226400;81-821;1224;955;945;273;672
17;226401;226400;81-815;1555;1259;1249;329;920
18;226401;226400;81-814;904;655;644;200;444
19;226401;226400;81-862;1333;1059;1049;270;779
20;226401;226400;81-881;1353;1084;1073;286;787
21;226401;226400;81-881;1258;1003;990;313;677
22;226401;226400;81-759;24;24;24;6;18
23;226401;226400;81-820;35;34;34;11;23
24;226401;226400;81-820;164;164;163;81;82
25;226401;226400;81-731;296;267;264;102;162
1;240101;240100;42-500;995;709;704;285;419
2;240101;240100;42-500;1545;1014;1005;422;583
3;240101;240100;42-500;1374;973;963;402;561
4;240101;240100;42-500;1336;994;989;393;596
5;240101;240100;42-500;1412;1078;1065;390;675
6;240101;240100;42-500;1408;1037;1024;399;625
7;240101;240100;42-500;1303;920;915;398;517
8;240101;240100;42-500;1811;1392;1375;439;936
9;240101;240100;42-500;1360;1053;1042;354;688
10;240101;240100;42-500;1544;1012;1003;407;596
11;240101;240100;42-500;1260;778;771;369;402
12;240101;240100;42-500;1039;713;706;269;437
13;240101;240100;42-500;993;598;592;256;336
14;240101;240100;42-500;547;344;343;156;187
15;240101;240100;42-500;867;597;590;239;351
16;240101;240100;42-500;1919;1424;1412;611;801
17;240101;240100;42-506;1990;1276;1264;514;750
18;240101;240100;42-506;1623;1154;1148;371;777
19;240101;240100;42-506;2196;1496;1469;576;893
20;240101;240100;42-500;688;551;547;181;366
21;240101;240100;42-504;2309;1580;1570;587;983
22;240101;240100;42-504;773;565;560;182;378
23;240101;240100;42-500;2082;1656;1643;537;1106
24;240101;240100;42-500;2081;1574;1559;569;990
25;240101;240100;42-500;1977;1295;1285;502;783
26;240101;240100;42-500;808;627;624;217;407
27;240101;240100;42-500;2033;1411;1385;565;820
28;240101;240100;42-506;47;26;24;8;16
29;240101;240100;42-500;71;31;31;11;20
1;240102;240100;41-250;1146;815;806;301;505
2;240102;240100;41-250;1170;865;848;332;516
3;240102;240100;41-250;1069;719;714;261;453
4;240102;240100;41-250;1136;687;683;272;411
5;240102;240100;41-250;960;631;625;232;393
6;240102;240100;41-250;1291;899;889;357;532
7;240102;240100;41-250;717;572;570;204;366
8;240102;240100;41-250;1855;1448;1435;398;1037
9;240102;240100;41-250;991;729;723;249;474
10;240102;240100;41-250;995;784;781;270;511
11;240102;240100;41-250;915;599;588;247;341
12;240102;240100;41-250;982;681;678;289;389
13;240102;240100;41-250;900;680;672;257;415
14;240102;240100;41-250;942;716;709;245;464
15;240102;240100;41-253;1099;790;782;246;536
16;240102;240100;41-253;1083;739;731;287;444
17;240102;240100;41-253;1068;692;692;284;408
18;240102;240100;41-253;1404;1061;1050;350;700
19;240102;240100;41-253;1047;777;772;246;526
20;240102;240100;41-253;914;717;712;274;438
21;240102;240100;41-253;992;737;732;286;446
22;240102;240100;41-250;110;52;51;21;30
23;240102;240100;41-250;45;17;17;3;14
1;240103;240100;42-580;1380;972;958;316;642
2;240103;240100;42-580;972;579;577;237;340
3;240103;240100;42-580;1485;1010;995;418;577
4;240103;240100;42-580;1004;683;677;268;409
5;240103;240100;42-580;1706;1263;1248;428;820
6;240103;240100;42-580;522;403;393;71;322
7;240103;240100;42-580;342;286;278;36;242
1;240104;240100;42-583;1386;1032;1023;379;644
2;240104;240100;42-583;1081;691;689;349;340
3;240104;240100;42-584;1533;1050;1037;403;634
4;240104;240100;42-595;446;331;331;143;188
5;240104;240100;42-582;1247;920;907;302;605
6;240104;240100;42-582;1192;898;883;307;576
7;240104;240100;42-595;1089;773;766;394;372
8;240104;240100;42-595;780;589;589;251;338
9;240104;240100;42-595;364;270;267;143;124
10;240104;240100;42-584;595;443;436;163;273
1;240105;240100;42-460;987;719;715;317;398
2;240105;240100;42-460;1199;808;790;402;388
3;240105;240100;42-460;796;579;576;260;316
4;240105;240100;42-460;827;605;597;296;301
5;240105;240100;42-460;827;588;579;246;333
6;240105;240100;42-460;512;380;374;184;190
7;240105;240100;42-460;575;418;417;146;271
8;240105;240100;42-460;559;383;379;214;165
1;240106;240100;42-504;886;635;629;235;394
2;240106;240100;42-504;527;362;355;165;190
3;240106;240100;42-575;853;654;647;230;417
4;240106;240100;42-575;790;628;621;211;410
5;240106;240100;42-512;664;523;518;165;353
6;240106;240100;42-512;792;585;579;187;392
7;240106;240100;42-512;2142;1516;1506;635;871
8;240106;240100;42-512;1565;1174;1160;418;742
9;240106;240100;42-575;1512;1068;1062;394;668
1;240107;240100;42-470;2611;1819;1802;789;1013
2;240107;240100;42-470;1901;1414;1406;622;784
3;240107;240100;42-470;919;615;606;372;234
4;240107;240100;42-470;547;377;375;226;149
5;240107;240100;42-510;1479;1087;1076;626;450
6;240107;240100;42-470;1455;1008;1001;614;387
7;240107;240100;42-470;305;232;232;156;76
8;240107;240100;42-510;738;554;551;240;311
9;240107;240100;42-470;25;12;12;7;5
1;240108;240100;41-260;1026;736;729;343;386
2;240108;240100;41-260;972;701;693;360;333
3;240108;240100;41-260;985;725;718;381;337
4;240108;240100;41-260;1162;860;851;424;427
5;240108;240100;41-260;1104;825;821;371;450
1;240201;240200;43-370;1575;1213;1195;631;564
2;240201;240200;43-370;1533;1224;1217;625;592
3;240201;240200;43-370;637;488;483;288;195
4;240201;240200;43-370;1097;799;795;484;311
1;240202;240200;43-512;1824;1387;1372;699;673
2;240202;240200;43-512;1945;1551;1535;738;797
3;240202;240200;43-512;1339;1013;1004;508;496
4;240202;240200;43-512;1401;1104;1097;598;499
5;240202;240200;43-514;1306;912;904;435;469
6;240202;240200;43-514;1335;1016;1006;494;512
1;240203;240200;43-374;1641;1207;1192;656;536
2;240203;240200;43-374;1672;1241;1232;608;624
3;240203;240200;43-378;1088;814;808;524;284
4;240203;240200;43-378;1464;1024;1015;591;424
5;240203;240200;43-376;1751;1266;1254;725;529
6;240203;240200;43-376;761;587;580;415;165
1;240204;240200;43-502;1766;1293;1289;590;699
2;240204;240200;43-502;1454;1055;1045;469;576
3;240204;240200;43-502;1598;1092;1080;503;577
4;240204;240200;43-502;1698;1289;1277;551;726
5;240204;240200;43-502;1515;1158;1153;535;618
6;240204;240200;43-502;1606;1198;1191;488;703
7;240204;240200;43-502;867;620;614;292;322
8;240204;240200;43-502;1776;1232;1219;579;640
9;240204;240200;43-502;1666;1257;1245;561;684
10;240204;240200;43-502;1638;1141;1124;558;566
11;240204;240200;43-502;1492;1017;1003;491;512
12;240204;240200;43-502;1425;1042;1035;535;500
13;240204;240200;43-502;1275;905;895;479;416
14;240204;240200;43-502;1390;1058;1050;542;508
15;240204;240200;43-502;2142;1722;1709;750;959
16;240204;240200;43-502;2331;1809;1786;873;913
17;240204;240200;43-516;1337;998;987;546;441
18;240204;240200;43-516;1281;943;936;463;473
19;240204;240200;43-518;1826;1387;1375;714;661
20;240204;240200;43-518;852;624;619;377;242
21;240204;240200;43-518;1166;865;857;509;348
22;240204;240200;43-502;856;691;687;500;187
23;240204;240200;43-502;23;23;23;18;5
1;240205;240200;43-386;420;305;302;155;147
2;240205;240200;43-386;1035;793;786;403;383
3;240205;240200;43-386;967;723;715;289;426
4;240205;240200;43-394;782;560;553;385;168
5;240205;240200;43-385;1687;1246;1235;499;736
6;240205;240200;43-385;1742;1308;1298;521;777
7;240205;240200;43-385;704;525;518;192;326
8;240205;240200;43-394;470;337;335;215;120
9;240205;240200;43-394;1429;1116;1101;737;364
10;240205;240200;43-394;908;652;644;409;235
11;240205;240200;43-386;716;530;526;338;188
12;240205;240200;43-391;1128;870;862;428;434
13;240205;240200;43-391;907;703;691;329;362
14;240205;240200;43-391;908;697;692;307;385
15;240205;240200;43-392;967;761;753;411;342
16;240205;240200;43-392;981;741;734;341;393
17;240205;240200;43-392;1180;852;845;521;324
18;240205;240200;43-394;575;405;402;218;184
19;240205;240200;43-386;465;361;358;191;167
20;240205;240200;43-386;503;377;375;231;144
1;240206;240200;43-384;1706;1350;1339;534;805
2;240206;240200;43-384;1645;1243;1231;456;775
3;240206;240200;43-384;2332;1814;1803;625;1178
4;240206;240200;43-384;113;94;93;38;55
1;240207;240200;43-340;2179;1633;1619;801;818
2;240207;240200;43-340;1646;1249;1233;638;595
3;240207;240200;43-340;1761;1302;1290;703;587
4;240207;240200;43-340;2225;1734;1722;865;857
5;240207;240200;43-340;2087;1553;1536;712;824
1;240208;240200;43-356;1773;1280;1263;715;548
2;240208;240200;43-354;1304;975;964;614;350
3;240208;240200;43-354;1506;1111;1102;640;462
4;240208;240200;43-354;1582;1157;1148;719;429
5;240208;240200;43-356;1662;1164;1155;663;492
6;240208;240200;43-356;909;637;628;384;244
7;240208;240200;43-353;1574;1146;1141;645;496
8;240208;240200;43-353;1622;1166;1154;710;444
1;240209;240200;43-330;2331;1825;1805;1218;587
2;240209;240200;43-331;2218;1589;1572;887;685
3;240209;240200;43-330;1940;1478;1468;983;485
4;240209;240200;43-332;2068;1594;1573;792;781
5;240209;240200;43-332;1852;1400;1385;752;633
6;240209;240200;43-332;808;588;582;362;220
7;240209;240200;43-330;1659;1259;1240;892;348
8;240209;240200;43-330;763;566;560;328;232
1;240210;240200;43-365;1370;1059;1049;537;512
2;240210;240200;43-365;1284;920;912;425;487
3;240210;240200;43-365;1299;967;956;463;493
4;240210;240200;43-365;1250;941;933;426;507
5;240210;240200;43-360;1187;888;881;320;561
6;240210;240200;43-360;2026;1526;1510;613;897
7;240210;240200;43-360;1749;1288;1261;644;617
8;240210;240200;43-365;93;64;63;38;25
9;240210;240200;43-360;83;83;80;38;42
10;240210;240200;43-365;55;36;34;27;7
1;240301;240300;43-400;693;462;454;218;236
2;240301;240300;43-400;641;473;468;245;223
3;240301;240300;43-400;1054;752;742;289;453
4;240301;240300;43-400;1745;1304;1291;544;747
5;240301;240300;43-400;916;699;693;243;450
6;240301;240300;43-400;2028;1506;1493;564;929
7;240301;240300;43-400;861;623;616;266;350
8;240301;240300;43-400;1349;940;929;363;566
9;240301;240300;43-400;866;574;568;248;320
10;240301;240300;43-400;1039;738;733;283;450
11;240301;240300;43-400;1370;969;965;397;568
12;240301;240300;43-400;982;618;613;236;377
13;240301;240300;43-400;728;523;519;186;333
14;240301;240300;43-400;1443;1007;994;397;597
15;240301;240300;43-400;1245;793;786;302;484
16;240301;240300;43-400;1527;1084;1073;408;665
17;240301;240300;43-400;1373;896;888;379;509
18;240301;240300;43-400;1597;1214;1207;440;767
19;240301;240300;43-400;956;696;684;266;418
20;240301;240300;43-400;1709;1339;1319;486;833
21;240301;240300;43-400;385;140;140;64;76
22;240301;240300;43-400;60;36;36;23;13
23;240301;240300;43-400;130;68;68;60;8
24;240301;240300;43-400;62;26;26;13;13
25;240301;240300;43-400;62;61;61;42;19
26;240301;240300;43-400;339;285;284;37;247
1;240302;240300;43-450;1147;801;794;270;524
2;240302;240300;43-450;677;531;527;139;388
3;240302;240300;43-450;1710;1215;1205;411;794
4;240302;240300;43-450;1724;1408;1399;487;912
5;240302;240300;43-450;1998;1434;1423;488;935
6;240302;240300;43-450;2097;1464;1450;570;880
7;240302;240300;43-450;1235;837;831;430;401
8;240302;240300;43-450;1212;850;841;337;504
9;240302;240300;43-450;1327;1030;1021;393;628
10;240302;240300;43-450;1117;1117;1109;508;601
11;240302;240300;43-450;159;159;159;73;86
12;240302;240300;43-450;133;120;119;58;61
13;240302;240300;43-450;33;23;21;13;8
1;240303;240300;43-460;701;516;510;169;341
2;240303;240300;43-460;1321;950;947;217;730
3;240303;240300;43-460;1201;868;862;240;622
4;240303;240300;43-460;1126;804;786;230;556
5;240303;240300;43-460;1910;1234;1219;389;830
6;240303;240300;43-460;1357;787;771;255;516
7;240303;240300;43-460;626;385;378;150;228
8;240303;240300;43-460;948;659;653;180;473
1;240304;240300;43-436;1296;914;907;493;414
2;240304;240300;43-436;1373;965;957;485;472
3;240304;240300;43-436;1395;1035;1030;539;491
4;240304;240300;43-438;811;590;587;342;245
5;240304;240300;43-438;1079;751;745;415;330
6;240304;240300;43-438;1125;766;760;445;315
7;240304;240300;43-438;1138;814;807;445;362
8;240304;240300;43-438;801;801;797;463;334
1;240305;240300;43-520;1656;1247;1241;725;516
2;240305;240300;43-520;1308;910;904;616;288
3;240305;240300;43-520;213;138;134;90;44
4;240305;240300;43-520;1408;934;930;558;372
5;240305;240300;43-520;1891;1414;1404;891;513
6;240305;240300;43-520;835;595;587;382;205
1;240306;240300;43-426;1433;1030;1021;584;437
2;240306;240300;43-426;397;277;276;141;135
3;240306;240300;43-426;772;547;533;234;299
4;240306;240300;43-426;499;358;353;188;165
5;240306;240300;43-426;1251;843;834;377;457
1;240307;240300;43-440;1300;941;930;314;616
2;240307;240300;43-440;1219;814;801;244;557
3;240307;240300;43-440;856;622;614;230;384
4;240307;240300;43-440;938;647;641;216;425
5;240307;240300;43-440;578;411;408;159;249
6;240307;240300;43-440;547;377;370;171;199
7;240307;240300;43-440;470;304;298;106;192
8;240307;240300;43-445;1006;759;750;294;456
9;240307;240300;43-400;1212;865;856;377;479
10;240307;240300;43-440;1375;924;915;294;621
11;240307;240300;43-445;389;250;250;122;128
12;240307;240300;43-445;90;61;61;18;43
1;240308;240300;43-418;519;364;360;230;130
2;240308;240300;43-419;1938;1418;1410;763;647
3;240308;240300;43-419;1431;1047;1039;646;393
4;240308;240300;43-418;1758;1262;1246;658;588
5;240308;240300;43-418;908;592;582;307;275
6;240308;240300;43-419;400;286;283;198;85
7;240308;240300;43-419;1110;767;759;321;438
1;240309;240300;43-470;2091;1572;1559;1190;369
2;240309;240300;43-470;1831;1313;1300;841;459
3;240309;240300;43-476;1257;944;943;819;124
4;240309;240300;43-476;1174;827;821;682;139
5;240309;240300;43-474;1616;1197;1188;894;294
6;240309;240300;43-474;1117;740;737;545;192
7;240309;240300;43-470;65;61;60;29;31
1;240310;240300;43-430;2017;1266;1254;591;663
2;240310;240300;43-430;1883;1320;1298;627;671
3;240310;240300;43-430;722;472;470;246;224
4;240310;240300;43-430;631;454;454;198;256
5;240310;240300;43-430;1469;895;887;469;418
6;240310;240300;43-430;1747;1324;1314;683;631
7;240310;240300;43-430;1352;909;903;377;526
8;240310;240300;43-430;863;580;576;366;210
9;240310;240300;43-430;1633;1171;1151;607;544
10;240310;240300;43-430;1556;1139;1128;638;490
11;240310;240300;43-430;588;414;411;246;165
12;240310;240300;43-430;730;493;481;219;262
13;240310;240300;43-430;695;461;458;226;232
14;240310;240300;43-430;524;373;371;228;143
15;240310;240300;43-430;886;634;629;262;367
16;240310;240300;43-430;1478;1051;1037;631;406
17;240310;240300;43-430;442;295;291;101;190
18;240310;240300;43-430;66;40;35;28;7
19;240310;240300;43-430;35;26;26;15;11
1;240311;240300;43-246;1339;982;978;626;352
2;240311;240300;43-246;1235;912;902;525;377
3;240311;240300;43-523;680;486;484;247;237
4;240311;240300;43-523;1213;871;863;517;346
5;240311;240300;43-424;1735;1175;1164;569;595
6;240311;240300;43-246;1402;1014;1009;653;356
7;240311;240300;43-246;1122;827;814;581;233
8;240311;240300;43-246;1146;879;871;591;280
1;240312;240300;43-410;846;660;648;431;217
2;240312;240300;43-410;1415;996;978;581;397
3;240312;240300;43-410;1309;899;891;488;403
4;240312;240300;43-410;1336;990;983;571;412
5;240312;240300;43-410;1341;980;971;592;379
6;240312;240300;43-410;1245;927;924;583;341
7;240312;240300;43-417;1167;870;863;505;358
8;240312;240300;43-417;1111;775;772;454;318
1;240401;240400;42-290;1992;1438;1420;611;809
2;240401;240400;42-290;1875;1330;1323;585;738
3;240401;240400;42-290;1679;1118;1104;495;609
4;240401;240400;42-290;1231;926;921;416;505
5;240401;240400;42-290;2118;1393;1376;666;710
6;240401;240400;42-290;543;370;367;174;193
7;240401;240400;42-290;90;35;35;18;17
8;240401;240400;42-290;109;58;54;37;17
1;240402;240400;42-265;1112;783;779;489;290
2;240402;240400;42-265;994;662;656;444;212
3;240402;240400;42-265;352;222;221;113;108
4;240402;240400;42-265;662;466;463;326;137
1;240403;240400;42-253;492;340;337;230;107
2;240403;240400;42-253;304;225;223;161;62
3;240403;240400;42-253;701;469;467;361;106
4;240403;240400;42-253;657;452;444;362;82
5;240403;240400;42-253;405;274;271;194;77
6;240403;240400;42-253;1162;814;808;462;346
7;240403;240400;42-253;856;640;630;393;237
8;240403;240400;42-253;162;126;126;97;29
1;240404;240400;42-260;1348;974;963;427;536
2;240404;240400;42-260;1141;824;819;355;464
3;240404;240400;42-260;781;539;537;243;294
4;240404;240400;42-260;638;451;448;193;255
5;240404;240400;42-260;433;294;289;185;104
1;240405;240400;42-270;2063;1519;1503;841;662
2;240405;240400;42-270;404;273;272;169;103
3;240405;240400;42-270;648;456;453;250;203
4;240405;240400;42-270;429;281;277;165;112
5;240405;240400;42-270;466;321;318;202;116
6;240405;240400;42-270;965;631;621;434;187
7;240405;240400;42-270;521;337;335;219;116
8;240405;240400;42-270;1495;1005;996;608;388
9;240405;240400;42-270;788;521;519;305;214
10;240405;240400;42-270;795;566;563;400;163
11;240405;240400;42-270;432;317;312;210;102
12;240405;240400;42-270;360;246;244;171;73
13;240405;240400;42-270;326;252;250;134;116
14;240405;240400;42-270;366;250;247;169;78
15;240405;240400;42-270;251;165;161;122;39
1;240406;240400;42-230;792;539;535;329;206
2;240406;240400;42-230;1956;1299;1292;893;399
3;240406;240400;42-230;747;465;463;361;102
4;240406;240400;42-230;392;248;246;203;43
5;240406;240400;42-230;418;276;275;242;33
6;240406;240400;42-230;279;201;201;140;61
7;240406;240400;42-230;2173;1438;1425;838;587
8;240406;240400;42-230;252;185;183;139;44
1;240407;240400;42-274;881;587;580;255;325
2;240407;240400;42-274;685;457;452;197;255
3;240407;240400;42-274;430;294;292;165;127
4;240407;240400;42-274;604;403;400;201;199
5;240407;240400;42-274;739;499;488;249;239
6;240407;240400;42-274;514;345;344;206;138
7;240407;240400;42-274;1075;769;763;324;439
8;240407;240400;42-274;1238;904;900;325;575
9;240407;240400;42-274;446;315;313;191;122
10;240407;240400;42-274;324;204;203;111;92
11;240407;240400;42-274;704;472;469;271;198
12;240407;240400;42-274;415;293;290;128;162
13;240407;240400;42-274;399;261;260;132;128
1;240408;240400;42-282;887;622;616;380;236
2;240408;240400;42-282;601;408;404;266;138
3;240408;240400;42-282;887;569;562;394;168
4;240408;240400;42-282;693;457;452;311;141
5;240408;240400;42-282;272;177;177;116;61
6;240408;240400;42-282;406;285;281;175;106
1;240409;240400;42-235;419;300;299;191;108
2;240409;240400;42-235;372;277;276;203;73
3;240409;240400;42-235;875;620;606;389;217
4;240409;240400;42-235;394;249;248;185;63
5;240409;240400;42-235;606;424;423;345;78
6;240409;240400;42-235;416;339;336;269;67
7;240409;240400;42-235;240;180;178;129;49
8;240409;240400;42-235;356;277;274;243;31
9;240409;240400;42-235;60;46;42;24;18
1;240410;240400;42-244;1207;905;894;509;385
2;240410;240400;42-244;1495;1139;1130;607;523
3;240410;240400;42-244;405;286;282;196;86
4;240410;240400;42-244;703;454;448;325;123
5;240410;240400;42-244;532;353;353;270;83
6;240410;240400;42-244;323;208;207;107;100
7;240410;240400;42-244;616;457;453;304;149
8;240410;240400;42-244;1301;947;937;527;410
9;240410;240400;42-244;730;528;526;356;170
10;240410;240400;42-244;436;340;338;233;105
11;240410;240400;42-244;371;254;252;171;81
12;240410;240400;42-244;362;275;274;191;83
1;240411;240400;42-233;1022;766;761;541;220
2;240411;240400;42-233;862;629;621;314;307
3;240411;240400;42-231;451;335;332;198;134
4;240411;240400;42-231;857;577;573;385;188
5;240411;240400;42-233;1211;897;889;603;286
6;240411;240400;42-233;857;651;638;387;251
7;240411;240400;42-231;583;431;428;290;138
8;240411;240400;42-233;769;547;540;324;216
9;240411;240400;42-233;568;487;482;151;331
10;240411;240400;42-233;608;470;466;306;160
11;240411;240400;42-231;352;251;247;157;90
12;240411;240400;42-233;598;468;463;295;168
13;240411;240400;42-231;723;535;529;324;205
14;240411;240400;42-231;255;175;175;133;42
15;240411;240400;42-233;221;166;165;116;49
16;240411;240400;42-231;448;317;313;216;97
17;240411;240400;42-233;382;283;282;211;71
18;240411;240400;42-231;254;177;175;127;48
19;240411;240400;42-233;809;639;636;269;367
1;240412;240400;42-256;832;610;603;307;296
2;240412;240400;42-256;943;653;647;371;276
3;240412;240400;42-256;2019;1546;1531;645;886
4;240412;240400;42-256;669;485;478;266;212
5;240412;240400;42-256;1019;699;695;440;255
6;240412;240400;42-256;654;528;523;306;217
7;240412;240400;42-256;276;192;192;107;85
8;240412;240400;42-256;56;36;34;15;19
1;240413;240400;42-262;608;457;455;177;278
2;240413;240400;42-262;1225;889;887;515;372
3;240413;240400;42-263;1104;798;788;351;437
4;240413;240400;42-263;1648;1071;1059;545;514
5;240413;240400;42-263;986;743;737;356;381
6;240413;240400;42-263;1492;1076;1061;510;551
7;240413;240400;42-262;511;385;383;221;162
8;240413;240400;42-262;452;321;313;164;149
9;240413;240400;42-262;853;596;589;251;338
10;240413;240400;42-262;758;569;566;246;320
1;240414;240400;42-248;355;246;241;166;75
2;240414;240400;42-248;1020;685;678;420;258
3;240414;240400;42-248;437;312;309;259;50
4;240414;240400;42-250;272;190;187;114;73
5;240414;240400;42-250;280;191;188;138;50
6;240414;240400;42-250;176;137;137;102;35
7;240414;240400;42-250;172;114;114;70;44
8;240414;240400;42-250;157;115;114;85;29
1;240415;240400;42-242;1127;886;880;415;465
2;240415;240400;42-242;1657;1185;1174;594;580
3;240415;240400;42-242;440;310;305;158;147
4;240415;240400;42-240;1119;768;760;415;345
5;240415;240400;42-240;1537;1090;1082;779;303
6;240415;240400;42-240;748;538;530;299;231
7;240415;240400;42-242;758;533;528;310;218
1;240416;240400;42-261;607;397;396;200;196
2;240416;240400;42-261;526;390;384;210;174
3;240416;240400;42-261;310;209;209;90;119
4;240416;240400;42-261;409;300;298;173;125
5;240416;240400;42-261;500;383;378;184;194
1;240501;240500;44-196;1509;1121;1110;536;574
2;240501;240500;44-196;841;623;619;297;322
3;240501;240500;44-196;1946;1531;1513;668;845
4;240501;240500;44-196;892;678;671;336;335
5;240501;240500;44-194;895;660;652;346;306
6;240501;240500;44-194;830;593;589;303;286
7;240501;240500;44-194;1029;749;744;372;372
8;240501;240500;44-194;1170;800;792;405;387
9;240501;240500;44-194;1366;908;899;507;392
10;240501;240500;44-194;1213;863;856;422;434
11;240501;240500;44-190;2058;1501;1492;671;821
12;240501;240500;44-190;1725;1177;1159;614;545
13;240501;240500;44-190;1079;791;786;351;435
14;240501;240500;44-190;1426;1029;1017;519;498
15;240501;240500;44-190;1539;981;977;567;410
16;240501;240500;44-190;980;656;645;390;255
17;240501;240500;44-190;1207;909;904;416;488
18;240501;240500;44-193;1282;947;935;499;436
19;240501;240500;44-193;1503;1024;1007;632;375
20;240501;240500;44-193;911;625;620;418;202
21;240501;240500;44-193;954;640;634;411;223
22;240501;240500;44-190;43;29;29;15;14
1;240502;240500;44-120;1850;1236;1217;544;673
2;240502;240500;44-120;871;564;560;239;321
3;240502;240500;44-120;1847;1170;1155;517;638
4;240502;240500;44-120;1411;966;953;439;514
5;240502;240500;44-120;1552;976;973;457;516
6;240502;240500;44-120;1463;864;853;453;400
7;240502;240500;44-120;1556;932;922;479;443
8;240502;240500;44-120;1338;1067;1053;372;681
9;240502;240500;44-120;772;448;438;228;210
10;240502;240500;44-120;36;24;24;15;9
1;240503;240500;44-186;1857;1345;1325;740;585
2;240503;240500;44-186;1235;907;889;421;468
3;240503;240500;44-178;1381;1018;1011;499;512
4;240503;240500;44-178;1288;955;940;482;458
5;240503;240500;44-177;2309;1822;1804;1027;777
6;240503;240500;44-177;1391;1031;1017;567;450
1;240504;240500;44-144;1079;838;832;363;469
2;240504;240500;44-145;329;240;239;92;147
3;240504;240500;44-145;2554;1769;1755;731;1024
4;240504;240500;44-145;1246;798;790;441;349
5;240504;240500;44-189;1628;1154;1145;694;451
6;240504;240500;44-144;2284;1687;1662;768;894
7;240504;240500;44-144;363;243;242;114;128
8;240504;240500;44-145;68;54;54;22;32
1;240505;240500;44-160;1146;725;716;399;317
2;240505;240500;44-160;834;545;541;247;294
3;240505;240500;44-160;884;593;585;351;234
4;240505;240500;44-164;765;599;593;225;368
5;240505;240500;44-164;487;331;326;146;180
6;240505;240500;44-120;672;382;379;216;163
7;240505;240500;44-171;430;279;274;129;145
8;240505;240500;44-171;660;372;366;188;178
9;240505;240500;44-172;512;301;296;165;131
10;240505;240500;44-172;329;202;197;126;71
11;240505;240500;44-160;290;204;204;137;67
12;240505;240500;44-109;201;134;134;59;75
13;240505;240500;44-172;233;152;151;110;41
14;240505;240500;44-172;300;196;194;142;52
15;240505;240500;44-172;254;181;179;81;98
16;240505;240500;44-160;314;174;174;100;74
1;240506;240500;44-153;729;460;455;216;239
2;240506;240500;44-153;611;340;339;154;185
3;240506;240500;44-156;907;584;580;320;260
4;240506;240500;44-153;853;540;536;292;244
5;240506;240500;44-153;555;353;353;206;147
6;240506;240500;44-153;1070;813;807;283;524
7;240506;240500;44-156;571;372;370;203;167
8;240506;240500;44-153;542;365;365;142;223
9;240506;240500;44-153;867;563;557;201;356
1;240507;240500;44-180;1410;974;964;498;466
2;240507;240500;44-180;1206;757;748;356;392
3;240507;240500;44-180;911;549;547;340;207
4;240507;240500;44-180;924;543;542;348;194
5;240507;240500;44-180;1044;591;584;349;235
6;240507;240500;44-120;893;500;496;280;216
7;240507;240500;44-120;558;363;359;183;176
8;240507;240500;44-180;366;146;141;72;69
1;240508;240500;44-187;1719;1054;1044;612;432
2;240508;240500;44-187;361;224;222;146;76
3;240508;240500;44-187;383;238;236;127;109
4;240508;240500;44-187;202;120;119;85;34
5;240508;240500;44-187;796;488;484;343;141
6;240508;240500;44-187;307;181;180;140;40
7;240508;240500;44-187;231;138;138;75;63
8;240508;240500;44-187;192;131;128;60;68
9;240508;240500;44-187;222;147;143;90;53
10;240508;240500;44-187;85;34;32;19;13
1;240601;240600;42-100;2373;1787;1767;746;1021
2;240601;240600;42-100;1170;874;872;376;496
3;240601;240600;42-100;1509;1061;1046;455;591
4;240601;240600;42-100;828;529;525;243;282
5;240601;240600;42-100;1509;1035;1028;492;536
6;240601;240600;42-100;1688;1176;1170;571;599
7;240601;240600;42-100;408;314;311;185;126
8;240601;240600;42-125;551;371;370;214;156
9;240601;240600;42-125;1663;1208;1197;708;489
10;240601;240600;42-125;1130;817;807;463;344
11;240601;240600;42-125;1396;959;943;554;389
12;240601;240600;42-100;604;395;393;191;202
13;240601;240600;42-125;290;217;214;133;81
14;240601;240600;42-125;241;191;187;130;57
15;240601;240600;42-100;7;3;3;1;2
1;240602;240600;42-160;922;667;664;336;328
2;240602;240600;42-160;1312;899;891;491;400
3;240602;240600;42-160;292;201;198;136;62
4;240602;240600;42-160;903;625;617;357;260
5;240602;240600;42-160;533;350;348;223;125
6;240602;240600;42-161;1247;851;846;499;347
7;240602;240600;42-160;617;440;437;286;151
8;240602;240600;42-160;956;625;620;412;208
9;240602;240600;42-160;10;5;5;3;2
1;240603;240600;42-165;1629;1114;1100;665;435
2;240603;240600;42-164;1488;1029;1022;687;335
3;240603;240600;42-165;773;539;535;413;122
4;240603;240600;42-165;511;346;342;243;99
5;240603;240600;42-165;401;277;272;179;93
1;240604;240600;42-120;681;514;504;293;211
2;240604;240600;42-120;1151;786;774;515;259
3;240604;240600;42-120;735;523;521;356;165
4;240604;240600;42-122;841;626;621;453;168
5;240604;240600;42-122;990;740;722;540;182
6;240604;240600;42-120;595;380;376;248;128
7;240604;240600;42-120;382;261;259;176;83
8;240604;240600;42-120;279;185;178;122;56
9;240604;240600;42-120;237;164;162;109;53
1;240605;240600;42-152;899;624;622;371;251
2;240605;240600;42-152;442;270;269;164;105
3;240605;240600;42-152;685;460;456;337;119
4;240605;240600;42-151;899;660;654;340;314
5;240605;240600;42-152;832;532;528;294;234
6;240605;240600;42-151;926;594;585;373;212
7;240605;240600;42-152;481;307;301;219;82
1;240606;240600;42-140;940;673;672;304;368
2;240606;240600;42-140;1177;802;795;427;368
3;240606;240600;42-140;705;487;480;275;205
4;240606;240600;42-140;1064;731;728;468;260
1;240607;240600;42-110;1228;816;808;449;359
2;240607;240600;42-110;607;385;383;271;112
3;240607;240600;42-110;740;474;471;327;144
4;240607;240600;42-110;659;416;415;303;112
5;240607;240600;42-110;988;720;714;368;346
6;240607;240600;42-110;402;278;267;183;84
7;240607;240600;42-110;69;68;67;13;54
1;240608;240600;42-141;1741;1243;1236;646;590
2;240608;240600;42-141;864;529;527;346;181
3;240608;240600;42-142;768;486;482;317;165
4;240608;240600;42-142;576;432;430;268;162
5;240608;240600;42-141;324;212;210;135;75
6;240608;240600;42-141;299;193;193;119;74
1;240609;240600;42-130;2192;1629;1607;677;930
2;240609;240600;42-130;1001;732;727;387;340
3;240609;240600;42-133;1210;783;774;440;334
4;240609;240600;42-130;1592;1088;1076;580;496
5;240609;240600;42-133;1828;1254;1245;778;467
6;240609;240600;42-134;1100;690;686;363;323
7;240609;240600;42-134;468;299;297;204;93
8;240609;240600;42-134;2646;1745;1732;1021;711
9;240609;240600;42-130;470;318;309;175;134
10;240609;240600;42-133;599;407;406;269;137
11;240609;240600;42-130;736;508;506;289;217
1;240701;240700;42-700;1483;1066;1050;494;556
2;240701;240700;42-700;1001;681;673;360;313
3;240701;240700;42-700;275;198;196;114;82
4;240701;240700;42-700;1515;1074;1060;591;469
5;240701;240700;42-700;731;499;492;183;309
6;240701;240700;42-700;779;485;482;214;268
7;240701;240700;42-700;1477;883;872;459;413
8;240701;240700;42-700;1322;971;961;420;541
9;240701;240700;42-700;2542;1864;1848;912;936
10;240701;240700;42-700;1873;1340;1315;632;683
11;240701;240700;42-700;1219;871;851;426;425
12;240701;240700;42-700;771;510;503;243;260
13;240701;240700;42-700;1710;1255;1244;636;608
14;240701;240700;42-700;165;79;66;41;25
15;240701;240700;42-700;192;141;141;23;118
16;240701;240700;42-700;11;4;4;1;3
17;240701;240700;42-700;387;123;122;82;40
18;240701;240700;42-700;164;56;54;31;23
19;240701;240700;42-700;26;21;20;8;12
1;240702;240700;42-283;1290;856;848;507;341
2;240702;240700;42-283;1353;892;876;574;302
1;240703;240700;42-793;1240;718;716;388;328
2;240703;240700;42-793;722;433;430;283;147
3;240703;240700;42-793;1238;644;638;363;275
4;240703;240700;42-793;453;198;195;142;53
5;240703;240700;42-793;797;400;397;266;131
6;240703;240700;42-793;216;123;120;74;46
7;240703;240700;42-793;398;196;194;131;63
8;240703;240700;42-793;262;122;118;50;68
9;240703;240700;42-793;401;213;209;130;79
10;240703;240700;42-793;550;385;380;68;312
1;240704;240700;42-284;1724;1173;1157;542;615
2;240704;240700;42-284;552;373;368;254;114
3;240704;240700;42-714;1892;1208;1198;677;521
4;240704;240700;42-714;514;307;306;187;119
5;240704;240700;42-284;355;223;219;113;106
6;240704;240700;42-284;331;305;299;55;244
1;240705;240700;42-700;328;189;188;119;69
2;240705;240700;42-700;444;294;294;192;102
3;240705;240700;42-713;1675;1030;1026;691;335
4;240705;240700;42-713;1486;874;866;570;296
5;240705;240700;42-700;586;358;356;205;151
6;240705;240700;42-713;480;257;255;185;70
7;240705;240700;42-700;200;112;112;83;29
8;240705;240700;42-713;179;128;127;91;36
9;240705;240700;42-713;92;87;86;48;38
1;240706;240700;42-286;1787;1177;1170;681;489
2;240706;240700;42-286;1977;1364;1354;699;655
3;240706;240700;42-288;1550;1052;1045;635;410
4;240706;240700;42-288;1101;665;661;435;226
5;240706;240700;42-700;1436;893;881;557;324
6;240706;240700;42-700;1287;906;900;623;277
1;240707;240700;42-772;1134;695;686;464;222
2;240707;240700;42-772;478;278;277;183;94
3;240707;240700;42-700;834;515;512;361;151
4;240707;240700;42-772;571;379;374;231;143
5;240707;240700;42-772;595;291;287;178;109
6;240707;240700;42-772;505;252;250;124;126
7;240707;240700;42-700;185;107;107;85;22
8;240707;240700;42-772;184;103;103;59;44
9;240707;240700;42-772;281;144;141;99;42
10;240707;240700;42-700;306;232;228;134;94
1;240708;240700;42-289;1112;745;741;446;295
2;240708;240700;42-289;1136;732;729;445;284
3;240708;240700;42-289;645;442;437;300;137
4;240708;240700;42-287;1000;700;689;399;290
5;240708;240700;42-287;675;448;446;325;121
6;240708;240700;42-287;747;488;481;309;172
7;240708;240700;42-287;247;170;170;115;55
8;240708;240700;42-287;496;351;348;238;110
9;240708;240700;42-289;352;246;245;141;104
10;240708;240700;42-287;857;554;551;350;201
1;240801;240800;43-173;1123;850;830;354;476
2;240801;240800;43-173;923;701;693;317;376
3;240801;240800;43-173;844;558;550;329;221
4;240801;240800;43-173;899;580;572;312;260
5;240801;240800;43-173;1039;754;750;389;361
6;240801;240800;43-173;1006;682;675;374;301
7;240801;240800;43-173;1038;718;711;372;339
8;240801;240800;43-170;1038;732;726;356;370
9;240801;240800;43-170;1115;852;843;427;416
10;240801;240800;43-170;938;787;776;303;473
11;240801;240800;43-170;1126;797;793;413;380
12;240801;240800;43-170;1116;839;834;413;421
13;240801;240800;43-170;1142;809;805;334;471
14;240801;240800;43-170;1044;749;739;422;317
15;240801;240800;43-170;1105;753;750;373;377
1;240802;240800;43-190;928;614;610;314;296
2;240802;240800;43-190;1139;855;847;353;494
3;240802;240800;43-190;911;691;687;302;385
4;240802;240800;43-190;731;483;477;234;243
5;240802;240800;43-190;1066;770;767;329;438
6;240802;240800;43-190;1427;1048;1035;473;562
7;240802;240800;43-190;1770;1362;1346;453;893
8;240802;240800;43-190;1813;1336;1330;488;842
9;240802;240800;43-190;2084;1586;1568;561;1007
10;240802;240800;43-190;1517;1088;1076;442;634
11;240802;240800;43-190;1295;834;826;404;422
12;240802;240800;43-190;1089;783;781;274;507
13;240802;240800;43-190;919;657;652;273;379
14;240802;240800;43-190;1179;901;899;314;585
15;240802;240800;43-190;1662;1359;1352;404;948
16;240802;240800;43-190;2171;1712;1695;606;1089
17;240802;240800;43-190;1940;1461;1440;585;855
18;240802;240800;43-190;1103;875;864;355;509
19;240802;240800;43-190;1438;1115;1105;576;529
20;240802;240800;43-190;2101;1624;1606;777;829
21;240802;240800;43-190;1609;1193;1174;750;424
22;240802;240800;43-190;802;642;640;260;380
23;240802;240800;43-190;81;39;37;20;17
24;240802;240800;43-190;103;25;25;12;13
25;240802;240800;43-190;121;64;63;39;24
1;240803;240800;43-180;882;642;635;336;299
2;240803;240800;43-180;905;635;626;306;320
3;240803;240800;43-180;1034;703;697;370;327
4;240803;240800;43-180;904;662;654;344;310
5;240803;240800;43-180;482;335;331;193;138
6;240803;240800;43-180;817;584;579;299;280
7;240803;240800;43-180;1026;720;715;459;256
8;240803;240800;43-180;891;655;651;388;263
9;240803;240800;43-180;1700;1251;1239;797;442
10;240803;240800;43-180;1644;1199;1184;735;449
11;240803;240800;43-180;1604;1195;1185;651;534
12;240803;240800;43-180;933;746;738;450;288
13;240803;240800;43-180;1313;925;917;550;367
14;240803;240800;43-180;973;776;770;410;360
15;240803;240800;43-180;1090;867;860;515;345
16;240803;240800;43-180;46;25;25;12;13
1;240804;240800;43-178;1552;1176;1153;758;395
2;240804;240800;43-178;1518;1082;1067;616;451
3;240804;240800;43-178;1452;1052;1040;654;386
1;240805;240800;43-175;1198;874;869;357;512
2;240805;240800;43-175;773;589;579;274;305
3;240805;240800;43-175;1232;957;941;437;504
4;240805;240800;43-176;1376;1087;1073;619;454
5;240805;240800;43-176;784;593;584;311;273
6;240805;240800;43-176;1255;979;964;490;474
1;240901;240900;42-300;904;605;597;333;264
2;240901;240900;42-300;1219;903;888;480;408
3;240901;240900;42-300;1002;656;647;355;292
4;240901;240900;42-300;969;643;637;311;326
5;240901;240900;42-300;720;481;478;258;220
6;240901;240900;42-300;1256;881;875;471;404
7;240901;240900;42-300;1345;939;930;515;415
8;240901;240900;42-300;687;470;463;280;183
9;240901;240900;42-300;1265;899;897;468;429
10;240901;240900;42-300;973;673;666;307;359
11;240901;240900;42-300;1113;713;700;360;340
12;240901;240900;42-300;1460;1037;1026;520;506
13;240901;240900;42-300;1227;795;787;473;314
14;240901;240900;42-300;1019;706;699;312;387
15;240901;240900;42-300;596;399;394;197;197
16;240901;240900;42-300;886;628;625;286;339
17;240901;240900;42-300;768;555;551;254;297
18;240901;240900;42-300;1459;975;965;597;368
19;240901;240900;42-300;998;748;745;404;341
20;240901;240900;42-300;1214;875;866;409;457
21;240901;240900;42-300;1425;973;967;555;412
22;240901;240900;42-300;145;51;51;25;26
23;240901;240900;42-300;128;26;25;9;16
1;240902;240900;42-350;930;566;558;389;169
2;240902;240900;42-350;668;441;437;310;127
3;240902;240900;42-350;1257;839;830;406;424
4;240902;240900;42-350;623;434;430;236;194
5;240902;240900;42-350;702;435;429;244;185
6;240902;240900;42-350;874;593;587;417;170
7;240902;240900;42-350;1340;973;963;564;399
8;240902;240900;42-350;1294;906;896;573;323
9;240902;240900;42-350;271;203;203;140;63
10;240902;240900;42-350;493;374;371;218;153
11;240902;240900;42-350;695;460;457;261;196
12;240902;240900;42-350;639;452;446;296;150
13;240902;240900;42-350;490;351;350;216;134
14;240902;240900;42-350;347;248;247;189;58
15;240902;240900;42-350;324;202;201;131;70
16;240902;240900;42-350;333;217;216;144;72
1;240903;240900;42-320;1180;860;854;609;245
2;240903;240900;42-320;1012;688;680;523;157
3;240903;240900;42-320;781;568;564;431;133
4;240903;240900;42-320;635;500;494;438;56
5;240903;240900;42-320;322;241;240;212;28
6;240903;240900;42-320;421;317;314;270;44
1;240904;240900;42-360;1536;1094;1088;488;600
2;240904;240900;42-360;1752;1151;1135;522;613
3;240904;240900;42-360;1053;657;656;372;284
4;240904;240900;42-360;1049;750;741;358;383
5;240904;240900;42-360;568;381;376;182;194
6;240904;240900;42-360;512;390;380;145;235
7;240904;240900;42-311;2130;1584;1577;654;923
1;240905;240900;42-310;1163;807;797;472;325
2;240905;240900;42-310;574;426;426;253;173
3;240905;240900;42-310;1244;928;916;599;317
4;240905;240900;42-310;499;348;343;185;158
5;240905;240900;42-310;642;431;427;261;166
6;240905;240900;42-310;1016;666;661;350;311
7;240905;240900;42-310;711;431;425;304;121
8;240905;240900;42-310;451;293;289;177;112
9;240905;240900;42-310;379;257;254;193;61
1;241001;241000;43-230;1203;885;872;432;440
2;241001;241000;43-230;1026;762;758;391;367
3;241001;241000;43-230;1012;747;742;377;365
4;241001;241000;43-230;1471;1101;1090;539;551
5;241001;241000;43-230;421;306;301;149;152
6;241001;241000;43-230;214;183;181;102;79
7;241001;241000;43-230;295;274;274;145;129
1;241002;241000;43-210;965;702;697;436;261
2;241002;241000;43-210;1502;1158;1140;686;454
3;241002;241000;43-210;1414;1133;1112;665;447
4;241002;241000;43-210;61;41;39;16;23
1;241003;241000;43-227;351;265;261;156;105
2;241003;241000;43-227;426;318;314;232;82
3;241003;241000;43-227;863;678;673;514;159
4;241003;241000;43-227;551;439;432;300;132
5;241003;241000;43-227;535;427;425;303;122
6;241003;241000;43-227;665;505;498;326;172
7;241003;241000;43-227;621;474;465;301;164
8;241003;241000;43-225;813;661;657;535;122
9;241003;241000;43-225;728;546;545;450;95
10;241003;241000;43-225;695;451;449;286;163
11;241003;241000;43-225;751;559;553;364;189
12;241003;241000;43-225;785;549;542;358;184
13;241003;241000;43-225;740;528;526;322;204
14;241003;241000;43-225;734;529;527;332;195
15;241003;241000;43-227;917;667;665;513;152
16;241003;241000;43-227;715;522;515;373;142
17;241003;241000;43-227;752;567;563;402;161
1;241004;241000;43-250;1010;817;805;584;221
2;241004;241000;43-250;1035;834;823;522;301
3;241004;241000;43-250;914;668;661;446;215
4;241004;241000;43-251;863;637;629;407;222
5;241004;241000;43-251;868;593;590;455;135
6;241004;241000;43-251;832;596;594;405;189
7;241004;241000;43-251;872;628;622;424;198
8;241004;241000;43-253;600;451;445;291;154
9;241004;241000;43-253;625;479;479;357;122
10;241004;241000;43-253;897;716;708;477;231
11;241004;241000;43-252;1121;823;818;545;273
12;241004;241000;43-252;522;406;404;283;121
13;241004;241000;43-254;840;663;650;472;178
14;241004;241000;43-254;740;551;542;338;204
15;241004;241000;43-254;721;543;536;413;123
16;241004;241000;43-251;375;283;282;204;78
1;241005;241000;43-200;818;566;561;269;292
2;241005;241000;43-200;1581;1206;1190;446;744
3;241005;241000;43-200;1666;1258;1241;550;691
4;241005;241000;43-200;1386;987;979;457;522
5;241005;241000;43-200;1474;1116;1108;525;583
6;241005;241000;43-200;1194;917;907;515;392
7;241005;241000;43-200;1803;1362;1351;699;652
8;241005;241000;43-200;1226;850;841;349;492
9;241005;241000;43-200;724;521;518;245;273
10;241005;241000;43-200;846;593;589;287;302
11;241005;241000;43-200;906;695;686;317;369
12;241005;241000;43-200;1297;1021;1012;444;568
13;241005;241000;43-200;1340;1016;1009;479;530
14;241005;241000;43-200;1292;962;954;393;561
15;241005;241000;43-211;1811;1373;1366;892;474
16;241005;241000;43-211;1458;1083;1068;630;438
17;241005;241000;43-211;1301;986;972;548;424
18;241005;241000;43-215;1231;926;921;575;346
19;241005;241000;43-215;1151;876;868;533;335
20;241005;241000;43-215;1633;1261;1253;808;445
21;241005;241000;43-229;1555;1176;1167;599;568
22;241005;241000;43-229;709;521;515;276;239
23;241005;241000;43-229;877;677;671;401;270
24;241005;241000;43-200;855;664;661;461;200
25;241005;241000;43-200;875;681;674;477;197
26;241005;241000;43-241;1186;900;894;573;321
27;241005;241000;43-241;1370;1051;1038;545;493
28;241005;241000;43-243;1783;1323;1309;919;390
29;241005;241000;43-243;1027;755;746;564;182
30;241005;241000;43-245;1781;1328;1311;897;414
31;241005;241000;43-241;329;224;222;114;108
32;241005;241000;43-200;374;246;245;149;96
33;241005;241000;43-200;82;56;56;34;22
1;241006;241000;43-262;1138;848;843;585;258
2;241006;241000;43-265;1060;822;816;570;246
3;241006;241000;43-265;1159;886;880;648;232
4;241006;241000;43-262;1393;1035;1021;651;370
5;241006;241000;43-267;1206;917;914;569;345
6;241006;241000;43-267;1438;1097;1074;667;407
7;241006;241000;43-267;1946;1423;1405;997;408
1;241101;241100;47-400;2028;1300;1290;767;523
2;241101;241100;47-400;2098;1442;1425;670;755
3;241101;241100;47-400;1174;660;646;353;293
4;241101;241100;47-400;445;241;238;153;85
5;241101;241100;47-400;1886;1199;1187;556;631
6;241101;241100;47-400;2370;1411;1405;629;776
7;241101;241100;47-400;1379;823;816;399;417
8;241101;241100;47-400;1033;655;651;298;353
9;241101;241100;47-400;1739;1097;1086;496;590
10;241101;241100;47-400;1578;1113;1107;474;633
11;241101;241100;47-400;998;738;731;350;381
12;241101;241100;47-400;1463;1022;1018;465;553
13;241101;241100;47-400;1292;891;885;408;477
14;241101;241100;47-400;1616;1056;1044;507;537
15;241101;241100;47-400;1614;1031;1013;449;564
16;241101;241100;47-400;1330;833;825;408;417
17;241101;241100;47-400;1375;873;864;369;495
18;241101;241100;47-400;1438;900;888;387;501
19;241101;241100;47-400;1929;1119;1101;580;521
20;241101;241100;47-400;1437;964;958;397;561
21;241101;241100;47-400;1723;1180;1170;470;700
22;241101;241100;47-400;1336;759;745;379;366
23;241101;241100;47-400;1340;843;841;395;446
24;241101;241100;47-400;1267;852;843;366;477
25;241101;241100;47-400;592;334;330;213;117
26;241101;241100;47-400;179;100;94;55;39
27;241101;241100;47-400;130;50;48;27;21
28;241101;241100;47-400;703;535;531;87;444
29;241101;241100;47-400;111;73;71;59;12
1;241102;241100;44-285;912;591;583;384;199
2;241102;241100;44-285;686;434;431;305;126
3;241102;241100;44-285;487;353;349;225;124
4;241102;241100;44-285;1034;730;727;489;238
5;241102;241100;44-285;859;567;563;346;217
1;241103;241100;47-470;537;258;258;145;113
2;241103;241100;47-470;873;446;439;276;163
3;241103;241100;47-470;1158;628;625;329;296
4;241103;241100;47-470;803;420;416;193;223
5;241103;241100;47-470;301;183;182;100;82
6;241103;241100;47-475;657;369;369;213;156
1;241104;241100;47-451;2053;994;987;445;542
2;241104;241100;47-450;1462;843;835;449;386
3;241104;241100;47-460;653;339;337;172;165
4;241104;241100;47-451;916;488;486;213;273
5;241104;241100;47-450;592;312;311;152;159
6;241104;241100;47-460;584;302;300;173;127
7;241104;241100;47-460;1271;769;767;368;399
8;241104;241100;47-450;312;217;214;128;86
9;241104;241100;47-451;350;188;187;112;75
10;241104;241100;47-450;252;154;148;107;41
1;241105;241100;47-420;1043;536;526;242;284
2;241105;241100;47-420;1088;560;553;244;309
3;241105;241100;47-420;1430;802;799;362;437
4;241105;241100;47-420;559;281;279;142;137
5;241105;241100;47-430;2199;1279;1265;642;623
6;241105;241100;47-430;350;226;225;131;94
7;241105;241100;47-420;618;321;317;155;162
8;241105;241100;47-430;457;262;257;188;69
9;241105;241100;47-420;177;83;79;44;35
10;241105;241100;47-420;463;271;269;132;137
1;241106;241100;47-440;607;361;358;208;150
2;241106;241100;47-440;760;542;537;283;254
3;241106;241100;47-440;564;296;289;157;132
4;241106;241100;47-440;848;457;451;244;207
5;241106;241100;47-440;704;380;371;205;166
6;241106;241100;47-440;222;162;161;92;69
7;241106;241100;47-440;964;561;556;304;252
8;241106;241100;47-440;312;165;164;101;63
9;241106;241100;47-440;319;158;157;101;56
1;241107;241100;47-480;2055;1220;1199;692;507
2;241107;241100;47-480;514;306;305;183;122
3;241107;241100;47-480;743;355;355;193;162
4;241107;241100;47-480;494;262;256;160;96
5;241107;241100;47-480;579;314;312;174;138
6;241107;241100;47-470;485;280;279;150;129
7;241107;241100;47-480;311;184;183;112;71
1;241108;241100;47-411;869;516;514;311;203
2;241108;241100;47-411;320;210;209;162;47
3;241108;241100;47-411;502;220;218;140;78
4;241108;241100;47-411;254;125;125;61;64
5;241108;241100;47-411;478;215;215;130;85
6;241108;241100;47-411;205;132;131;94;37
7;241108;241100;47-411;296;156;155;89;66
8;241108;241100;47-411;485;285;282;173;109
9;241108;241100;47-411;437;218;218;123;95
1;241201;241200;44-238;1229;829;822;494;328
2;241201;241200;44-238;1218;789;783;494;289
3;241201;241200;44-238;1269;841;830;531;299
4;241201;241200;44-238;1366;940;932;546;386
5;241201;241200;44-238;1154;814;806;503;303
6;241201;241200;44-238;1843;1383;1369;828;541
7;241201;241200;44-230;1593;937;929;633;296
8;241201;241200;44-230;1496;1028;1024;640;384
9;241201;241200;44-230;1317;904;894;495;399
10;241201;241200;44-230;1022;748;746;425;321
11;241201;241200;44-230;1272;907;900;516;384
12;241201;241200;44-230;1629;1156;1140;726;414
13;241201;241200;44-230;1497;1134;1125;708;417
14;241201;241200;44-230;1666;1230;1215;760;455
15;241201;241200;44-237;1109;732;725;473;252
16;241201;241200;44-237;1454;1027;1016;624;392
17;241201;241200;44-213;2065;1495;1484;886;598
18;241201;241200;44-246;1132;789;778;527;251
19;241201;241200;44-238;1293;932;923;601;322
20;241201;241200;44-237;1970;1470;1456;877;579
21;241201;241200;44-246;1367;1009;999;604;395
1;241202;241200;44-293;1448;1040;1024;622;402
2;241202;241200;44-293;892;654;640;367;273
3;241202;241200;44-293;786;565;559;323;236
4;241202;241200;44-293;1059;688;684;393;291
5;241202;241200;44-293;923;642;637;368;269
6;241202;241200;44-282;1775;1215;1206;716;490
7;241202;241200;44-282;563;382;379;251;128
1;241203;241200;44-290;948;695;689;421;268
2;241203;241200;44-290;1114;845;826;547;279
3;241203;241200;44-290;1099;819;809;496;313
1;241204;241200;47-435;727;491;483;321;162
2;241204;241200;44-295;627;442;437;245;192
3;241204;241200;44-295;388;259;257;155;102
4;241204;241200;44-295;1376;974;966;522;444
5;241204;241200;44-295;349;258;257;149;108
6;241204;241200;44-284;747;543;537;339;198
7;241204;241200;47-435;823;537;527;283;244
8;241204;241200;44-295;757;526;525;263;262
9;241204;241200;44-292;1171;816;798;465;333
10;241204;241200;47-435;490;336;332;191;141
11;241204;241200;44-295;84;31;27;20;7
1;241205;241200;44-266;1950;1494;1481;980;501
2;241205;241200;44-266;1429;1060;1055;754;301
3;241205;241200;44-266;1716;1241;1231;910;321
4;241205;241200;44-266;1114;815;808;614;194
5;241205;241200;44-264;1762;1236;1227;821;406
6;241205;241200;44-264;1390;1058;1042;670;372
1;241301;241300;42-660;1586;896;881;466;415
2;241301;241300;42-660;625;343;341;162;179
3;241301;241300;42-660;2049;1321;1305;732;573
4;241301;241300;42-660;571;374;370;190;180
5;241301;241300;42-660;1703;1080;1069;565;504
1;241302;241300;42-610;1403;969;961;565;396
2;241302;241300;42-610;1148;779;777;461;316
3;241302;241300;42-610;961;595;589;383;206
4;241302;241300;42-610;1383;952;944;581;363
5;241302;241300;42-610;412;319;319;251;68
1;241303;241300;41-922;1320;801;790;461;329
2;241303;241300;41-922;1660;1245;1236;530;706
3;241303;241300;41-922;783;462;460;265;195
4;241303;241300;41-922;1673;1188;1176;647;529
5;241303;241300;41-922;1520;1167;1157;559;598
6;241303;241300;41-922;1762;1288;1280;673;607
7;241303;241300;41-922;2097;1572;1562;891;671
8;241303;241300;41-922;1454;1023;1013;543;470
1;241304;241300;42-609;1068;749;745;436;309
2;241304;241300;42-609;1618;1129;1114;542;572
3;241304;241300;42-609;1080;757;750;401;349
4;241304;241300;42-609;1135;780;768;371;397
5;241304;241300;42-600;1338;901;891;469;422
6;241304;241300;42-600;1683;1183;1168;514;654
7;241304;241300;42-600;1949;1427;1414;637;777
8;241304;241300;42-606;1599;1210;1199;492;707
9;241304;241300;42-606;1623;1153;1130;453;677
10;241304;241300;42-605;1653;1126;1119;535;584
11;241304;241300;42-605;1701;1285;1267;634;633
12;241304;241300;42-603;2371;1808;1771;687;1084
13;241304;241300;42-680;2341;1737;1722;746;976
14;241304;241300;42-600;1404;1137;1131;427;704
15;241304;241300;42-612;2479;1927;1907;690;1217
16;241304;241300;42-612;2277;1733;1724;661;1063
17;241304;241300;42-612;1465;1054;1046;427;619
18;241304;241300;42-612;1503;1102;1089;460;629
19;241304;241300;42-612;1654;1272;1263;530;733
20;241304;241300;42-600;1686;1202;1197;490;707
21;241304;241300;42-600;1853;1410;1401;473;928
22;241304;241300;42-600;2593;1884;1863;688;1175
23;241304;241300;42-600;1788;1077;1056;454;602
24;241304;241300;42-600;1564;927;910;390;520
25;241304;241300;42-600;1939;1414;1404;616;788
26;241304;241300;42-600;1757;1137;1125;520;605
27;241304;241300;42-609;49;40;39;26;13
28;241304;241300;42-606;41;16;16;5;11
29;241304;241300;42-600;367;281;277;57;220
30;241304;241300;42-612;119;53;51;40;11
31;241304;241300;42-612;95;41;41;18;23
32;241304;241300;42-612;481;346;337;180;157
1;241305;241300;42-693;642;445;441;245;196
2;241305;241300;42-693;494;359;354;152;202
3;241305;241300;42-693;459;284;279;203;76
4;241305;241300;42-693;821;588;582;277;305
1;241306;241300;42-625;825;619;613;229;384
2;241306;241300;42-625;973;667;662;432;230
3;241306;241300;42-625;1414;1027;1013;548;465
4;241306;241300;42-624;1705;1267;1251;555;696
1;241307;241300;42-620;1199;794;788;339;449
2;241307;241300;42-620;1997;1369;1360;602;758
3;241307;241300;42-622;1540;1089;1080;445;635
4;241307;241300;42-622;1757;1251;1244;677;567
5;241307;241300;42-622;2103;1562;1548;713;835
6;241307;241300;42-622;1254;910;906;415;491
1;241308;241300;42-690;952;627;617;335;282
2;241308;241300;42-690;1007;588;579;290;289
3;241308;241300;42-690;663;451;450;235;215
4;241308;241300;42-690;737;523;515;258;257
5;241308;241300;42-690;1336;921;915;487;428
6;241308;241300;42-690;442;320;318;153;165
7;241308;241300;42-690;479;315;310;169;141
8;241308;241300;42-690;566;388;385;271;114
9;241308;241300;42-690;314;184;184;146;38
1;241309;241300;42-674;2195;1567;1552;601;951
2;241309;241300;42-674;454;273;270;112;158
3;241309;241300;42-676;798;511;507;295;212
4;241309;241300;42-674;699;440;434;192;242
5;241309;241300;42-674;637;389;387;231;156
6;241309;241300;42-674;608;420;414;190;224
7;241309;241300;42-675;746;492;484;205;279
8;241309;241300;42-677;671;417;411;215;196
9;241309;241300;42-672;1955;1227;1221;615;606
10;241309;241300;42-675;422;262;260;105;155
11;241309;241300;42-674;303;202;201;66;135
12;241309;241300;42-674;363;200;197;96;101
13;241309;241300;42-674;330;213;209;121;88
14;241309;241300;42-674;184;111;110;59;51
15;241309;241300;42-674;470;253;253;156;97
16;241309;241300;42-675;679;426;419;193;226
17;241309;241300;42-677;634;548;543;166;377
18;241309;241300;42-674;51;26;24;11;13
19;241309;241300;42-676;21;21;21;4;17
1;241401;241400;43-150;1281;909;896;540;356
2;241401;241400;43-150;1140;814;804;520;284
3;241401;241400;43-150;831;524;516;395;121
4;241401;241400;43-150;738;479;466;314;152
5;241401;241400;43-150;1110;816;811;486;325
6;241401;241400;43-150;1252;927;918;591;327
7;241401;241400;43-155;1167;868;862;554;308
8;241401;241400;43-155;818;567;560;306;254
9;241401;241400;43-155;886;645;642;351;291
10;241401;241400;43-155;905;661;656;375;281
11;241401;241400;43-155;706;488;480;298;182
12;241401;241400;43-155;791;576;573;286;287
13;241401;241400;43-155;856;638;636;413;223
14;241401;241400;43-155;834;618;611;378;233
15;241401;241400;43-155;858;610;605;392;213
1;241402;241400;41-407;1840;1338;1329;712;617
2;241402;241400;41-407;1936;1480;1463;720;743
3;241402;241400;41-407;1612;1201;1184;637;547
4;241402;241400;41-407;1720;1247;1238;719;519
1;241403;241400;43-143;1339;960;948;600;348
2;241403;241400;43-143;775;576;572;363;209
3;241403;241400;43-143;1287;995;985;698;287
4;241403;241400;43-143;1220;793;780;535;245
5;241403;241400;43-143;1004;685;678;431;247
6;241403;241400;43-140;1514;1102;1094;714;380
7;241403;241400;43-140;1092;809;796;550;246
8;241403;241400;43-140;1081;852;846;519;327
9;241403;241400;43-143;1373;944;936;651;285
10;241403;241400;43-144;400;328;325;250;75
11;241403;241400;43-144;846;618;613;421;192
1;241404;241400;43-220;913;729;724;467;257
2;241404;241400;43-220;780;611;604;428;176
3;241404;241400;43-220;822;660;655;402;253
4;241404;241400;43-220;345;253;250;178;72
5;241404;241400;43-220;713;563;557;363;194
6;241404;241400;43-220;1101;866;858;609;249
7;241404;241400;43-220;420;323;316;157;159
8;241404;241400;43-220;813;641;633;376;257
9;241404;241400;43-220;362;276;274;201;73
1;241405;241400;41-403;1549;1168;1154;666;488
2;241405;241400;41-403;2122;1554;1535;925;610
3;241405;241400;41-403;1068;793;784;511;273
1;241501;241500;44-370;2025;1401;1385;757;628
2;241501;241500;44-370;1639;980;976;605;371
3;241501;241500;44-370;2239;1594;1578;947;631
4;241501;241500;44-370;1876;1198;1182;802;380
5;241501;241500;44-370;2059;1465;1448;925;523
1;241502;241500;44-310;1785;1218;1212;783;429
2;241502;241500;44-310;1652;1169;1163;611;552
3;241502;241500;44-310;895;592;587;311;276
4;241502;241500;44-310;1821;1289;1278;631;647
5;241502;241500;44-310;1540;1054;1041;511;530
6;241502;241500;44-310;779;576;574;244;330
7;241502;241500;44-310;1578;1048;1040;541;499
8;241502;241500;44-310;1617;997;984;609;375
9;241502;241500;44-310;802;543;535;269;266
1;241503;241500;44-280;905;645;642;386;256
2;241503;241500;44-280;944;713;709;407;302
3;241503;241500;44-280;1130;796;792;531;261
4;241503;241500;44-280;885;604;601;350;251
5;241503;241500;44-280;1079;715;708;459;249
6;241503;241500;44-280;939;637;627;351;276
7;241503;241500;44-280;981;649;643;386;257
8;241503;241500;44-280;827;503;494;299;195
9;241503;241500;44-280;982;686;678;373;305
10;241503;241500;44-280;1001;676;667;375;292
11;241503;241500;44-280;980;645;637;361;276
12;241503;241500;44-280;1040;701;696;395;301
13;241503;241500;44-280;1084;728;721;406;315
14;241503;241500;44-280;930;620;613;347;266
15;241503;241500;44-280;1112;798;790;415;375
16;241503;241500;44-280;30;27;27;13;14
1;241504;241500;44-300;1324;900;889;432;457
2;241504;241500;44-300;1422;1064;1057;460;597
3;241504;241500;44-300;1395;1074;1064;515;549
4;241504;241500;44-300;1721;1024;1018;636;382
5;241504;241500;44-300;1645;1007;1001;582;419
6;241504;241500;44-300;1255;861;851;430;421
7;241504;241500;44-300;1696;1063;1054;589;465
8;241504;241500;44-286;1492;1008;1005;507;498
9;241504;241500;44-286;1344;977;966;435;531
10;241504;241500;44-286;1659;1218;1207;554;653
11;241504;241500;44-286;1135;796;791;380;411
12;241504;241500;44-286;1468;1038;1034;497;537
13;241504;241500;44-300;1171;751;746;441;305
14;241504;241500;44-300;1178;872;860;403;457
15;241504;241500;44-300;1255;911;903;507;396
16;241504;241500;44-304;1546;1153;1146;648;498
17;241504;241500;44-304;1503;1120;1101;737;364
18;241504;241500;44-304;1619;1072;1068;664;404
19;241504;241500;44-373;1827;1306;1297;764;533
20;241504;241500;44-373;1885;1301;1291;850;441
21;241504;241500;44-313;1578;1126;1109;601;508
22;241504;241500;44-313;1391;960;953;552;401
23;241504;241500;44-313;1247;860;853;542;311
24;241504;241500;44-300;127;79;77;45;32
25;241504;241500;44-300;50;28;28;18;10
1;241505;241500;44-340;731;540;535;320;215
2;241505;241500;44-340;756;519;517;331;186
3;241505;241500;44-341;724;499;495;321;174
4;241505;241500;44-341;709;544;539;343;196
5;241505;241500;44-341;919;697;691;466;225
6;241505;241500;44-341;842;636;633;404;229
7;241505;241500;44-348;486;335;334;236;98
8;241505;241500;44-348;494;359;356;240;116
9;241505;241500;44-340;689;495;493;321;172
10;241505;241500;44-340;677;503;498;287;211
11;241505;241500;44-341;739;578;566;368;198
12;241505;241500;44-348;785;579;575;375;200
13;241505;241500;44-348;692;494;489;293;196
14;241505;241500;44-348;720;510;506;317;189
15;241505;241500;44-348;672;489;487;357;130
16;241505;241500;44-348;53;18;18;5;13
1;241506;241500;44-362;935;648;648;425;223
2;241506;241500;44-362;745;531;529;333;196
3;241506;241500;44-352;1351;971;955;582;373
4;241506;241500;44-352;1394;978;970;550;420
5;241506;241500;44-350;1764;1194;1185;607;578
6;241506;241500;44-350;524;382;377;276;101
7;241506;241500;44-350;1346;890;882;582;300
8;241506;241500;44-350;862;566;560;361;199
9;241506;241500;44-362;288;184;184;117;67
10;241506;241500;44-353;1188;758;751;446;305
11;241506;241500;44-362;1332;885;878;618;260
12;241506;241500;44-362;1147;782;780;510;270
13;241506;241500;44-351;1434;1029;1021;623;398
14;241506;241500;44-351;1349;1004;987;571;416
15;241506;241500;44-350;248;185;180;124;56
16;241506;241500;44-350;196;91;88;51;37
17;241506;241500;44-350;172;105;104;69;35
1;241507;241500;44-360;1590;999;995;681;314
2;241507;241500;44-360;1201;745;735;517;218
3;241507;241500;44-360;249;160;159;128;31
4;241507;241500;44-361;1037;693;686;422;264
5;241507;241500;44-361;1271;855;848;439;409
6;241507;241500;44-360;295;215;214;169;45
7;241507;241500;44-360;196;116;115;72;43
1;241508;241500;44-321;947;704;695;442;253
2;241508;241500;44-321;931;674;670;445;225
3;241508;241500;44-321;938;660;655;470;185
4;241508;241500;44-321;1277;939;932;563;369
1;241509;241500;44-325;1628;1201;1195;804;391
2;241509;241500;44-325;1433;1055;1049;769;280
3;241509;241500;44-323;1992;1552;1536;1210;326
4;241509;241500;44-323;831;613;607;445;162
1;241601;241600;42-480;608;418;414;181;233
2;241601;241600;42-480;1071;731;724;321;403
3;241601;241600;42-480;1181;799;793;330;463
4;241601;241600;42-480;990;677;672;240;432
5;241601;241600;42-480;1119;833;826;331;495
6;241601;241600;42-480;815;582;574;275;299
7;241601;241600;42-480;570;408;402;261;141
8;241601;241600;42-450;230;147;144;43;101
1;241602;241600;42-400;930;656;655;295;360
2;241602;241600;42-400;800;572;569;220;349
3;241602;241600;42-400;871;615;612;261;351
4;241602;241600;42-400;1029;745;738;330;408
5;241602;241600;42-400;1257;818;814;392;422
6;241602;241600;42-400;655;466;463;201;262
7;241602;241600;42-400;879;626;623;241;382
8;241602;241600;42-400;868;593;590;263;327
9;241602;241600;42-400;1303;875;862;409;453
10;241602;241600;42-400;705;485;483;295;188
11;241602;241600;42-400;686;512;503;275;228
12;241602;241600;42-400;975;722;712;380;332
13;241602;241600;42-400;1035;725;721;413;308
14;241602;241600;42-400;719;540;533;228;305
15;241602;241600;42-400;832;635;630;228;402
16;241602;241600;42-400;864;554;544;271;273
17;241602;241600;42-400;795;540;533;244;289
18;241602;241600;42-400;730;430;427;214;213
19;241602;241600;42-400;950;640;634;301;333
20;241602;241600;42-400;998;636;628;330;298
21;241602;241600;42-400;930;617;611;308;303
22;241602;241600;42-400;1084;777;770;408;362
23;241602;241600;42-400;774;538;530;233;297
24;241602;241600;42-400;849;649;645;267;378
25;241602;241600;42-400;913;645;642;283;359
26;241602;241600;42-400;734;440;436;213;223
27;241602;241600;42-400;704;442;434;212;222
28;241602;241600;42-400;1222;872;868;423;445
29;241602;241600;42-400;550;431;431;268;163
30;241602;241600;42-400;816;585;582;272;310
31;241602;241600;42-400;881;626;613;277;336
32;241602;241600;42-400;1358;974;966;523;443
33;241602;241600;42-400;891;615;611;292;319
34;241602;241600;42-400;1098;546;541;311;230
35;241602;241600;42-400;1140;802;795;384;411
36;241602;241600;42-400;943;646;645;293;352
37;241602;241600;42-400;726;500;499;225;274
38;241602;241600;42-400;840;560;555;270;285
39;241602;241600;42-400;1002;703;698;290;408
40;241602;241600;42-400;112;49;46;27;19
41;241602;241600;42-400;210;67;66;33;33
42;241602;241600;42-400;20;16;16;4;12
1;241603;241600;42-446;797;569;563;451;112
2;241603;241600;42-446;231;157;157;105;52
3;241603;241600;42-446;438;340;338;305;33
4;241603;241600;42-446;336;227;227;164;63
5;241603;241600;42-446;338;254;248;172;76
1;241604;241600;42-425;1602;1168;1163;593;570
2;241604;241600;42-425;492;334;328;285;43
3;241604;241600;42-425;1203;821;812;591;221
4;241604;241600;42-425;524;377;370;218;152
5;241604;241600;42-425;1069;733;729;402;327
6;241604;241600;42-425;202;145;144;94;50
1;241605;241600;42-450;1500;1043;1038;470;568
2;241605;241600;42-450;1441;1077;1067;506;561
3;241605;241600;42-450;757;543;540;277;263
4;241605;241600;42-450;1220;873;861;469;392
5;241605;241600;42-454;621;406;403;252;151
6;241605;241600;42-454;1984;1460;1444;875;569
7;241605;241600;42-450;1052;738;733;366;367
8;241605;241600;42-458;542;400;391;189;202
9;241605;241600;42-457;872;569;563;345;218
10;241605;241600;42-456;1574;1127;1117;568;549
11;241605;241600;42-458;345;241;238;117;121
12;241605;241600;42-457;223;165;162;108;54
1;241606;241600;42-440;1515;1168;1161;530;631
2;241606;241600;42-440;1402;972;963;512;451
3;241606;241600;42-440;1097;742;735;393;342
4;241606;241600;42-440;828;586;585;380;205
5;241606;241600;42-440;785;570;562;306;256
6;241606;241600;42-440;963;641;636;412;224
7;241606;241600;42-440;265;201;200;115;85
8;241606;241600;42-440;385;279;278;134;144
1;241607;241600;42-439;590;437;437;341;96
2;241607;241600;42-436;577;405;405;318;87
3;241607;241600;42-436;1793;1281;1268;729;539
4;241607;241600;42-436;448;320;318;251;67
5;241607;241600;42-436;401;274;273;219;54
6;241607;241600;42-436;934;664;660;495;165
7;241607;241600;42-436;569;382;379;271;108
8;241607;241600;42-436;404;337;334;229;105
9;241607;241600;42-436;429;306;304;234;70
10;241607;241600;42-436;424;311;308;260;48
1;241608;241600;42-445;662;429;420;252;168
2;241608;241600;42-445;492;330;329;209;120
3;241608;241600;42-445;749;489;486;289;197
4;241608;241600;42-445;773;556;552;326;226
5;241608;241600;42-445;386;289;287;218;69
6;241608;241600;42-445;334;220;215;158;57
7;241608;241600;42-445;246;181;180;110;70
8;241608;241600;42-445;281;197;197;135;62
9;241608;241600;42-445;565;406;405;315;90
10;241608;241600;42-445;636;430;426;343;83
11;241608;241600;42-445;315;248;244;211;33
12;241608;241600;42-445;426;267;265;207;58
1;241609;241600;42-421;432;310;307;188;119
2;241609;241600;42-421;1260;909;899;494;405
3;241609;241600;42-421;909;628;622;375;247
4;241609;241600;42-421;375;260;258;213;45
5;241609;241600;42-421;439;318;315;207;108
6;241609;241600;42-421;274;223;220;123;97
7;241609;241600;42-421;178;129;128;82;46
8;241609;241600;42-421;260;200;199;119;80
1;241610;241600;42-439;605;458;455;332;123
2;241610;241600;42-439;729;534;529;402;127
3;241610;241600;42-439;384;252;250;189;61
4;241610;241600;42-439;289;216;216;197;19
5;241610;241600;42-439;230;161;160;129;31
6;241610;241600;42-439;424;315;315;231;84
7;241610;241600;42-439;332;249;244;204;40
8;241610;241600;42-439;175;134;133;108;25
9;241610;241600;42-439;177;144;144;126;18
10;241610;241600;42-439;192;136;135;109;26
1;241701;241700;34-300;2205;1457;1442;756;686
2;241701;241700;34-300;1522;1140;1131;503;628
3;241701;241700;34-300;1167;858;849;388;461
4;241701;241700;34-300;1988;1461;1441;674;767
5;241701;241700;34-300;1034;703;701;497;204
6;241701;241700;34-300;1212;926;921;632;289
7;241701;241700;34-300;1284;939;931;440;491
8;241701;241700;34-300;1007;754;750;335;415
9;241701;241700;34-300;1081;753;744;456;288
10;241701;241700;34-300;1335;947;939;468;471
11;241701;241700;34-300;1433;997;986;484;502
12;241701;241700;34-300;648;466;455;218;237
13;241701;241700;34-300;933;607;600;357;243
14;241701;241700;34-300;1580;1196;1182;551;631
15;241701;241700;34-300;746;541;539;309;230
16;241701;241700;34-300;1548;1144;1132;593;539
17;241701;241700;34-300;643;496;493;289;204
18;241701;241700;34-300;899;590;580;276;304
19;241701;241700;34-300;154;79;79;47;32
20;241701;241700;34-300;80;53;53;32;21
1;241702;241700;34-311;1358;1008;1002;724;278
2;241702;241700;34-312;1145;872;867;546;321
3;241702;241700;34-312;1547;1142;1133;688;445
4;241702;241700;34-312;917;672;669;425;244
5;241702;241700;34-312;115;88;86;57;29
1;241703;241700;34-322;1327;960;951;561;390
2;241703;241700;34-322;1641;1217;1209;909;300
3;241703;241700;34-322;1864;1349;1345;892;453
1;241704;241700;34-335;1041;686;681;447;234
2;241704;241700;34-335;883;610;606;401;205
3;241704;241700;34-340;1440;1041;1030;645;385
4;241704;241700;34-340;1596;1135;1127;678;449
5;241704;241700;34-340;1256;818;813;599;214
6;241704;241700;34-340;901;636;630;479;151
7;241704;241700;34-340;1129;838;836;663;173
8;241704;241700;34-335;222;146;145;111;34
9;241704;241700;34-340;344;254;251;200;51
10;241704;241700;34-340;1232;885;880;715;165
11;241704;241700;34-332;82;69;69;52;17
1;241705;241700;34-332;612;437;436;324;112
2;241705;241700;34-332;616;417;415;345;70
3;241705;241700;34-332;514;372;369;276;93
4;241705;241700;34-332;133;101;101;84;17
1;241706;241700;34-324;2279;1581;1571;797;774
2;241706;241700;34-324;1594;1153;1145;707;438
3;241706;241700;34-300;1680;1162;1152;655;497
4;241706;241700;34-324;1154;879;873;565;308
5;241706;241700;34-300;746;558;552;297;255
6;241706;241700;34-324;642;481;476;315;161
7;241706;241700;34-324;336;235;232;141;91
1;241707;241700;34-321;1772;1296;1286;925;361
2;241707;241700;34-321;749;553;550;345;205
3;241707;241700;34-321;232;154;153;90;63
4;241707;241700;34-321;695;520;513;373;140
1;241708;241700;34-325;2254;1679;1656;993;663
2;241708;241700;34-325;1616;1249;1237;714;523
3;241708;241700;34-325;2010;1451;1436;870;566
4;241708;241700;34-325;903;669;666;345;321
5;241708;241700;34-326;1100;841;838;550;288
6;241708;241700;34-326;1643;1175;1167;734;433
7;241708;241700;34-326;1916;1415;1402;811;591
1;241709;241700;34-360;2000;1472;1463;989;474
2;241709;241700;34-360;1464;1091;1083;743;340
3;241709;241700;34-383;1073;787;780;655;125
4;241709;241700;34-383;1063;803;797;693;104
5;241709;241700;34-383;602;400;397;297;100
6;241709;241700;34-360;705;463;461;355;106
7;241709;241700;34-373;793;554;552;402;150
1;241710;241700;34-382;918;677;670;482;188
2;241710;241700;34-382;750;552;550;412;138
3;241710;241700;34-382;1303;967;959;807;152
4;241710;241700;34-381;760;539;537;372;165
5;241710;241700;34-381;1394;1006;998;709;289
6;241710;241700;34-381;1993;1424;1416;951;465
7;241710;241700;34-382;1327;917;914;676;238
8;241710;241700;34-382;1442;973;967;660;307
1;241711;241700;34-370;364;244;244;163;81
2;241711;241700;34-370;1558;1010;999;626;373
3;241711;241700;34-370;559;412;406;236;170
4;241711;241700;34-370;1128;731;727;515;212
5;241711;241700;34-370;1134;761;753;594;159
6;241711;241700;34-370;896;611;607;446;161
7;241711;241700;34-370;365;275;273;181;92
8;241711;241700;34-373;630;412;408;248;160
9;241711;241700;34-370;77;34;33;25;8
1;241712;241700;34-323;1586;1184;1169;852;317
2;241712;241700;34-323;572;456;451;305;146
3;241712;241700;34-323;580;449;443;353;90
1;241713;241700;34-331;1501;1070;1059;664;395
2;241713;241700;34-331;1166;904;897;495;402
3;241713;241700;34-331;1190;880;877;667;210
4;241713;241700;34-300;1315;924;921;605;316
5;241713;241700;34-331;651;461;455;312;143
6;241713;241700;34-331;289;187;184;128;56
1;241714;241700;34-371;573;375;369;255;114
2;241714;241700;34-371;612;406;399;288;111
3;241714;241700;34-371;496;336;333;210;123
4;241714;241700;34-371;934;610;605;451;154
5;241714;241700;34-371;807;566;562;329;233
1;241715;241700;34-350;1189;864;861;622;239
2;241715;241700;34-350;1259;926;920;678;242
3;241715;241700;34-350;1523;1118;1112;557;555
4;241715;241700;34-350;1594;1176;1165;704;461
5;241715;241700;34-350;873;638;632;467;165
6;241715;241700;34-350;1459;1016;1010;796;214
7;241715;241700;34-350;1721;1251;1246;886;360
8;241715;241700;34-350;1543;1083;1075;831;244
1;246101;246100;43-300;1932;1443;1436;652;784
2;246101;246100;43-300;2502;1901;1879;986;893
3;246101;246100;43-300;1842;1338;1321;707;614
4;246101;246100;43-300;2036;1561;1543;725;818
5;246101;246100;43-300;2368;1857;1845;945;900
6;246101;246100;43-300;2293;1796;1781;893;888
7;246101;246100;43-300;2070;1473;1457;765;692
8;246101;246100;43-300;2047;1515;1509;728;781
9;246101;246100;43-300;1540;1018;1008;429;579
10;246101;246100;43-300;1412;1028;1019;419;600
11;246101;246100;43-300;2387;1753;1745;758;987
12;246101;246100;43-300;2161;1514;1501;675;826
13;246101;246100;43-300;2023;1430;1418;704;714
14;246101;246100;43-300;2097;1560;1542;710;832
15;246101;246100;43-300;1924;1468;1449;692;757
16;246101;246100;43-300;2290;1808;1801;659;1142
17;246101;246100;43-300;2197;1708;1692;744;948
18;246101;246100;43-300;1656;1202;1191;527;664
19;246101;246100;43-300;1784;1334;1327;602;725
20;246101;246100;43-300;1559;1071;1061;466;595
21;246101;246100;43-300;1812;1362;1354;591;763
22;246101;246100;43-300;1525;1086;1078;462;616
23;246101;246100;43-300;1156;835;830;321;509
24;246101;246100;43-300;1828;1453;1434;632;802
25;246101;246100;43-300;1775;1410;1401;583;818
26;246101;246100;43-300;1700;1374;1356;597;759
27;246101;246100;43-300;2219;1320;1307;617;690
28;246101;246100;43-300;1640;1211;1195;430;765
29;246101;246100;43-300;1576;1085;1078;410;668
30;246101;246100;43-300;1453;965;959;610;349
31;246101;246100;43-300;1640;1006;998;438;560
32;246101;246100;43-300;1410;1009;1000;342;658
33;246101;246100;43-300;1788;1365;1360;568;792
34;246101;246100;43-300;1632;1214;1205;481;724
35;246101;246100;43-300;1492;1066;1054;493;561
36;246101;246100;43-300;1519;1204;1178;510;668
37;246101;246100;43-300;1450;1053;1044;418;626
38;246101;246100;43-300;1383;933;925;391;534
39;246101;246100;43-300;1761;1211;1198;489;709
40;246101;246100;43-300;1730;1181;1176;518;658
41;246101;246100;43-300;1452;1073;1068;514;554
42;246101;246100;43-300;1292;929;916;391;525
43;246101;246100;43-300;1288;956;945;468;477
44;246101;246100;43-300;1490;1116;1110;531;579
45;246101;246100;43-300;1371;1048;1036;518;518
46;246101;246100;43-300;1242;873;865;397;468
47;246101;246100;43-300;2412;1905;1890;711;1179
48;246101;246100;43-300;2456;1901;1885;811;1074
49;246101;246100;43-300;2359;1853;1834;755;1079
50;246101;246100;43-300;1284;938;928;433;495
51;246101;246100;43-300;1476;1094;1083;484;599
52;246101;246100;43-300;1549;1179;1169;532;637
53;246101;246100;43-300;2144;1666;1648;715;933
54;246101;246100;43-300;2666;2091;2074;895;1179
55;246101;246100;43-300;1362;1037;1029;384;645
56;246101;246100;43-300;1803;1395;1390;579;811
57;246101;246100;43-300;1613;1182;1176;528;648
58;246101;246100;43-300;1752;1269;1250;547;703
59;246101;246100;43-300;2107;1627;1617;732;885
60;246101;246100;43-300;2098;1594;1578;677;901
61;246101;246100;43-300;2417;1835;1819;1048;771
62;246101;246100;43-300;1787;1409;1399;472;927
63;246101;246100;43-300;1964;1511;1499;494;1005
64;246101;246100;43-300;1789;1464;1446;502;944
65;246101;246100;43-300;1926;1432;1426;531;895
66;246101;246100;43-300;1982;1513;1498;537;961
67;246101;246100;43-300;1707;1326;1313;538;775
68;246101;246100;43-300;52;23;23;12;11
69;246101;246100;43-300;194;158;154;46;108
70;246101;246100;43-300;173;66;66;34;32
71;246101;246100;43-300;56;56;56;28;28
72;246101;246100;43-300;52;9;8;4;4
73;246101;246100;43-300;455;211;208;128;80
74;246101;246100;43-300;87;56;56;31;25
75;246101;246100;43-300;40;26;26;17;9
76;246101;246100;43-300;43;12;12;8;4
77;246101;246100;43-300;55;27;25;20;5
1;246201;246200;41-923;1753;1130;1117;523;594
2;246201;246200;41-923;1812;1129;1115;585;530
3;246201;246200;41-923;1385;782;765;344;421
4;246201;246200;41-923;1881;1360;1355;529;826
5;246201;246200;41-923;1866;1302;1290;556;734
6;246201;246200;41-923;1724;1235;1229;471;758
7;246201;246200;41-923;1653;1148;1140;523;617
8;246201;246200;41-923;1721;1246;1239;523;716
9;246201;246200;41-923;1401;1039;1025;424;601
10;246201;246200;41-906;894;389;383;269;114
11;246201;246200;41-906;1549;980;971;598;373
12;246201;246200;41-906;1347;864;855;498;357
13;246201;246200;41-905;1135;571;566;340;226
14;246201;246200;41-905;1204;413;401;293;108
15;246201;246200;41-907;1566;920;911;439;472
16;246201;246200;41-907;1757;1209;1202;506;696
17;246201;246200;41-907;1719;1161;1154;509;645
18;246201;246200;41-907;1538;881;876;431;445
19;246201;246200;41-907;1766;1218;1207;514;693
20;246201;246200;41-907;1487;976;963;413;550
21;246201;246200;41-907;1567;1091;1084;458;626
22;246201;246200;41-907;1729;1269;1242;543;699
23;246201;246200;41-907;669;484;479;154;325
24;246201;246200;41-909;1826;1128;1119;548;571
25;246201;246200;41-909;1724;1035;1023;518;505
26;246201;246200;41-909;1859;1307;1294;549;745
27;246201;246200;41-936;778;514;509;206;303
28;246201;246200;41-936;1277;845;841;349;492
29;246201;246200;41-936;1607;1106;1092;402;690
30;246201;246200;41-935;1266;894;883;486;397
31;246201;246200;41-935;1242;902;889;423;466
32;246201;246200;41-933;1730;1195;1180;549;631
33;246201;246200;41-933;1544;981;974;495;479
34;246201;246200;41-933;1596;980;969;516;453
35;246201;246200;41-933;1581;1029;1018;538;480
36;246201;246200;41-933;1732;1129;1122;538;584
37;246201;246200;41-933;1716;1238;1225;543;682
38;246201;246200;41-933;1560;1144;1132;479;653
39;246201;246200;41-933;1445;1002;990;445;545
40;246201;246200;41-933;1275;800;795;389;406
41;246201;246200;41-902;1815;1164;1144;433;711
42;246201;246200;41-902;1868;1226;1217;481;736
43;246201;246200;41-902;1624;1051;1037;393;644
44;246201;246200;41-902;1441;915;907;333;574
45;246201;246200;41-902;1492;930;922;397;525
46;246201;246200;41-902;1063;678;668;230;438
47;246201;246200;41-902;1480;934;926;391;535
48;246201;246200;41-902;1448;840;827;428;399
49;246201;246200;41-902;1312;734;725;377;348
50;246201;246200;41-902;1269;726;721;339;382
51;246201;246200;41-902;1169;675;667;315;352
52;246201;246200;41-902;1105;617;610;283;327
53;246201;246200;41-902;1465;1001;994;420;574
54;246201;246200;41-902;1513;969;958;384;574
55;246201;246200;41-910;1394;965;955;387;568
56;246201;246200;41-902;1761;1239;1226;525;701
57;246201;246200;41-902;1806;1309;1300;570;730
58;246201;246200;41-902;1748;1163;1150;549;601
59;246201;246200;41-902;1608;1084;1074;444;630
60;246201;246200;41-902;1489;927;917;427;490
61;246201;246200;41-902;1553;1090;1083;391;692
62;246201;246200;41-902;1428;922;912;410;502
63;246201;246200;41-902;1496;842;834;356;478
64;246201;246200;41-902;1267;838;831;360;471
65;246201;246200;41-902;1331;815;810;328;482
66;246201;246200;41-902;1525;1021;1003;392;611
67;246201;246200;41-902;1491;903;895;383;512
68;246201;246200;41-902;787;487;480;171;309
69;246201;246200;41-902;1213;767;758;359;399
70;246201;246200;41-907;1336;946;939;419;520
71;246201;246200;41-935;8;1;1;1;0
72;246201;246200;41-902;62;38;36;21;15
73;246201;246200;41-902;91;42;41;15;26
74;246201;246200;41-902;53;4;4;4;0
75;246201;246200;41-902;106;66;66;34;32
76;246201;246200;41-902;203;77;77;39;38
77;246201;246200;41-902;313;240;233;25;208
78;246201;246200;41-902;103;46;46;27;19
79;246201;246200;41-902;57;20;20;15;5
80;246201;246200;41-923;92;37;32;22;10
81;246201;246200;41-923;127;63;58;31;27
82;246201;246200;41-923;53;25;25;8;17
1;246301;246300;41-503;1616;1064;1043;464;579
2;246301;246300;41-503;1033;753;745;290;455
3;246301;246300;41-503;1432;885;879;385;494
4;246301;246300;41-500;1575;1115;1107;344;763
5;246301;246300;41-500;1146;651;649;290;359
6;246301;246300;41-500;1433;1088;1076;382;694
7;246301;246300;41-500;1305;872;863;337;526
8;246301;246300;41-500;1107;578;571;275;296
9;246301;246300;41-500;1320;989;985;380;605
10;246301;246300;41-500;1258;912;906;349;557
11;246301;246300;41-500;1507;869;864;410;454
12;246301;246300;41-500;1261;668;658;314;344
13;246301;246300;41-500;1544;987;973;419;554
14;246301;246300;41-500;1700;1188;1176;491;685
15;246301;246300;41-500;1765;1164;1156;435;721
16;246301;246300;41-500;1689;1219;1209;454;755
17;246301;246300;41-500;1672;1211;1202;479;723
18;246301;246300;41-500;1581;933;923;434;489
19;246301;246300;41-500;1577;1040;1030;435;595
20;246301;246300;41-500;1187;795;790;336;454
21;246301;246300;41-500;756;406;399;162;237
22;246301;246300;41-500;1224;897;891;298;593
23;246301;246300;41-500;1019;545;539;229;310
24;246301;246300;41-500;893;551;543;206;337
25;246301;246300;41-500;921;608;594;223;371
26;246301;246300;41-500;1320;956;940;318;622
27;246301;246300;41-500;1524;1125;1115;351;764
28;246301;246300;41-500;1613;1084;1071;403;668
29;246301;246300;41-500;1479;1015;1006;352;654
30;246301;246300;41-500;1386;1013;1001;332;669
31;246301;246300;41-500;1395;1072;1064;381;683
32;246301;246300;41-500;1265;1014;1002;337;665
33;246301;246300;41-500;1175;854;847;288;559
34;246301;246300;41-500;1357;1001;993;365;628
35;246301;246300;41-500;1508;944;936;419;517
36;246301;246300;41-500;1391;896;891;381;510
37;246301;246300;41-500;1257;853;850;344;506
38;246301;246300;41-500;962;566;561;275;286
39;246301;246300;41-506;1176;761;752;350;402
40;246301;246300;41-506;1123;601;597;255;342
41;246301;246300;41-506;1390;1002;991;382;609
42;246301;246300;41-506;1296;802;796;303;493
43;246301;246300;41-506;989;591;585;279;306
44;246301;246300;41-506;1108;777;769;301;468
45;246301;246300;41-506;1359;945;939;316;623
46;246301;246300;41-506;1083;773;768;299;469
47;246301;246300;41-506;1025;666;659;255;404
48;246301;246300;41-506;1365;976;971;398;573
49;246301;246300;41-506;1169;833;822;287;535
50;246301;246300;41-506;1593;1170;1162;407;755
51;246301;246300;41-506;1638;1157;1147;414;733
52;246301;246300;41-506;1474;1000;986;395;591
53;246301;246300;41-506;1407;940;928;360;568
54;246301;246300;41-503;691;615;610;113;497
55;246301;246300;41-500;62;35;31;21;10
56;246301;246300;41-500;57;42;41;17;24
57;246301;246300;41-500;67;10;10;6;4
58;246301;246300;41-500;109;109;106;46;60
59;246301;246300;41-500;68;36;35;20;15
60;246301;246300;41-506;61;32;28;10;18
61;246301;246300;41-500;45;44;41;27;14
62;246301;246300;41-500;37;16;16;4;12
63;246301;246300;41-500;95;39;37;6;31
64;246301;246300;41-500;143;74;69;44;25
65;246301;246300;41-500;32;25;25;10;15
1;246401;246400;42-202;890;474;471;229;242
2;246401;246400;42-202;873;513;509;244;265
3;246401;246400;42-202;379;240;238;110;128
4;246401;246400;42-202;732;472;470;198;272
5;246401;246400;42-202;823;482;478;219;259
6;246401;246400;42-202;932;535;530;271;259
7;246401;246400;42-202;1066;578;573;277;296
8;246401;246400;42-202;651;380;376;200;176
9;246401;246400;42-202;832;576;569;242;327
10;246401;246400;42-202;993;731;720;287;433
11;246401;246400;42-202;825;603;598;260;338
12;246401;246400;42-217;781;604;595;257;338
13;246401;246400;42-217;522;462;456;226;230
14;246401;246400;42-217;913;644;637;274;363
15;246401;246400;42-217;1128;784;779;307;472
16;246401;246400;42-217;1105;834;818;356;462
17;246401;246400;42-217;1303;938;927;371;556
18;246401;246400;42-217;868;630;621;283;338
19;246401;246400;42-217;1239;870;865;365;500
20;246401;246400;42-217;1574;1145;1140;490;650
21;246401;246400;42-217;1211;824;818;343;475
22;246401;246400;42-217;1237;856;849;384;465
23;246401;246400;42-202;1530;1118;1109;462;647
24;246401;246400;42-226;709;501;498;254;244
25;246401;246400;42-226;1926;1517;1512;909;603
26;246401;246400;42-202;584;439;435;166;269
27;246401;246400;42-202;1075;772;766;312;454
28;246401;246400;42-202;922;709;705;277;428
29;246401;246400;42-202;905;615;609;268;341
30;246401;246400;42-215;1213;892;886;413;473
31;246401;246400;42-215;903;603;600;278;322
32;246401;246400;42-215;778;549;547;268;279
33;246401;246400;42-215;1055;728;721;308;413
34;246401;246400;42-200;1089;803;791;361;430
35;246401;246400;42-218;536;395;389;165;224
36;246401;246400;42-218;1464;1129;1121;425;696
37;246401;246400;42-218;1485;1179;1171;342;829
38;246401;246400;42-218;1240;904;901;391;510
39;246401;246400;42-218;1476;1110;1102;489;613
40;246401;246400;42-218;1606;1235;1221;553;668
41;246401;246400;42-218;1906;1497;1485;499;986
42;246401;246400;42-215;1482;1122;1106;540;566
43;246401;246400;42-215;901;719;713;303;410
44;246401;246400;42-200;1782;1406;1394;545;849
45;246401;246400;42-200;2717;2271;2257;647;1610
46;246401;246400;42-218;1588;1235;1222;539;683
47;246401;246400;42-200;1415;1064;1058;572;486
48;246401;246400;42-224;1638;1251;1246;502;744
49;246401;246400;42-224;1476;1124;1109;464;645
50;246401;246400;42-224;1599;1221;1213;436;777
51;246401;246400;42-224;1475;1125;1116;430;686
52;246401;246400;42-224;1397;1009;1001;419;582
53;246401;246400;42-224;775;579;572;203;369
54;246401;246400;42-224;1388;1051;1041;439;602
55;246401;246400;42-224;361;294;293;107;186
56;246401;246400;42-224;1508;1109;1101;513;588
57;246401;246400;42-224;1365;1017;1012;423;589
58;246401;246400;42-224;1937;1606;1596;547;1049
59;246401;246400;42-224;1299;955;948;386;562
60;246401;246400;42-224;1248;941;937;417;520
61;246401;246400;42-224;1130;869;860;332;528
62;246401;246400;42-224;858;669;665;316;349
63;246401;246400;42-209;945;666;661;352;309
64;246401;246400;42-209;690;471;467;190;277
65;246401;246400;42-209;1154;855;853;407;446
66;246401;246400;42-209;1120;846;838;339;499
67;246401;246400;42-209;1076;840;832;289;543
68;246401;246400;42-209;1165;889;876;350;526
69;246401;246400;42-202;249;189;183;88;95
70;246401;246400;42-202;980;653;644;314;330
71;246401;246400;42-202;1168;773;769;339;430
72;246401;246400;42-200;1120;760;755;346;409
73;246401;246400;42-200;1122;808;801;359;442
74;246401;246400;42-202;1736;1259;1249;528;721
75;246401;246400;42-202;1816;1372;1362;700;662
76;246401;246400;42-216;1171;660;654;334;320
77;246401;246400;42-216;1302;899;888;408;480
78;246401;246400;42-216;1636;1135;1126;555;571
79;246401;246400;42-207;1224;819;812;378;434
80;246401;246400;42-207;778;514;509;236;273
81;246401;246400;42-207;1689;1111;1095;584;511
82;246401;246400;42-207;1225;881;869;398;471
83;246401;246400;42-207;916;571;562;288;274
84;246401;246400;42-207;1598;1107;1101;506;595
85;246401;246400;42-207;822;456;452;235;217
86;246401;246400;42-207;1228;894;887;416;471
87;246401;246400;42-207;857;565;562;278;284
88;246401;246400;42-208;1457;1062;1048;467;581
89;246401;246400;42-208;1063;784;779;322;457
90;246401;246400;42-208;1365;947;937;395;542
91;246401;246400;42-216;939;668;665;271;394
92;246401;246400;42-216;1655;1067;1058;519;539
93;246401;246400;42-216;1818;1355;1345;546;799
94;246401;246400;42-229;1563;1183;1172;462;710
95;246401;246400;42-229;1361;1001;993;428;565
96;246401;246400;42-229;1670;1229;1222;512;710
97;246401;246400;42-229;1649;1238;1229;559;670
98;246401;246400;42-216;1388;1035;1026;472;554
99;246401;246400;42-216;1084;794;787;386;401
100;246401;246400;42-208;570;437;434;166;268
101;246401;246400;42-208;1435;1061;1053;436;617
102;246401;246400;42-208;1519;1087;1074;501;573
103;246401;246400;42-208;1635;1170;1154;477;677
104;246401;246400;42-208;1777;1325;1313;571;742
105;246401;246400;42-202;792;588;583;255;328
106;246401;246400;42-202;782;581;573;300;273
107;246401;246400;42-200;799;585;582;333;249
108;246401;246400;42-271;1418;972;965;432;533
109;246401;246400;42-271;1441;912;905;443;462
110;246401;246400;42-280;549;406;402;203;199
111;246401;246400;42-202;935;693;685;301;384
112;246401;246400;42-202;1114;801;795;392;403
113;246401;246400;42-202;1536;1130;1122;492;630
114;246401;246400;42-202;1545;1142;1130;471;659
115;246401;246400;42-280;1355;1016;1010;429;581
116;246401;246400;42-280;1340;1012;1001;380;621
117;246401;246400;42-280;1026;748;739;338;401
118;246401;246400;42-280;1239;867;859;396;463
119;246401;246400;42-280;1538;1078;1070;448;622
120;246401;246400;42-280;1046;739;728;344;384
121;246401;246400;42-200;1963;1466;1457;731;726
122;246401;246400;42-200;2006;1539;1523;738;785
123;246401;246400;42-200;1591;1241;1225;450;775
124;246401;246400;42-200;1680;1375;1361;457;904
125;246401;246400;42-200;1891;1475;1464;683;781
126;246401;246400;42-200;1694;1392;1374;541;833
127;246401;246400;42-200;64;47;47;21;26
128;246401;246400;42-200;86;24;24;11;13
129;246401;246400;42-200;246;137;137;69;68
130;246401;246400;42-200;94;94;94;48;46
131;246401;246400;42-200;118;58;54;32;22
132;246401;246400;42-200;139;100;99;53;46
133;246401;246400;42-200;188;138;133;24;109
134;246401;246400;42-226;103;72;69;49;20
135;246401;246400;42-200;38;17;17;5;12
1;246501;246500;41-300;1335;1049;1027;316;711
2;246501;246500;41-300;1642;1232;1222;545;677
3;246501;246500;41-300;1372;1030;1026;417;609
4;246501;246500;41-300;1413;1010;1006;402;604
5;246501;246500;41-300;1623;1242;1229;457;772
6;246501;246500;41-300;507;363;360;147;213
7;246501;246500;41-300;1208;884;877;338;539
8;246501;246500;41-300;965;729;722;277;445
9;246501;246500;41-300;1518;1113;1097;492;605
10;246501;246500;41-300;1521;1082;1073;452;621
11;246501;246500;41-300;1021;702;694;269;425
12;246501;246500;41-300;1251;836;826;358;468
13;246501;246500;41-300;1109;746;740;284;456
14;246501;246500;41-300;1253;902;900;348;552
15;246501;246500;41-300;1497;1068;1060;385;675
16;246501;246500;41-300;1079;790;781;264;517
17;246501;246500;41-300;862;615;608;198;410
18;246501;246500;41-300;1472;1059;1058;400;658
19;246501;246500;41-300;1659;1243;1234;420;814
20;246501;246500;41-300;1044;783;775;265;510
21;246501;246500;41-300;1515;1057;1051;370;681
22;246501;246500;41-303;1629;1230;1225;534;691
23;246501;246500;41-303;1495;1141;1128;240;888
24;246501;246500;41-300;1510;1165;1152;379;773
25;246501;246500;41-303;1227;961;955;286;669
26;246501;246500;41-300;1314;1026;1013;370;643
27;246501;246500;41-300;962;654;651;261;390
28;246501;246500;41-300;1517;1056;1047;398;649
29;246501;246500;41-300;776;566;563;190;373
30;246501;246500;41-300;1394;997;984;400;584
31;246501;246500;41-300;1262;919;910;271;639
32;246501;246500;41-303;1595;1199;1178;471;707
33;246501;246500;41-303;1342;1007;995;414;581
34;246501;246500;41-303;1547;1179;1172;468;704
35;246501;246500;41-303;1501;1132;1124;432;692
36;246501;246500;41-303;1529;1154;1145;391;754
37;246501;246500;41-303;1669;1238;1221;465;756
38;246501;246500;41-303;1585;1188;1182;495;687
39;246501;246500;41-303;810;602;598;263;335
40;246501;246500;41-303;1413;1000;985;403;582
41;246501;246500;41-303;986;652;642;237;405
42;246501;246500;41-303;1162;761;747;317;430
43;246501;246500;41-303;1193;811;805;303;502
44;246501;246500;41-303;1615;1102;1092;515;577
45;246501;246500;41-303;1560;1127;1114;423;691
46;246501;246500;41-303;1896;1209;1198;505;693
47;246501;246500;41-303;1213;879;869;323;546
48;246501;246500;42-520;1770;1219;1207;488;719
49;246501;246500;42-520;819;593;593;291;302
50;246501;246500;42-520;1215;811;804;324;480
51;246501;246500;42-520;1158;746;739;294;445
52;246501;246500;42-520;907;627;623;258;365
53;246501;246500;42-520;1755;1305;1294;515;779
54;246501;246500;42-520;881;579;573;302;271
55;246501;246500;42-520;1157;724;718;412;306
56;246501;246500;42-520;1876;1399;1384;540;844
57;246501;246500;42-523;539;380;373;209;164
58;246501;246500;42-524;932;693;681;338;343
59;246501;246500;42-525;1485;1079;1063;542;521
60;246501;246500;42-530;1976;1442;1425;539;886
61;246501;246500;42-530;1733;1156;1142;500;642
62;246501;246500;42-530;1125;763;761;339;422
63;246501;246500;42-530;1469;1041;1034;533;501
64;246501;246500;42-530;1001;636;628;316;312
65;246501;246500;42-523;1130;768;759;316;443
66;246501;246500;41-300;208;116;113;52;61
67;246501;246500;41-300;103;41;41;14;27
1;246601;246600;44-109;705;540;535;221;314
2;246601;246600;44-109;1175;837;830;339;491
3;246601;246600;44-109;1359;904;895;451;444
4;246601;246600;44-109;1468;932;922;454;468
5;246601;246600;44-113;1332;886;881;446;435
6;246601;246600;44-113;1357;927;918;428;490
7;246601;246600;44-113;1358;1041;1031;384;647
8;246601;246600;44-113;1403;1097;1088;378;710
9;246601;246600;44-113;1566;1182;1169;415;754
10;246601;246600;44-117;1302;976;967;401;566
11;246601;246600;44-117;1418;1090;1082;440;642
12;246601;246600;44-117;1230;994;984;378;606
13;246601;246600;44-117;1092;837;832;340;492
14;246601;246600;44-117;1025;816;808;341;467
15;246601;246600;44-117;1162;865;863;346;517
16;246601;246600;44-100;704;557;553;174;379
17;246601;246600;44-100;1187;869;861;285;576
18;246601;246600;44-100;1451;1007;997;356;641
19;246601;246600;44-121;1653;1280;1263;414;849
20;246601;246600;44-121;1176;947;942;380;562
21;246601;246600;44-121;1402;1118;1107;329;778
22;246601;246600;44-105;1445;1143;1129;340;789
23;246601;246600;44-105;1177;947;938;345;593
24;246601;246600;44-105;1274;1009;998;415;583
25;246601;246600;44-105;1477;1239;1224;341;883
26;246601;246600;44-105;1525;1214;1207;380;827
27;246601;246600;44-102;894;703;695;242;453
28;246601;246600;44-102;902;661;657;260;397
29;246601;246600;44-102;1006;771;763;252;511
30;246601;246600;44-102;1008;646;640;277;363
31;246601;246600;44-102;1598;1044;1037;473;564
32;246601;246600;44-102;1168;756;744;316;428
33;246601;246600;44-102;954;705;702;306;396
34;246601;246600;44-102;996;653;650;288;362
35;246601;246600;44-102;1870;1400;1386;511;875
36;246601;246600;44-102;1765;1223;1209;539;670
37;246601;246600;44-100;1267;918;906;379;527
38;246601;246600;44-100;1414;980;972;399;573
39;246601;246600;44-100;1263;894;885;362;523
40;246601;246600;44-100;1360;1000;986;384;602
41;246601;246600;44-102;1273;861;857;368;489
42;246601;246600;44-102;1240;869;861;353;508
43;246601;246600;44-102;1092;769;760;322;438
44;246601;246600;44-100;932;697;680;236;444
45;246601;246600;44-100;1303;994;985;291;694
46;246601;246600;44-100;1033;756;746;267;479
47;246601;246600;44-100;863;621;613;196;417
48;246601;246600;44-100;691;503;499;145;354
49;246601;246600;44-100;1112;832;821;286;535
50;246601;246600;44-100;1144;864;855;328;527
51;246601;246600;44-100;1144;859;856;286;570
52;246601;246600;44-100;1172;896;888;234;654
53;246601;246600;44-100;728;572;562;120;442
54;246601;246600;44-103;1345;892;885;494;391
55;246601;246600;44-103;952;952;939;517;422
56;246601;246600;44-103;1446;1052;1040;595;445
57;246601;246600;44-103;1287;776;772;466;306
58;246601;246600;44-119;698;436;434;216;218
59;246601;246600;44-119;979;696;690;351;339
60;246601;246600;44-119;1012;685;678;376;302
61;246601;246600;44-119;1320;914;908;420;488
62;246601;246600;44-119;1334;953;944;468;476
63;246601;246600;44-119;1090;757;748;369;379
64;246601;246600;44-119;808;579;574;312;262
65;246601;246600;44-100;1609;1132;1121;494;627
66;246601;246600;44-100;1283;744;734;370;364
67;246601;246600;44-100;583;416;411;194;217
68;246601;246600;44-100;1030;677;668;317;351
69;246601;246600;44-100;1113;676;668;297;371
70;246601;246600;44-100;858;660;648;251;397
71;246601;246600;44-100;631;454;452;141;311
72;246601;246600;44-100;698;537;526;160;366
73;246601;246600;44-141;1004;748;740;342;398
74;246601;246600;44-141;1366;1109;1106;491;615
75;246601;246600;44-152;858;602;597;232;365
76;246601;246600;44-151;1174;850;836;388;448
77;246601;246600;44-151;1212;845;836;382;454
78;246601;246600;44-164;1044;779;773;274;499
79;246601;246600;44-164;990;766;764;330;434
80;246601;246600;44-121;1437;1096;1090;365;725
81;246601;246600;44-121;1719;1392;1384;433;951
82;246601;246600;44-121;1758;1451;1438;407;1031
83;246601;246600;44-100;1982;1531;1524;469;1055
84;246601;246600;44-100;1585;1288;1274;349;925
85;246601;246600;44-100;1157;893;882;282;600
86;246601;246600;44-100;691;562;559;142;417
87;246601;246600;44-100;1138;815;804;331;473
88;246601;246600;44-100;1175;897;890;295;595
89;246601;246600;44-100;934;590;583;298;285
90;246601;246600;44-100;1077;804;795;300;495
91;246601;246600;44-122;705;535;532;218;314
92;246601;246600;44-122;1089;799;795;305;490
93;246601;246600;44-122;1301;915;906;326;580
94;246601;246600;44-122;860;591;585;215;370
95;246601;246600;44-122;926;694;683;284;399
96;246601;246600;44-122;982;741;736;236;500
97;246601;246600;44-122;859;662;654;242;412
98;246601;246600;44-122;1267;1016;1002;351;651
99;246601;246600;44-122;959;685;679;214;465
100;246601;246600;44-122;903;680;676;200;476
101;246601;246600;44-122;949;662;654;244;410
102;246601;246600;44-122;1091;781;773;278;495
103;246601;246600;44-122;1156;889;881;297;584
104;246601;246600;44-122;1419;1047;1037;395;642
105;246601;246600;44-122;1847;1452;1435;494;941
106;246601;246600;44-122;1628;1168;1153;462;691
107;246601;246600;44-100;43;26;26;8;18
108;246601;246600;44-100;73;63;63;21;42
109;246601;246600;44-100;55;24;24;11;13
110;246601;246600;44-121;37;31;30;15;15
111;246601;246600;44-100;15;14;14;4;10
112;246601;246600;44-102;223;168;168;77;91
113;246601;246600;44-100;50;33;31;21;10
114;246601;246600;44-122;116;54;51;26;25
115;246601;246600;44-100;21;9;9;3;6
116;246601;246600;44-103;43;35;33;26;7
117;246601;246600;44-100;359;287;278;57;221
1;246701;246700;44-268;2164;1583;1570;1129;441
2;246701;246700;44-268;1781;1242;1231;822;409
3;246701;246700;44-268;1708;1055;1043;726;317
4;246701;246700;44-335;2579;2015;1998;1264;734
5;246701;246700;44-335;1430;1043;1038;694;344
6;246701;246700;44-335;1421;955;949;646;303
7;246701;246700;44-336;2070;1592;1572;1003;569
8;246701;246700;44-336;1098;817;811;576;235
9;246701;246700;44-335;1357;817;812;520;292
10;246701;246700;44-335;1401;841;830;534;296
11;246701;246700;44-330;2416;1564;1551;912;639
12;246701;246700;44-330;2129;1548;1531;837;694
13;246701;246700;44-330;1605;1138;1130;650;480
14;246701;246700;44-335;2522;1683;1665;960;705
15;246701;246700;44-335;2213;1480;1471;836;635
16;246701;246700;44-330;1727;1256;1246;643;603
17;246701;246700;44-330;1655;1235;1228;650;578
18;246701;246700;44-338;1771;1286;1281;860;421
19;246701;246700;44-338;1533;1082;1077;757;320
20;246701;246700;44-337;1445;1027;1015;593;422
21;246701;246700;44-337;1781;1331;1318;758;560
22;246701;246700;44-335;1390;900;890;531;359
23;246701;246700;44-335;1340;899;895;508;387
24;246701;246700;44-335;1905;1288;1275;765;510
25;246701;246700;44-335;2023;1375;1363;825;538
26;246701;246700;44-335;1827;1321;1309;818;491
27;246701;246700;44-335;2097;1454;1440;876;564
28;246701;246700;44-335;2501;1719;1706;988;718
29;246701;246700;44-335;1748;1213;1203;693;510
30;246701;246700;44-335;1823;1284;1276;721;555
31;246701;246700;44-335;1328;956;951;552;399
32;246701;246700;44-335;1348;990;983;559;424
33;246701;246700;44-335;1786;1255;1244;698;546
34;246701;246700;44-335;1762;1251;1239;618;621
35;246701;246700;44-268;899;608;608;97;511
36;246701;246700;44-330;146;104;104;62;42
37;246701;246700;44-335;96;19;19;10;9
38;246701;246700;44-335;29;21;19;9;10
1;246801;246800;43-600;1489;1135;1123;460;663
2;246801;246800;43-600;1253;953;951;388;563
3;246801;246800;43-600;1487;967;959;512;447
4;246801;246800;43-600;1498;1135;1126;454;672
5;246801;246800;43-600;1175;816;813;417;396
6;246801;246800;43-600;1480;1004;995;450;545
7;246801;246800;43-600;1494;965;954;501;453
8;246801;246800;43-600;1431;967;962;471;491
9;246801;246800;43-600;1627;1174;1165;594;571
10;246801;246800;43-600;1633;1139;1132;486;646
11;246801;246800;43-600;1490;1143;1130;555;575
12;246801;246800;43-600;1960;1478;1464;700;764
13;246801;246800;43-600;2178;1652;1631;859;772
14;246801;246800;43-600;1522;1106;1098;554;544
15;246801;246800;43-600;1986;1440;1429;648;781
16;246801;246800;43-600;1398;953;946;431;515
17;246801;246800;43-600;1558;939;927;507;420
18;246801;246800;43-600;1281;805;789;441;348
19;246801;246800;43-600;1271;899;888;417;471
20;246801;246800;43-600;1244;884;875;372;503
21;246801;246800;43-600;1456;1067;1050;438;612
22;246801;246800;43-600;1784;1315;1305;567;738
23;246801;246800;43-600;1740;1313;1303;520;783
24;246801;246800;43-600;1081;851;843;344;499
25;246801;246800;43-600;944;670;667;316;351
26;246801;246800;43-600;932;698;695;294;401
27;246801;246800;43-600;1210;827;819;389;430
28;246801;246800;43-600;1660;1144;1131;513;618
29;246801;246800;43-600;1238;770;762;371;391
30;246801;246800;43-600;1654;1165;1155;591;564
31;246801;246800;43-600;1490;1113;1105;534;571
32;246801;246800;43-600;917;669;664;315;349
33;246801;246800;43-600;2112;1540;1520;695;825
34;246801;246800;43-600;1918;1338;1329;716;613
35;246801;246800;43-600;1731;1235;1223;595;628
36;246801;246800;43-600;947;684;682;329;353
37;246801;246800;43-600;1192;737;732;356;376
38;246801;246800;43-600;1334;885;878;427;451
39;246801;246800;43-600;1305;832;823;439;384
40;246801;246800;43-600;1405;1006;996;463;533
41;246801;246800;43-600;1778;1341;1335;590;745
42;246801;246800;43-600;348;208;207;98;109
43;246801;246800;43-600;2340;1757;1741;717;1024
44;246801;246800;43-600;1614;1136;1126;505;621
45;246801;246800;43-600;621;426;423;219;204
46;246801;246800;43-600;88;50;50;29;21
47;246801;246800;43-600;133;81;79;42;37
48;246801;246800;43-600;107;40;40;16;24
1;246901;246900;40-772;2208;1770;1756;519;1237
2;246901;246900;40-772;1973;1570;1562;409;1153
3;246901;246900;40-756;1696;1346;1337;483;854
4;246901;246900;40-756;1924;1485;1465;500;965
5;246901;246900;40-756;1145;907;904;310;594
6;246901;246900;40-751;1724;1421;1407;507;900
7;246901;246900;40-709;2343;1770;1754;622;1132
8;246901;246900;40-709;1766;1265;1256;590;666
9;246901;246900;40-710;1662;1216;1208;461;747
10;246901;246900;40-710;1519;1036;1026;399;627
11;246901;246900;40-718;798;609;602;187;415
12;246901;246900;40-718;1248;934;920;359;561
13;246901;246900;40-719;1175;898;892;314;578
14;246901;246900;40-551;1252;1010;989;294;695
15;246901;246900;40-694;1479;1121;1110;353;757
16;246901;246900;40-685;1132;823;814;320;494
17;246901;246900;40-685;2232;1801;1785;416;1369
18;246901;246900;40-671;1011;750;745;324;421
19;246901;246900;40-613;2313;1879;1849;560;1289
20;246901;246900;40-613;1597;1228;1221;462;759
21;246901;246900;40-615;1795;1414;1402;496;906
22;246901;246900;40-642;1853;1412;1400;559;841
23;246901;246900;40-648;1765;1420;1409;520;889
24;246901;246900;40-648;1736;1352;1337;505;832
25;246901;246900;40-648;1558;1201;1193;510;683
26;246901;246900;40-748;2396;1971;1952;548;1404
27;246901;246900;40-750;1610;1320;1312;378;934
28;246901;246900;40-750;1847;1518;1508;507;1001
29;246901;246900;40-750;1800;1465;1452;458;994
30;246901;246900;40-750;830;582;578;342;236
31;246901;246900;40-750;1133;788;782;430;352
32;246901;246900;40-748;1998;1576;1559;598;961
33;246901;246900;40-748;1545;1250;1238;457;781
34;246901;246900;40-748;1815;1421;1406;533;873
35;246901;246900;40-749;1377;1091;1073;535;538
36;246901;246900;40-749;1165;804;798;414;384
37;246901;246900;40-749;1103;761;751;401;350
38;246901;246900;40-326;1866;1315;1301;568;733
39;246901;246900;40-309;816;524;521;216;305
40;246901;246900;40-309;762;534;531;237;294
41;246901;246900;40-320;1151;750;735;354;381
42;246901;246900;40-318;1193;855;844;338;506
43;246901;246900;40-338;975;662;656;309;347
44;246901;246900;40-353;1307;888;880;425;455
45;246901;246900;40-374;1591;984;976;506;470
46;246901;246900;40-374;1072;570;557;322;235
47;246901;246900;40-384;1019;590;584;348;236
48;246901;246900;40-384;1261;757;746;395;351
49;246901;246900;40-404;1593;1006;1000;505;495
50;246901;246900;40-413;1263;860;849;382;467
51;246901;246900;40-431;1250;902;891;425;466
52;246901;246900;40-431;1069;730;722;316;406
53;246901;246900;40-431;2008;1471;1458;628;830
54;246901;246900;40-488;1468;1075;1068;533;535
55;246901;246900;40-488;1472;1059;1050;484;566
56;246901;246900;40-466;1390;1054;1047;476;571
57;246901;246900;40-466;1732;1264;1253;519;734
58;246901;246900;40-467;1492;1099;1090;606;484
59;246901;246900;40-474;1105;854;847;363;484
60;246901;246900;40-474;1176;853;846;382;464
61;246901;246900;40-474;1480;1062;1051;478;573
62;246901;246900;40-527;2524;2163;2143;450;1693
63;246901;246900;40-592;405;291;289;90;199
64;246901;246900;40-533;1319;1105;1097;304;793
65;246901;246900;40-584;1363;1073;1059;319;740
66;246901;246900;40-092;1115;815;806;240;566
67;246901;246900;40-086;950;733;726;201;525
68;246901;246900;40-092;525;350;345;111;234
69;246901;246900;40-006;620;416;407;130;277
70;246901;246900;40-097;889;620;614;189;425
71;246901;246900;40-052;1041;714;707;244;463
72;246901;246900;40-052;1305;1014;1004;326;678
73;246901;246900;40-066;1232;905;895;280;615
74;246901;246900;40-053;1349;1036;1029;334;695
75;246901;246900;40-069;1665;1255;1236;393;843
76;246901;246900;40-074;1231;871;864;298;566
77;246901;246900;40-042;953;804;797;233;564
78;246901;246900;40-039;1412;1126;1119;335;784
79;246901;246900;40-035;1477;1059;1049;364;685
80;246901;246900;40-035;1072;791;782;254;528
81;246901;246900;40-035;1370;998;986;296;690
82;246901;246900;40-007;1131;859;856;284;572
83;246901;246900;40-008;820;550;544;238;306
84;246901;246900;40-282;1789;1436;1419;510;909
85;246901;246900;40-282;1394;1148;1145;331;814
86;246901;246900;40-282;2657;2251;2230;535;1695
87;246901;246900;40-018;1525;1227;1218;390;828
88;246901;246900;40-018;2420;1894;1877;534;1343
89;246901;246900;40-866;1289;972;961;311;650
90;246901;246900;40-870;1528;1142;1127;350;777
91;246901;246900;40-873;1426;1072;1054;309;745
92;246901;246900;40-873;1245;863;856;321;535
93;246901;246900;40-870;1220;908;901;338;563
94;246901;246900;40-881;1700;1347;1336;460;876
95;246901;246900;40-881;1452;1150;1139;326;813
96;246901;246900;40-881;1690;1307;1296;413;883
97;246901;246900;40-871;1331;1026;1020;329;691
98;246901;246900;40-881;1359;1046;1034;359;675
99;246901;246900;40-881;1528;1193;1182;407;775
100;246901;246900;40-859;1358;840;835;428;407
101;246901;246900;40-860;1609;1101;1088;477;611
102;246901;246900;40-854;1234;810;803;402;401
103;246901;246900;40-854;1124;700;693;305;388
104;246901;246900;40-854;1079;755;748;310;438
105;246901;246900;40-110;1435;994;972;424;548
106;246901;246900;40-114;1811;1400;1386;434;952
107;246901;246900;40-106;865;604;597;223;374
108;246901;246900;40-106;1194;865;854;349;505
109;246901;246900;40-844;1958;1529;1512;600;912
110;246901;246900;40-833;1156;845;837;351;486
111;246901;246900;40-832;1382;1044;1033;412;621
112;246901;246900;40-832;1667;1283;1263;493;770
113;246901;246900;40-832;1539;1204;1192;442;750
114;246901;246900;40-832;1449;1096;1088;466;622
115;246901;246900;40-560;1505;1145;1132;402;730
116;246901;246900;40-560;938;730;727;259;468
117;246901;246900;40-555;1804;1489;1469;462;1007
118;246901;246900;40-551;1810;1461;1451;397;1054
119;246901;246900;40-594;1708;1204;1194;496;698
120;246901;246900;40-594;1309;914;905;369;536
121;246901;246900;40-592;1358;1019;1009;433;576
122;246901;246900;40-143;2408;1843;1816;587;1229
123;246901;246900;40-143;1458;1117;1106;406;700
124;246901;246900;40-111;1353;1009;1006;400;606
125;246901;246900;40-111;1286;915;908;375;533
126;246901;246900;40-144;1576;1107;1092;373;719
127;246901;246900;40-111;1225;912;901;392;509
128;246901;246900;40-136;1442;1107;1088;337;751
129;246901;246900;40-134;1405;1029;1019;349;670
130;246901;246900;40-134;1024;727;726;233;493
131;246901;246900;40-126;1073;829;821;253;568
132;246901;246900;40-126;1718;1263;1245;406;839
133;246901;246900;40-164;1725;1062;1054;351;703
134;246901;246900;40-165;1263;1046;1042;284;758
135;246901;246900;40-165;1134;815;805;293;512
136;246901;246900;40-165;1089;835;834;257;577
137;246901;246900;40-175;1851;1444;1422;514;908
138;246901;246900;40-208;1540;1106;1095;435;660
139;246901;246900;40-213;1192;746;739;366;373
140;246901;246900;40-214;1629;1235;1216;505;711
141;246901;246900;40-216;1648;1313;1306;477;829
142;246901;246900;40-203;1079;884;873;275;598
143;246901;246900;40-203;866;683;676;260;416
144;246901;246900;40-224;1112;665;659;286;373
145;246901;246900;40-230;1949;1492;1478;558;920
146;246901;246900;40-230;1069;667;656;252;404
147;246901;246900;40-233;986;728;718;299;419
148;246901;246900;40-233;1262;991;979;361;618
149;246901;246900;40-069;82;50;46;31;15
150;246901;246900;40-695;92;69;65;27;38
151;246901;246900;40-750;186;76;72;20;52
152;246901;246900;40-067;352;325;318;44;274
153;246901;246900;40-042;117;48;48;16;32
154;246901;246900;40-029;146;113;111;53;58
155;246901;246900;40-749;110;53;51;30;21
156;246901;246900;40-635;249;113;113;44;69
157;246901;246900;40-752;257;152;150;55;95
158;246901;246900;40-211;50;31;30;10;20
159;246901;246900;40-340;175;103;99;47;52
160;246901;246900;40-074;83;83;83;44;39
161;246901;246900;40-073;50;50;50;26;24
162;246901;246900;40-145;59;34;34;14;20
163;246901;246900;40-008;25;17;17;8;9
164;246901;246900;40-760;23;23;23;11;12
165;246901;246900;40-514;74;62;61;26;35
166;246901;246900;40-353;61;26;24;15;9
167;246901;246900;40-635;192;102;101;44;57
168;246901;246900;40-042;24;11;11;5;6
1;247001;247000;41-400;1110;721;710;411;299
2;247001;247000;41-400;1051;680;675;378;297
3;247001;247000;41-400;1241;729;723;413;310
4;247001;247000;41-400;989;592;584;310;274
5;247001;247000;41-400;1155;784;779;385;394
6;247001;247000;41-400;1573;1033;1025;496;529
7;247001;247000;41-400;1441;963;959;483;476
8;247001;247000;41-400;1194;682;678;366;312
9;247001;247000;41-400;815;520;517;265;252
10;247001;247000;41-400;1462;1013;1003;490;513
11;247001;247000;41-406;1274;1024;1008;462;546
12;247001;247000;41-406;1741;1382;1375;529;846
13;247001;247000;41-406;2159;1604;1593;626;967
14;247001;247000;41-400;1927;1392;1377;646;731
15;247001;247000;41-400;1511;1145;1133;484;649
16;247001;247000;41-400;839;680;674;227;447
17;247001;247000;41-406;1162;823;813;381;432
18;247001;247000;41-406;1280;942;931;428;503
19;247001;247000;41-406;1914;1287;1273;597;676
20;247001;247000;41-412;1035;820;816;324;492
21;247001;247000;41-412;1743;1282;1268;629;639
22;247001;247000;41-412;1291;987;979;469;510
23;247001;247000;41-412;1153;855;849;417;432
24;247001;247000;41-412;1416;1070;1060;526;534
25;247001;247000;41-404;1919;1337;1332;720;612
26;247001;247000;41-404;1478;1070;1063;587;476
27;247001;247000;41-404;1909;1513;1498;735;763
28;247001;247000;41-409;2474;1935;1922;954;968
29;247001;247000;41-409;1672;1283;1276;614;662
30;247001;247000;41-409;1456;1142;1137;540;597
31;247001;247000;41-409;1051;718;710;433;277
32;247001;247000;41-404;1389;1087;1075;485;590
33;247001;247000;41-408;1886;1282;1272;766;506
34;247001;247000;41-408;884;677;672;415;257
35;247001;247000;41-408;753;514;510;296;214
36;247001;247000;41-408;784;566;557;359;198
37;247001;247000;41-408;1689;1344;1333;497;836
38;247001;247000;41-400;17;15;15;7;8
39;247001;247000;41-400;44;34;34;19;15
40;247001;247000;41-400;337;296;287;50;237
41;247001;247000;41-404;31;23;23;12;11
1;247101;247100;41-945;1241;890;880;421;459
2;247101;247100;41-945;1101;811;801;392;409
3;247101;247100;41-943;1573;964;956;508;448
4;247101;247100;41-943;2118;1493;1477;729;748
5;247101;247100;41-943;1733;1177;1165;552;613
6;247101;247100;41-943;1148;706;700;411;289
7;247101;247100;41-943;1085;702;699;377;322
8;247101;247100;41-943;1121;859;840;401;439
9;247101;247100;41-943;1140;754;744;422;322
10;247101;247100;41-943;1201;806;801;450;351
11;247101;247100;41-940;1502;1073;1057;504;553
12;247101;247100;41-940;1560;1121;1115;505;610
13;247101;247100;41-940;2169;1565;1551;676;875
14;247101;247100;41-940;1838;1383;1370;602;768
15;247101;247100;41-940;1628;1084;1076;509;567
16;247101;247100;41-940;1274;873;865;402;463
17;247101;247100;41-940;905;472;468;274;194
18;247101;247100;41-940;1162;779;773;390;383
19;247101;247100;41-949;1376;945;933;454;479
20;247101;247100;41-949;1188;856;849;464;385
21;247101;247100;41-949;1030;778;769;404;365
22;247101;247100;41-949;1059;744;743;359;384
23;247101;247100;41-949;1304;943;932;499;433
24;247101;247100;41-949;1332;989;980;447;533
25;247101;247100;41-946;1529;930;918;547;371
26;247101;247100;41-946;1378;850;835;471;364
27;247101;247100;41-948;1295;916;902;544;358
28;247101;247100;41-948;1642;1167;1159;654;505
29;247101;247100;41-940;68;27;24;13;11
30;247101;247100;41-946;88;40;36;25;11
31;247101;247100;41-940;100;74;74;24;50
32;247101;247100;41-940;51;47;45;20;25
1;247201;247200;41-700;1271;675;669;425;244
2;247201;247200;41-700;928;453;443;252;191
3;247201;247200;41-700;1471;995;985;503;482
4;247201;247200;41-700;1009;632;624;317;307
5;247201;247200;41-700;986;629;620;288;332
6;247201;247200;41-700;871;563;556;326;230
7;247201;247200;41-700;1436;833;822;414;408
8;247201;247200;41-700;548;385;382;172;210
9;247201;247200;41-700;1382;983;974;395;579
10;247201;247200;41-700;596;427;427;194;233
11;247201;247200;41-700;1560;1084;1071;563;508
12;247201;247200;41-700;1778;1251;1233;558;675
13;247201;247200;41-700;937;695;686;332;354
14;247201;247200;41-700;1020;714;708;349;359
15;247201;247200;41-712;1577;858;846;498;348
16;247201;247200;41-712;1285;816;811;429;382
17;247201;247200;41-712;1253;937;925;409;516
18;247201;247200;41-712;1207;882;873;351;522
19;247201;247200;41-712;796;604;593;256;337
20;247201;247200;41-712;1387;883;871;377;494
21;247201;247200;41-712;1392;960;949;425;524
22;247201;247200;41-712;1473;1030;1024;508;516
23;247201;247200;41-712;1309;818;813;415;398
24;247201;247200;41-712;1084;740;739;335;404
25;247201;247200;41-709;617;343;338;199;139
26;247201;247200;41-709;1532;731;724;431;293
27;247201;247200;41-709;950;630;624;336;288
28;247201;247200;41-709;1761;1134;1114;586;528
29;247201;247200;41-709;1611;950;940;529;411
30;247201;247200;41-709;816;555;553;288;265
31;247201;247200;41-709;880;603;601;328;273
32;247201;247200;41-709;1558;1071;1056;560;496
33;247201;247200;41-710;1014;640;631;311;320
34;247201;247200;41-710;1167;725;712;392;320
35;247201;247200;41-710;447;299;295;154;141
36;247201;247200;41-710;1237;880;872;449;423
37;247201;247200;41-710;1267;802;799;390;409
38;247201;247200;41-710;1182;778;768;402;366
39;247201;247200;41-710;1348;1006;999;416;583
40;247201;247200;41-710;784;516;512;284;228
41;247201;247200;41-710;1052;740;737;400;337
42;247201;247200;41-710;715;346;344;211;133
43;247201;247200;41-710;1073;810;804;301;503
44;247201;247200;41-711;1376;937;931;513;418
45;247201;247200;41-711;1828;1284;1273;561;712
46;247201;247200;41-711;1300;891;882;481;401
47;247201;247200;41-711;1395;921;914;458;456
48;247201;247200;41-711;1689;1180;1174;515;659
49;247201;247200;41-717;1211;910;907;440;467
50;247201;247200;41-717;1060;796;788;391;397
51;247201;247200;41-717;1779;1194;1178;635;543
52;247201;247200;41-717;1221;811;798;458;340
53;247201;247200;41-717;846;589;583;283;300
54;247201;247200;41-717;1282;928;922;487;435
55;247201;247200;41-717;1176;870;861;463;398
56;247201;247200;41-717;1251;907;899;441;458
57;247201;247200;41-717;1219;879;867;422;445
58;247201;247200;41-707;1744;1196;1185;612;573
59;247201;247200;41-707;1925;1460;1449;570;879
60;247201;247200;41-707;1744;1333;1322;599;723
61;247201;247200;41-707;1118;821;816;404;412
62;247201;247200;41-707;1199;816;805;378;427
63;247201;247200;41-707;1659;1136;1132;594;538
64;247201;247200;41-706;2178;1597;1576;719;857
65;247201;247200;41-706;2362;1768;1747;751;996
66;247201;247200;41-706;1333;902;895;478;417
67;247201;247200;41-706;1612;1157;1148;668;480
68;247201;247200;41-706;2164;1679;1663;748;915
69;247201;247200;41-706;1528;1056;1048;552;496
70;247201;247200;41-706;1548;1030;1021;489;532
71;247201;247200;41-706;1412;877;867;456;411
72;247201;247200;41-706;1540;1055;1038;514;524
73;247201;247200;41-706;1159;849;845;378;467
74;247201;247200;41-706;1335;918;901;437;464
75;247201;247200;41-700;89;33;32;19;13
76;247201;247200;41-712;77;77;76;34;42
77;247201;247200;41-711;55;28;28;11;17
78;247201;247200;41-710;44;28;28;11;17
79;247201;247200;41-704;173;82;79;43;36
1;247301;247300;44-200;1157;820;814;327;487
2;247301;247300;44-200;1202;834;831;340;491
3;247301;247300;44-200;1288;911;905;358;547
4;247301;247300;44-200;1444;1037;1029;421;608
5;247301;247300;44-200;1380;975;970;374;596
6;247301;247300;44-200;1546;1099;1086;433;653
7;247301;247300;44-200;1282;989;983;393;590
8;247301;247300;44-200;1087;832;824;294;530
9;247301;247300;44-213;1689;1199;1187;674;513
10;247301;247300;44-213;1717;1296;1284;691;593
11;247301;247300;44-207;1523;1119;1108;590;518
12;247301;247300;44-200;1578;1210;1197;685;512
13;247301;247300;44-200;1215;886;872;512;360
14;247301;247300;44-207;1216;922;912;422;490
15;247301;247300;44-207;1292;907;899;407;492
16;247301;247300;44-207;1784;1354;1344;800;544
17;247301;247300;44-207;591;417;415;297;118
18;247301;247300;44-292;1383;1001;993;648;345
19;247301;247300;44-292;432;283;280;165;115
20;247301;247300;44-207;1606;1201;1192;654;538
21;247301;247300;44-203;1531;1055;1047;574;473
22;247301;247300;44-203;1632;1112;1108;515;593
23;247301;247300;44-203;1533;1152;1143;538;605
24;247301;247300;44-203;1510;1125;1121;605;516
25;247301;247300;44-251;1509;1132;1126;662;464
26;247301;247300;44-251;1293;985;972;581;391
27;247301;247300;44-251;2030;1534;1517;904;613
28;247301;247300;44-251;1691;1249;1237;782;455
29;247301;247300;44-251;1890;1345;1326;761;565
30;247301;247300;44-253;1280;781;776;483;293
31;247301;247300;44-253;1490;1028;1016;590;426
32;247301;247300;44-253;1258;708;704;453;251
33;247301;247300;44-253;1416;785;777;527;250
34;247301;247300;44-253;1508;894;887;586;301
35;247301;247300;44-251;1986;1361;1353;947;406
36;247301;247300;44-200;936;689;682;311;371
37;247301;247300;44-200;1019;765;760;361;399
38;247301;247300;44-206;1683;1114;1108;681;427
39;247301;247300;44-206;1704;1184;1178;695;483
40;247301;247300;44-206;1715;1147;1142;695;447
41;247301;247300;44-274;1439;1011;1002;619;383
42;247301;247300;44-274;1213;856;842;450;392
43;247301;247300;44-274;1223;821;804;417;387
44;247301;247300;44-270;1338;902;897;506;391
45;247301;247300;44-270;1307;803;798;439;359
46;247301;247300;44-270;1166;725;722;468;254
47;247301;247300;44-270;1249;925;911;514;397
48;247301;247300;44-270;1959;1468;1459;733;726
49;247301;247300;44-270;1619;1074;1065;537;528
50;247301;247300;44-273;1504;928;917;532;385
51;247301;247300;44-273;1970;1291;1277;685;592
52;247301;247300;44-217;1708;1185;1172;565;607
53;247301;247300;44-217;1639;1217;1205;543;662
54;247301;247300;44-217;1181;874;870;377;493
55;247301;247300;44-217;1853;1358;1338;589;749
56;247301;247300;44-210;1562;1081;1076;477;599
57;247301;247300;44-210;1640;1210;1202;543;659
58;247301;247300;44-217;1733;1068;1060;535;525
59;247301;247300;44-217;1367;1024;1017;424;593
60;247301;247300;44-200;1455;1031;1024;458;566
61;247301;247300;44-200;1620;1145;1134;477;657
62;247301;247300;44-200;1585;1144;1133;465;668
63;247301;247300;44-218;1390;1049;1039;421;618
64;247301;247300;44-218;1713;1336;1321;510;811
65;247301;247300;44-217;1405;1059;1045;584;461
66;247301;247300;44-217;1188;873;867;539;328
67;247301;247300;44-200;533;180;178;120;58
68;247301;247300;44-200;140;49;49;26;23
69;247301;247300;44-200;256;135;134;82;52
70;247301;247300;44-270;25;14;14;9;5
71;247301;247300;44-251;42;19;19;5;14
72;247301;247300;44-213;31;11;10;4;6
1;247401;247400;41-100;775;359;355;205;150
2;247401;247400;41-100;864;536;531;272;259
3;247401;247400;41-100;1081;675;665;300;365
4;247401;247400;41-100;1284;680;678;322;356
5;247401;247400;41-100;1106;664;659;312;347
6;247401;247400;41-100;989;583;574;279;295
7;247401;247400;41-100;1210;965;956;261;695
8;247401;247400;41-100;1030;648;643;276;367
9;247401;247400;41-100;1281;747;741;376;365
10;247401;247400;41-100;1328;831;825;367;458
11;247401;247400;41-100;1609;973;959;426;533
12;247401;247400;41-100;1601;933;921;439;482
13;247401;247400;41-100;1402;913;908;402;506
14;247401;247400;41-100;951;705;690;251;439
15;247401;247400;41-100;1191;773;766;291;475
16;247401;247400;41-100;1238;943;931;356;575
17;247401;247400;41-100;1028;811;800;330;470
18;247401;247400;41-106;1199;863;848;307;541
19;247401;247400;41-100;1822;1332;1322;457;865
20;247401;247400;41-106;1658;1329;1314;428;886
21;247401;247400;41-106;1141;891;883;342;541
22;247401;247400;41-106;1539;1128;1118;418;700
23;247401;247400;41-106;1165;863;852;325;527
24;247401;247400;41-106;1333;1017;1010;343;667
25;247401;247400;41-106;976;744;735;211;524
26;247401;247400;41-106;1298;995;982;346;636
27;247401;247400;41-103;762;535;525;210;315
28;247401;247400;41-103;392;275;269;127;142
29;247401;247400;41-103;1111;851;843;340;503
30;247401;247400;41-103;818;633;628;255;373
31;247401;247400;41-103;1607;1327;1318;348;970
32;247401;247400;41-103;551;382;377;135;242
33;247401;247400;41-103;1510;1065;1056;477;579
34;247401;247400;41-103;1848;1360;1344;568;776
35;247401;247400;41-103;1678;1251;1234;508;726
36;247401;247400;41-103;1189;785;781;302;479
37;247401;247400;41-103;594;400;395;191;204
38;247401;247400;41-103;1434;1058;1045;474;571
39;247401;247400;41-103;1133;857;847;351;496
40;247401;247400;41-100;65;46;46;13;33
41;247401;247400;41-100;40;19;19;9;10
1;247501;247500;41-203;1005;725;713;246;467
2;247501;247500;41-203;1672;1289;1274;450;824
3;247501;247500;41-214;1927;1441;1428;597;831
4;247501;247500;41-205;916;699;692;215;477
5;247501;247500;41-205;1518;1054;1042;382;660
6;247501;247500;41-205;1281;795;788;324;464
7;247501;247500;41-205;1029;773;764;236;528
8;247501;247500;41-200;850;462;458;229;229
9;247501;247500;41-214;2135;1566;1552;511;1041
10;247501;247500;41-214;1055;756;749;241;508
11;247501;247500;41-214;1605;1130;1118;457;661
12;247501;247500;41-214;1211;809;803;317;486
13;247501;247500;41-209;1702;1329;1315;518;797
14;247501;247500;41-209;1438;1125;1115;361;754
15;247501;247500;41-209;990;711;709;271;438
16;247501;247500;41-209;2292;1813;1804;534;1270
17;247501;247500;41-209;1417;1062;1050;438;612
18;247501;247500;41-209;1552;1074;1064;380;684
19;247501;247500;41-214;1798;1326;1311;489;822
20;247501;247500;41-205;1672;1167;1157;442;715
21;247501;247500;41-205;1418;988;977;360;617
22;247501;247500;41-205;1536;961;953;425;528
23;247501;247500;41-205;1621;1113;1099;413;686
24;247501;247500;41-200;1248;892;887;361;526
25;247501;247500;41-200;1666;1301;1288;386;902
26;247501;247500;41-200;2315;1729;1721;587;1134
27;247501;247500;41-200;1148;838;830;290;540
28;247501;247500;41-200;1200;879;873;305;568
29;247501;247500;41-200;1345;1007;996;329;667
30;247501;247500;41-200;1418;992;982;320;662
31;247501;247500;41-200;1594;1118;1110;407;703
32;247501;247500;41-200;905;549;543;232;311
33;247501;247500;41-200;629;309;303;139;164
34;247501;247500;41-200;1304;885;882;330;552
35;247501;247500;41-200;1845;1209;1203;491;712
36;247501;247500;41-200;1083;840;833;240;593
37;247501;247500;41-200;1898;1419;1406;504;902
38;247501;247500;41-200;975;723;718;203;515
39;247501;247500;41-200;1419;1060;1050;378;672
40;247501;247500;41-200;2318;1739;1724;625;1099
41;247501;247500;41-200;1632;1168;1155;445;710
42;247501;247500;41-219;1775;1346;1334;491;843
43;247501;247500;41-219;1844;1360;1354;564;790
44;247501;247500;41-219;1961;1403;1396;598;798
45;247501;247500;41-219;1498;1139;1130;427;703
46;247501;247500;41-219;1025;760;755;245;510
47;247501;247500;41-200;2616;1986;1968;678;1290
48;247501;247500;41-200;1260;990;974;302;672
49;247501;247500;41-200;349;197;195;90;105
50;247501;247500;41-200;744;499;492;261;231
51;247501;247500;41-208;928;667;658;249;409
52;247501;247500;41-208;1777;1216;1203;532;671
53;247501;247500;41-208;1790;1287;1278;568;710
54;247501;247500;41-208;1661;1144;1126;510;616
55;247501;247500;41-208;572;378;373;160;213
56;247501;247500;41-208;1886;1336;1317;596;721
57;247501;247500;41-208;1602;1120;1107;515;592
58;247501;247500;41-208;1555;1064;1054;473;581
59;247501;247500;41-208;1475;995;988;462;526
60;247501;247500;41-208;882;641;633;242;391
61;247501;247500;41-200;1283;852;846;352;494
62;247501;247500;41-219;812;554;548;274;274
63;247501;247500;41-219;1152;832;822;329;493
64;247501;247500;41-219;1353;885;880;403;477
65;247501;247500;41-219;1150;791;783;343;440
66;247501;247500;41-219;2025;1531;1521;618;903
67;247501;247500;41-219;1630;1119;1110;518;592
68;247501;247500;41-219;2066;1454;1439;558;881
69;247501;247500;41-219;1618;1037;1033;521;512
70;247501;247500;41-219;1287;919;904;448;456
71;247501;247500;41-219;970;700;697;292;405
72;247501;247500;41-219;1389;1063;1058;503;555
73;247501;247500;41-219;1183;911;903;362;541
74;247501;247500;41-219;1510;1154;1140;452;688
75;247501;247500;41-219;1294;940;936;365;571
76;247501;247500;41-219;1535;1215;1204;467;737
77;247501;247500;41-219;883;655;652;250;402
78;247501;247500;41-219;1108;814;805;311;494
79;247501;247500;41-219;1289;999;995;383;612
80;247501;247500;41-219;1604;1170;1161;492;669
81;247501;247500;41-219;1730;1330;1316;546;770
82;247501;247500;41-218;2087;1583;1576;601;975
83;247501;247500;41-218;1716;1318;1310;559;751
84;247501;247500;41-218;851;606;604;289;315
85;247501;247500;41-218;1441;1005;993;417;576
86;247501;247500;41-218;1365;936;926;415;511
87;247501;247500;41-215;2073;1433;1414;595;819
88;247501;247500;41-216;703;536;530;239;291
89;247501;247500;41-216;707;501;496;246;250
90;247501;247500;41-216;1721;1082;1073;531;542
91;247501;247500;41-216;1603;1079;1067;533;534
92;247501;247500;41-215;1544;1063;1054;449;605
93;247501;247500;41-215;1356;937;929;442;487
94;247501;247500;41-215;2476;1809;1791;658;1133
95;247501;247500;41-217;1291;932;920;390;530
96;247501;247500;41-214;1085;813;806;283;523
97;247501;247500;41-208;635;478;473;209;264
98;247501;247500;41-219;1241;923;918;429;489
99;247501;247500;41-219;958;707;702;310;392
100;247501;247500;41-200;64;36;33;17;16
101;247501;247500;41-200;142;73;72;27;45
102;247501;247500;41-200;77;43;39;18;21
103;247501;247500;41-219;65;6;6;1;5
104;247501;247500;41-200;303;202;198;72;126
105;247501;247500;41-219;66;10;10;4;6
106;247501;247500;41-200;270;220;220;28;192
107;247501;247500;41-200;43;18;18;8;10
1;247601;247600;41-608;1632;1104;1090;491;599
2;247601;247600;41-608;1491;719;712;456;256
3;247601;247600;41-608;1459;1002;998;453;545
4;247601;247600;41-608;1548;1098;1089;474;615
5;247601;247600;41-608;1184;865;861;394;467
6;247601;247600;41-608;1230;944;939;352;587
7;247601;247600;41-605;1173;596;593;264;329
8;247601;247600;41-605;1248;684;679;327;352
9;247601;247600;41-605;1596;860;847;431;416
10;247601;247600;41-605;1682;1244;1235;515;720
11;247601;247600;41-605;1528;1079;1074;451;623
12;247601;247600;41-605;1722;1323;1314;543;771
13;247601;247600;41-600;1255;639;631;319;312
14;247601;247600;41-600;1563;1153;1143;495;648
15;247601;247600;41-600;1451;920;910;431;479
16;247601;247600;41-600;1208;820;817;324;493
17;247601;247600;41-600;1560;993;976;434;542
18;247601;247600;41-600;1628;894;881;396;485
19;247601;247600;41-600;1394;781;769;422;347
20;247601;247600;41-600;1235;870;865;405;460
21;247601;247600;41-600;1516;965;950;437;513
22;247601;247600;41-600;2066;1489;1475;570;905
23;247601;247600;41-600;804;479;476;227;249
24;247601;247600;41-605;54;26;24;11;13
25;247601;247600;41-605;166;76;75;42;33
26;247601;247600;41-600;61;21;19;7;12
27;247601;247600;41-600;19;17;16;5;11
1;247701;247700;43-100;1957;1619;1604;556;1048
2;247701;247700;43-100;1579;1269;1249;480;769
3;247701;247700;43-100;1434;1039;1033;480;553
4;247701;247700;43-100;1977;1582;1563;650;913
5;247701;247700;43-100;2033;1542;1523;747;776
6;247701;247700;43-100;1403;940;932;457;475
7;247701;247700;43-100;1080;687;683;352;331
8;247701;247700;43-100;1133;772;753;317;436
9;247701;247700;43-100;1436;978;971;447;524
10;247701;247700;43-100;1695;1187;1174;544;630
11;247701;247700;43-100;1091;731;721;375;346
12;247701;247700;43-100;1482;1163;1149;449;700
13;247701;247700;43-100;1187;966;952;424;528
14;247701;247700;43-100;1969;1582;1574;861;713
15;247701;247700;43-100;1350;1022;1015;593;422
16;247701;247700;43-100;1359;901;896;409;487
17;247701;247700;43-100;1602;1119;1107;425;682
18;247701;247700;43-100;1743;1332;1322;544;778
19;247701;247700;43-100;1512;1004;995;474;521
20;247701;247700;43-100;1342;913;900;453;447
21;247701;247700;43-100;924;602;594;289;305
22;247701;247700;43-100;1524;1102;1094;513;581
23;247701;247700;43-100;1267;883;873;419;454
24;247701;247700;43-100;1057;734;729;325;404
25;247701;247700;43-100;930;656;651;297;354
26;247701;247700;43-100;726;527;525;242;283
27;247701;247700;43-100;1107;840;832;373;459
28;247701;247700;43-100;1150;888;884;389;495
29;247701;247700;43-100;1593;1210;1196;576;620
30;247701;247700;43-100;1314;1073;1063;416;647
31;247701;247700;43-100;1523;1184;1178;455;723
32;247701;247700;43-100;1230;927;918;434;484
33;247701;247700;43-100;1309;981;975;463;512
34;247701;247700;43-100;1219;921;907;403;504
35;247701;247700;43-100;1216;936;928;581;347
36;247701;247700;43-100;1395;1094;1078;473;605
37;247701;247700;43-100;944;719;716;376;340
38;247701;247700;43-100;1195;934;923;373;550
39;247701;247700;43-100;1269;986;977;549;428
40;247701;247700;43-100;1651;1119;1112;516;596
41;247701;247700;43-100;1266;848;841;399;442
42;247701;247700;43-100;1372;962;952;452;500
43;247701;247700;43-100;1637;1157;1146;531;615
44;247701;247700;43-100;1427;1071;1060;527;533
45;247701;247700;43-100;1371;1033;1023;444;579
46;247701;247700;43-100;1527;1170;1156;454;702
47;247701;247700;43-100;1313;937;922;424;498
48;247701;247700;43-100;1495;1150;1141;508;633
49;247701;247700;43-100;1161;889;880;441;439
50;247701;247700;43-100;1274;975;968;399;569
51;247701;247700;43-100;1064;778;774;297;477
52;247701;247700;43-100;1474;1109;1102;482;620
53;247701;247700;43-100;2456;1982;1969;846;1123
54;247701;247700;43-100;1297;990;973;407;566
55;247701;247700;43-100;1333;1074;1067;462;605
56;247701;247700;43-100;1854;1489;1477;613;864
57;247701;247700;43-100;1622;1179;1167;578;589
58;247701;247700;43-100;1420;1102;1087;520;567
59;247701;247700;43-100;1639;1246;1231;536;695
60;247701;247700;43-100;1471;1041;1033;536;497
61;247701;247700;43-100;1442;1071;1066;481;585
62;247701;247700;43-100;1303;958;949;456;493
63;247701;247700;43-100;1649;1213;1194;475;719
64;247701;247700;43-100;23;17;17;10;7
65;247701;247700;43-100;151;97;97;57;40
66;247701;247700;43-100;53;31;30;21;9
67;247701;247700;43-100;26;10;10;6;4
1;247801;247800;41-813;1180;666;657;325;332
2;247801;247800;41-813;1374;743;736;312;424
3;247801;247800;41-813;793;457;453;222;231
4;247801;247800;41-813;1236;818;813;333;480
5;247801;247800;41-813;1608;1045;1043;449;594
6;247801;247800;41-808;1460;878;867;423;444
7;247801;247800;41-808;1037;544;533;275;258
8;247801;247800;41-808;2173;1398;1379;609;770
9;247801;247800;41-808;1657;933;919;465;454
10;247801;247800;41-808;1569;920;907;376;531
11;247801;247800;41-808;1567;851;847;455;392
12;247801;247800;41-814;2053;1484;1469;651;818
13;247801;247800;41-807;1769;1107;1097;480;617
14;247801;247800;41-807;1541;732;727;391;336
15;247801;247800;41-807;1662;894;887;482;405
16;247801;247800;41-807;1070;528;522;288;234
17;247801;247800;41-807;2032;1267;1244;584;660
18;247801;247800;41-807;1372;917;906;333;573
19;247801;247800;41-808;765;479;473;255;218
20;247801;247800;41-818;1675;1241;1225;543;682
21;247801;247800;41-818;2162;1578;1565;574;991
22;247801;247800;41-819;877;585;579;259;320
23;247801;247800;41-819;1601;1022;1010;371;639
24;247801;247800;41-800;1779;1201;1186;427;759
25;247801;247800;41-800;1826;1201;1186;448;738
26;247801;247800;41-800;1614;1009;993;397;596
27;247801;247800;41-800;1094;646;642;321;321
28;247801;247800;41-819;1707;1180;1167;443;724
29;247801;247800;41-819;1090;815;805;305;500
30;247801;247800;41-819;2048;1375;1361;562;799
31;247801;247800;41-800;1846;1272;1261;514;747
32;247801;247800;41-800;1578;1133;1125;455;670
33;247801;247800;41-800;963;645;635;258;377
34;247801;247800;41-800;2009;1053;1050;569;481
35;247801;247800;41-800;890;471;468;230;238
36;247801;247800;41-800;1087;604;602;275;327
37;247801;247800;41-800;1818;1162;1152;479;673
38;247801;247800;41-803;1226;670;666;362;304
39;247801;247800;41-803;1260;640;636;340;296
40;247801;247800;41-803;1511;857;854;430;424
41;247801;247800;41-803;1235;647;640;303;337
42;247801;247800;41-803;1242;489;482;288;194
43;247801;247800;41-806;1701;1109;1099;589;510
44;247801;247800;41-806;1477;933;928;435;493
45;247801;247800;41-806;1505;970;962;533;429
46;247801;247800;41-806;1560;983;979;456;523
47;247801;247800;41-806;1571;1069;1053;453;600
48;247801;247800;41-806;1456;1046;1038;470;568
49;247801;247800;41-806;1373;964;957;428;529
50;247801;247800;41-806;1691;996;984;593;391
51;247801;247800;41-806;1341;699;694;377;317
52;247801;247800;41-800;1621;1053;1046;505;541
53;247801;247800;41-800;1285;840;830;394;436
54;247801;247800;41-800;1143;688;678;303;375
55;247801;247800;41-800;1218;790;784;334;450
56;247801;247800;41-809;1856;1321;1313;545;768
57;247801;247800;41-810;1038;708;697;320;377
58;247801;247800;41-810;910;626;619;254;365
59;247801;247800;41-811;1586;1119;1108;570;538
60;247801;247800;41-800;1620;1117;1101;416;685
61;247801;247800;41-800;1544;959;954;424;530
62;247801;247800;41-800;1561;855;849;427;422
63;247801;247800;41-800;1636;1060;1050;449;601
64;247801;247800;41-800;984;663;646;257;389
65;247801;247800;41-800;1572;1006;998;398;600
66;247801;247800;41-800;1359;818;812;356;456
67;247801;247800;41-800;1505;788;783;321;462
68;247801;247800;41-800;1575;1045;1037;405;632
69;247801;247800;41-800;1233;676;664;348;316
70;247801;247800;41-800;1355;810;801;381;420
71;247801;247800;41-800;1248;677;665;357;308
72;247801;247800;41-800;1667;1039;1029;433;596
73;247801;247800;41-800;1462;988;977;412;565
74;247801;247800;41-800;1812;1229;1214;538;676
75;247801;247800;41-800;1481;939;934;382;552
76;247801;247800;41-800;1823;1233;1220;460;760
77;247801;247800;41-800;1591;820;807;445;362
78;247801;247800;41-800;93;50;48;33;15
79;247801;247800;41-800;65;43;40;12;28
80;247801;247800;41-800;53;35;31;17;14
81;247801;247800;41-800;66;31;26;8;18
82;247801;247800;41-800;77;38;34;20;14
83;247801;247800;41-800;55;32;23;16;7
84;247801;247800;41-806;553;433;424;42;382
85;247801;247800;41-803;139;69;66;31;35
86;247801;247800;41-803;35;22;22;6;16
87;247801;247800;41-800;209;145;143;61;82
88;247801;247800;41-800;78;57;57;24;33
89;247801;247800;41-800;82;55;55;21;34
1;247901;247900;44-240;1849;1284;1268;584;684
2;247901;247900;44-240;2524;1809;1789;830;959
3;247901;247900;44-240;1850;1416;1398;758;640
4;247901;247900;44-240;1915;1451;1440;801;639
5;247901;247900;44-240;1253;972;954;520;434
6;247901;247900;44-240;1593;1166;1162;594;568
7;247901;247900;44-240;1421;980;974;489;485
8;247901;247900;44-240;2124;1484;1476;697;779
9;247901;247900;44-240;2176;1459;1455;714;741
10;247901;247900;44-240;2316;1601;1594;761;833
11;247901;247900;44-240;1715;1183;1168;580;588
12;247901;247900;44-240;1825;1260;1245;646;599
13;247901;247900;44-240;2846;1879;1869;1027;842
14;247901;247900;44-240;1949;1306;1295;662;633
15;247901;247900;44-240;2030;1367;1355;699;656
16;247901;247900;44-240;1961;1334;1320;706;614
17;247901;247900;44-240;1905;1256;1245;657;588
18;247901;247900;44-240;1503;1173;1166;495;671
19;247901;247900;44-240;1865;1421;1413;745;668
20;247901;247900;44-240;2266;1725;1712;1053;659
21;247901;247900;44-240;2745;2090;2069;1162;907
22;247901;247900;44-240;1446;1125;1115;794;321
23;247901;247900;44-240;1263;941;933;587;346
24;247901;247900;44-240;720;401;397;244;153
25;247901;247900;44-240;41;30;30;14;16
26;247901;247900;44-240;25;15;14;12;2
1;260101;260100;28-100;1324;985;978;454;524
2;260101;260100;28-100;989;643;643;336;307
3;260101;260100;28-100;967;720;715;335;380
4;260101;260100;28-100;1351;997;991;534;457
5;260101;260100;28-100;1194;842;839;419;420
6;260101;260100;28-100;2117;1749;1727;769;958
7;260101;260100;28-100;1099;795;788;391;397
8;260101;260100;28-100;1105;802;796;430;366
9;260101;260100;28-100;1138;784;778;388;390
10;260101;260100;28-100;1221;936;929;439;490
11;260101;260100;28-100;1000;655;644;417;227
12;260101;260100;28-100;837;560;557;322;235
13;260101;260100;28-100;1126;706;703;504;199
14;260101;260100;28-100;854;571;566;377;189
15;260101;260100;28-100;1266;883;874;495;379
16;260101;260100;28-100;869;586;581;355;226
17;260101;260100;28-100;437;301;300;202;98
18;260101;260100;28-100;500;336;336;228;108
19;260101;260100;28-100;506;306;304;205;99
20;260101;260100;28-100;351;249;248;146;102
21;260101;260100;28-100;663;445;443;329;114
22;260101;260100;28-100;1124;789;781;615;166
23;260101;260100;28-100;388;271;269;200;69
24;260101;260100;28-100;425;287;287;204;83
25;260101;260100;28-100;243;166;164;110;54
26;260101;260100;28-100;272;183;179;133;46
27;260101;260100;28-100;459;302;301;213;88
28;260101;260100;28-100;300;190;187;144;43
29;260101;260100;28-100;635;461;461;272;189
30;260101;260100;28-100;392;257;256;187;69
31;260101;260100;28-100;94;59;59;44;15
32;260101;260100;28-100;370;328;326;181;145
33;260101;260100;28-100;47;47;47;31;16
34;260101;260100;28-100;283;261;259;111;148
35;260101;260100;28-100;85;15;14;10;4
1;260102;260100;28-114;593;397;392;316;76
2;260102;260100;28-114;962;682;677;560;117
3;260102;260100;28-114;529;321;320;249;71
4;260102;260100;28-114;728;531;531;436;95
5;260102;260100;28-114;176;128;127;113;14
6;260102;260100;28-114;109;74;74;64;10
7;260102;260100;28-114;292;204;203;173;30
8;260102;260100;28-114;54;18;15;12;3
1;260103;260100;28-136;1327;849;845;567;278
2;260103;260100;28-136;621;408;405;282;123
3;260103;260100;28-136;604;384;383;268;115
4;260103;260100;28-136;490;319;316;227;89
5;260103;260100;28-136;800;506;505;377;128
6;260103;260100;28-136;371;217;216;151;65
7;260103;260100;28-136;303;197;195;154;41
1;260104;260100;28-133;1463;894;889;551;338
2;260104;260100;28-133;860;523;520;405;115
3;260104;260100;28-133;1133;742;734;570;164
4;260104;260100;28-133;649;405;401;291;110
5;260104;260100;28-133;962;609;603;486;117
6;260104;260100;28-133;447;262;254;195;59
7;260104;260100;28-133;69;40;39;33;6
8;260104;260100;28-133;33;25;17;14;3
1;260105;260100;28-131;375;254;253;195;58
2;260105;260100;28-131;664;443;440;327;113
3;260105;260100;28-131;1009;807;797;410;387
4;260105;260100;28-131;575;369;366;282;84
5;260105;260100;28-131;451;281;279;223;56
6;260105;260100;28-131;535;353;351;239;112
7;260105;260100;28-131;179;128;128;109;19
8;260105;260100;28-131;341;246;245;172;73
9;260105;260100;28-131;62;32;32;26;6
10;260105;260100;28-131;45;28;21;16;5
1;260106;260100;28-130;1336;910;907;583;324
2;260106;260100;28-130;144;96;96;74;22
3;260106;260100;28-130;602;427;425;326;99
4;260106;260100;28-130;504;299;295;226;69
5;260106;260100;28-130;333;232;232;165;67
6;260106;260100;28-130;439;274;274;198;76
7;260106;260100;28-220;330;244;243;190;53
8;260106;260100;28-130;217;136;136;105;31
9;260106;260100;28-130;311;235;235;191;44
10;260106;260100;28-130;291;182;182;146;36
11;260106;260100;28-130;303;181;180;156;24
12;260106;260100;28-130;493;359;358;268;90
13;260106;260100;28-130;356;230;229;172;57
14;260106;260100;28-130;166;119;119;99;20
1;260107;260100;28-142;377;245;243;195;48
2;260107;260100;28-142;837;541;537;421;116
3;260107;260100;28-142;1023;668;660;533;127
4;260107;260100;28-142;611;439;435;305;130
1;260108;260100;28-160;750;521;513;313;200
2;260108;260100;28-160;527;316;316;246;70
3;260108;260100;28-160;677;410;403;297;106
4;260108;260100;28-160;587;399;399;328;71
5;260108;260100;28-160;691;466;462;391;71
6;260108;260100;28-160;300;220;217;167;50
7;260108;260100;28-160;377;220;220;143;77
8;260108;260100;28-160;280;184;182;134;48
1;260201;260200;28-313;1493;1019;1014;777;237
2;260201;260200;28-313;962;616;613;435;178
3;260201;260200;28-313;520;337;334;266;68
4;260201;260200;28-313;409;269;265;205;60
1;260202;260200;28-300;996;719;719;410;309
2;260202;260200;28-300;815;622;619;324;295
3;260202;260200;28-300;1223;895;894;514;380
4;260202;260200;28-300;700;439;437;241;196
5;260202;260200;28-300;1135;785;774;416;358
6;260202;260200;28-300;1077;790;785;379;406
7;260202;260200;28-300;758;561;554;322;232
8;260202;260200;28-300;771;568;561;306;255
9;260202;260200;28-300;608;403;403;231;172
10;260202;260200;28-300;1163;784;779;448;331
11;260202;260200;28-300;952;679;676;341;335
12;260202;260200;28-300;669;488;484;227;257
13;260202;260200;28-300;1347;912;905;611;294
14;260202;260200;28-300;759;513;510;382;128
15;260202;260200;28-300;923;645;636;424;212
16;260202;260200;28-300;1075;724;718;498;220
17;260202;260200;28-300;594;422;422;280;142
18;260202;260200;28-300;846;585;581;460;121
19;260202;260200;28-300;622;402;401;331;70
20;260202;260200;28-300;847;590;586;442;144
21;260202;260200;28-300;665;443;443;349;94
22;260202;260200;28-300;257;170;170;107;63
23;260202;260200;28-300;318;232;229;154;75
24;260202;260200;28-300;359;258;251;163;88
25;260202;260200;28-300;285;222;220;146;74
26;260202;260200;28-300;232;186;184;141;43
27;260202;260200;28-300;231;153;153;120;33
28;260202;260200;28-300;282;203;202;173;29
29;260202;260200;28-300;65;12;12;5;7
30;260202;260200;28-300;17;9;8;8;0
1;260203;260200;28-366;1325;940;934;635;299
2;260203;260200;28-366;1281;897;892;646;246
3;260203;260200;28-366;1258;876;872;741;131
4;260203;260200;28-366;1433;1051;1044;892;152
5;260203;260200;28-366;1180;898;895;776;119
6;260203;260200;28-366;880;616;616;488;128
7;260203;260200;28-366;817;556;553;425;128
8;260203;260200;28-366;448;330;328;262;66
1;260204;260200;28-362;619;422;417;277;140
2;260204;260200;28-362;258;153;152;121;31
3;260204;260200;28-362;756;539;532;424;108
4;260204;260200;28-362;457;317;317;270;47
5;260204;260200;28-362;607;393;391;312;79
6;260204;260200;28-362;371;244;243;191;52
7;260204;260200;28-362;436;289;288;234;54
8;260204;260200;28-362;297;177;177;158;19
1;260205;260200;28-363;1023;705;703;451;252
2;260205;260200;28-363;360;274;271;236;35
3;260205;260200;28-363;614;399;399;323;76
4;260205;260200;28-363;289;190;190;156;34
5;260205;260200;28-363;281;187;186;150;36
6;260205;260200;28-363;294;206;204;168;36
7;260205;260200;28-363;302;216;216;167;49
8;260205;260200;28-363;255;171;170;140;30
9;260205;260200;28-363;181;144;143;115;28
1;260206;260200;28-340;311;219;218;160;58
2;260206;260200;28-340;227;164;164;137;27
3;260206;260200;28-340;218;153;153;123;30
4;260206;260200;28-340;849;573;571;374;197
5;260206;260200;28-340;304;195;194;126;68
6;260206;260200;28-340;598;401;398;332;66
7;260206;260200;28-340;515;358;355;258;97
8;260206;260200;28-340;1101;713;711;436;275
9;260206;260200;28-340;1441;985;980;664;316
10;260206;260200;28-340;722;454;447;294;153
11;260206;260200;28-340;1503;1032;1025;639;386
12;260206;260200;28-340;328;236;236;176;60
13;260206;260200;28-340;231;177;174;144;30
14;260206;260200;28-340;263;198;198;171;27
15;260206;260200;28-340;214;134;132;121;11
16;260206;260200;28-340;201;145;145;115;30
17;260206;260200;28-340;300;177;174;131;43
1;260207;260200;28-350;727;476;473;400;73
2;260207;260200;28-350;1237;887;885;663;222
3;260207;260200;28-350;486;292;292;225;67
4;260207;260200;28-350;791;512;508;412;96
1;260208;260200;28-305;721;511;506;381;125
2;260208;260200;28-305;680;424;423;344;79
3;260208;260200;28-305;1088;806;802;576;226
4;260208;260200;28-305;1450;995;986;752;234
5;260208;260200;28-305;893;655;650;416;234
6;260208;260200;28-305;571;398;394;306;88
7;260208;260200;28-305;750;530;526;390;136
8;260208;260200;28-305;421;291;290;247;43
1;260209;260200;28-330;806;551;550;374;176
2;260209;260200;28-330;370;239;238;194;44
3;260209;260200;28-330;684;460;457;358;99
4;260209;260200;28-330;1022;707;704;478;226
5;260209;260200;28-330;388;239;238;155;83
6;260209;260200;28-330;730;484;477;349;128
7;260209;260200;28-330;739;453;447;358;89
8;260209;260200;28-330;286;195;194;132;62
9;260209;260200;28-330;309;224;223;178;45
1;260301;260300;28-512;1971;1137;1130;767;363
2;260301;260300;28-512;1094;648;643;486;157
3;260301;260300;28-512;44;23;22;18;4
1;260302;260300;28-506;638;428;425;318;107
2;260302;260300;28-506;768;479;476;359;117
3;260302;260300;28-506;1187;697;695;559;136
4;260302;260300;28-506;374;242;242;177;65
1;260303;260300;28-500;974;617;612;316;296
2;260303;260300;28-500;880;566;565;328;237
3;260303;260300;28-500;682;442;438;230;208
4;260303;260300;28-500;733;439;438;196;242
5;260303;260300;28-500;669;397;395;185;210
6;260303;260300;28-500;774;474;469;319;150
7;260303;260300;28-500;1117;666;660;396;264
8;260303;260300;28-500;934;569;565;392;173
9;260303;260300;28-500;801;557;556;445;111
10;260303;260300;28-500;547;328;323;236;87
11;260303;260300;28-500;773;444;440;355;85
12;260303;260300;28-500;726;465;462;359;103
13;260303;260300;28-500;919;554;549;408;141
14;260303;260300;28-500;839;555;552;428;124
15;260303;260300;28-500;820;582;580;470;110
16;260303;260300;28-500;56;14;14;10;4
1;260304;260300;28-520;691;395;391;288;103
2;260304;260300;28-520;770;522;517;280;237
3;260304;260300;28-520;657;384;382;250;132
4;260304;260300;28-520;298;191;191;131;60
5;260304;260300;28-520;168;105;103;82;21
1;260305;260300;28-530;957;633;625;373;252
2;260305;260300;28-530;684;469;465;427;38
3;260305;260300;28-530;919;600;594;432;162
4;260305;260300;28-530;688;433;431;366;65
5;260305;260300;28-530;541;351;349;283;66
6;260305;260300;28-530;1100;654;649;527;122
1;260401;260400;26-004;532;382;381;336;45
2;260401;260400;26-004;1573;1098;1091;877;214
3;260401;260400;26-004;1002;686;681;569;112
4;260401;260400;26-004;645;434;430;352;78
5;260401;260400;26-004;1029;754;749;630;119
6;260401;260400;26-004;374;283;281;228;53
7;260401;260400;26-004;462;337;336;312;24
8;260401;260400;26-004;445;332;329;284;45
9;260401;260400;26-004;926;661;658;473;185
10;260401;260400;26-004;265;209;209;191;18
11;260401;260400;26-004;502;363;360;318;42
1;260402;260400;26-010;1620;1133;1124;700;424
2;260402;260400;26-010;150;85;85;71;14
3;260402;260400;26-010;399;261;260;210;50
4;260402;260400;26-010;332;222;221;185;36
5;260402;260400;26-010;548;366;361;301;60
6;260402;260400;26-010;240;146;146;92;54
7;260402;260400;26-010;639;399;395;340;55
8;260402;260400;26-010;1504;990;982;765;217
9;260402;260400;26-010;672;514;510;300;210
10;260402;260400;26-010;720;515;513;371;142
11;260402;260400;26-006;456;295;293;233;60
12;260402;260400;26-010;517;352;351;288;63
13;260402;260400;26-010;241;171;171;132;39
14;260402;260400;26-010;177;132;131;126;5
15;260402;260400;26-010;426;319;315;249;66
1;260403;260400;26-060;934;680;675;397;278
2;260403;260400;26-060;534;368;367;223;144
3;260403;260400;26-060;1112;818;812;475;337
4;260403;260400;26-060;612;437;430;315;115
5;260403;260400;26-060;931;617;611;443;168
6;260403;260400;26-060;1189;858;851;634;217
7;260403;260400;26-060;494;343;340;229;111
8;260403;260400;26-060;622;464;457;322;135
9;260403;260400;26-060;1018;734;727;527;200
10;260403;260400;26-060;838;585;582;402;180
11;260403;260400;26-060;542;380;378;295;83
12;260403;260400;26-060;529;341;338;248;90
13;260403;260400;26-060;613;414;413;349;64
14;260403;260400;26-060;411;269;266;210;56
15;260403;260400;26-060;338;284;283;194;89
16;260403;260400;26-060;759;569;561;284;277
17;260403;260400;26-060;352;162;158;109;49
1;260404;260400;26-020;360;269;267;177;90
2;260404;260400;26-020;389;277;274;171;103
3;260404;260400;26-020;519;391;385;262;123
4;260404;260400;26-020;621;451;447;285;162
5;260404;260400;26-020;279;185;184;146;38
6;260404;260400;26-020;462;337;336;289;47
7;260404;260400;26-020;281;182;181;165;16
8;260404;260400;26-020;195;148;147;139;8
9;260404;260400;26-020;490;297;295;250;45
10;260404;260400;26-020;401;281;279;227;52
11;260404;260400;26-020;688;500;495;362;133
12;260404;260400;26-020;834;579;577;430;147
13;260404;260400;26-020;469;363;361;266;95
14;260404;260400;26-020;271;172;172;143;29
15;260404;260400;26-020;409;273;272;205;67
16;260404;260400;26-020;303;192;191;141;50
17;260404;260400;26-020;228;165;164;138;26
18;260404;260400;26-020;302;201;201;163;38
19;260404;260400;26-020;763;522;519;342;177
20;260404;260400;26-020;51;16;16;14;2
21;260404;260400;26-020;123;59;55;40;15
22;260404;260400;26-020;22;11;10;2;8
1;260405;260400;26-021;717;491;484;335;149
2;260405;260400;26-021;716;563;557;415;142
3;260405;260400;26-021;921;630;626;472;154
4;260405;260400;26-021;552;401;398;224;174
5;260405;260400;26-021;727;514;508;406;102
6;260405;260400;26-021;354;243;240;167;73
7;260405;260400;26-021;370;277;277;243;34
8;260405;260400;26-021;375;259;257;180;77
9;260405;260400;26-021;181;127;127;96;31
10;260405;260400;26-015;572;385;381;244;137
11;260405;260400;26-021;744;546;544;355;189
12;260405;260400;26-021;1098;794;788;552;236
13;260405;260400;26-021;975;755;749;487;262
14;260405;260400;26-021;575;436;431;321;110
15;260405;260400;26-021;261;184;183;157;26
16;260405;260400;26-021;800;578;572;457;115
17;260405;260400;26-015;323;247;240;195;45
18;260405;260400;26-021;478;345;343;228;115
19;260405;260400;26-021;129;85;85;74;11
20;260405;260400;26-021;745;531;527;369;158
21;260405;260400;26-021;813;608;604;353;251
1;260406;260400;26-008;1380;1057;1050;863;187
2;260406;260400;25-351;1230;987;978;533;445
3;260406;260400;26-008;2720;2018;1994;1572;422
4;260406;260400;26-008;1512;1103;1101;931;170
5;260406;260400;26-008;1037;792;785;533;252
6;260406;260400;26-008;1333;969;962;614;348
7;260406;260400;26-008;1104;794;785;657;128
8;260406;260400;26-008;1120;841;834;665;169
1;260407;260400;26-025;1167;822;816;610;206
2;260407;260400;26-025;766;527;526;494;32
3;260407;260400;26-025;584;415;408;342;66
4;260407;260400;26-025;380;273;269;231;38
5;260407;260400;26-025;255;173;172;153;19
6;260407;260400;26-025;650;448;447;396;51
7;260407;260400;26-025;263;183;182;158;24
8;260407;260400;26-025;309;226;224;192;32
9;260407;260400;26-025;395;272;270;237;33
10;260407;260400;26-025;326;193;193;167;26
1;260408;260400;26-070;473;331;329;264;65
2;260408;260400;26-070;469;335;334;279;55
3;260408;260400;26-070;509;358;357;315;42
4;260408;260400;26-070;847;599;598;471;127
5;260408;260400;26-070;1439;1067;1057;727;330
6;260408;260400;26-070;1069;749;744;615;129
7;260408;260400;26-070;379;280;279;250;29
8;260408;260400;26-070;387;273;273;241;32
9;260408;260400;26-070;386;305;302;248;54
10;260408;260400;26-070;937;671;669;570;99
1;260409;260400;26-001;478;351;343;221;122
2;260409;260400;26-001;483;349;348;203;145
3;260409;260400;26-001;867;655;645;371;274
4;260409;260400;25-351;1073;804;801;442;359
5;260409;260400;26-001;782;557;554;363;191
6;260409;260400;26-001;1467;1083;1074;592;482
7;260409;260400;26-001;1044;730;727;497;230
8;260409;260400;26-050;469;343;339;203;136
9;260409;260400;26-001;1279;973;962;492;470
10;260409;260400;26-001;253;172;171;142;29
11;260409;260400;26-001;358;243;242;185;57
12;260409;260400;26-001;306;224;223;160;63
1;260410;260400;26-085;1511;1138;1121;641;480
2;260410;260400;26-085;1432;1079;1062;628;434
3;260410;260400;26-085;1275;931;924;594;330
4;260410;260400;26-085;1266;880;868;556;312
5;260410;260400;26-085;933;704;695;406;289
6;260410;260400;26-085;1124;839;829;483;346
7;260410;260400;26-085;1043;755;751;407;344
8;260410;260400;26-085;325;251;251;177;74
9;260410;260400;26-085;329;241;238;159;79
1;260411;260400;26-080;693;488;487;418;69
2;260411;260400;26-080;387;277;276;240;36
3;260411;260400;26-080;1178;817;812;655;157
4;260411;260400;26-080;755;537;534;388;146
5;260411;260400;26-080;533;348;345;294;51
6;260411;260400;26-080;937;667;664;522;142
7;260411;260400;26-080;427;293;292;242;50
8;260411;260400;26-080;592;385;385;279;106
9;260411;260400;26-080;623;450;448;315;133
10;260411;260400;26-080;762;534;530;448;82
11;260411;260400;26-080;197;134;133;107;26
1;260412;260400;26-026;1521;1138;1128;665;463
2;260412;260400;26-026;1166;956;949;471;478
3;260412;260400;26-026;255;203;202;150;52
4;260412;260400;26-026;843;577;575;459;116
5;260412;260400;26-026;761;517;515;369;146
6;260412;260400;26-026;1039;761;753;491;262
7;260412;260400;26-026;356;248;245;156;89
8;260412;260400;26-026;1338;1061;1056;618;438
9;260412;260400;26-026;777;552;550;423;127
10;260412;260400;26-026;778;648;643;315;328
11;260412;260400;26-026;188;107;105;64;41
12;260412;260400;26-026;230;160;160;123;37
13;260412;260400;26-026;384;270;267;187;80
14;260412;260400;26-026;260;175;173;161;12
15;260412;260400;26-026;1381;1184;1170;442;728
16;260412;260400;26-026;1391;1054;1048;673;375
17;260412;260400;26-026;447;325;325;226;99
18;260412;260400;26-026;530;194;190;133;57
19;260412;260400;25-450;53;16;15;7;8
20;260412;260400;26-026;71;17;17;12;5
1;260413;260400;26-006;1027;706;700;429;271
2;260413;260400;26-006;391;239;239;178;61
3;260413;260400;26-006;704;461;456;371;85
4;260413;260400;26-006;537;349;349;304;45
5;260413;260400;26-006;1641;1059;1051;711;340
6;260413;260400;26-006;843;554;552;433;119
7;260413;260400;26-006;692;414;413;299;114
8;260413;260400;26-006;482;312;311;259;52
9;260413;260400;26-006;353;231;230;192;38
10;260413;260400;26-006;153;104;104;91;13
11;260413;260400;26-006;362;243;242;186;56
1;260414;260400;26-065;1112;855;847;424;423
2;260414;260400;26-065;785;518;513;351;162
3;260414;260400;26-065;866;616;609;461;148
4;260414;260400;26-065;706;495;492;340;152
5;260414;260400;26-065;718;484;481;311;170
6;260414;260400;26-065;942;688;683;520;163
7;260414;260400;26-065;870;632;631;574;57
8;260414;260400;26-065;898;644;642;543;99
9;260414;260400;26-065;1181;864;854;655;199
10;260414;260400;26-065;660;448;448;352;96
11;260414;260400;26-065;1001;719;718;522;196
12;260414;260400;26-065;720;531;523;397;126
13;260414;260400;26-065;593;418;416;262;154
14;260414;260400;26-065;910;625;622;519;103
15;260414;260400;26-065;411;271;270;194;76
16;260414;260400;26-065;326;233;233;177;56
17;260414;260400;26-065;72;64;64;56;8
1;260415;260400;26-015;203;140;139;95;44
2;260415;260400;26-015;389;255;253;219;34
3;260415;260400;26-015;491;364;361;292;69
4;260415;260400;26-015;869;634;630;418;212
5;260415;260400;26-015;355;270;269;232;37
6;260415;260400;26-015;185;137;137;110;27
7;260415;260400;26-015;166;103;101;84;17
8;260415;260400;26-015;210;136;131;86;45
9;260415;260400;26-015;250;187;187;144;43
10;260415;260400;26-015;257;198;196;156;40
11;260415;260400;26-015;251;182;182;157;25
12;260415;260400;26-015;137;29;28;16;12
13;260415;260400;26-015;96;40;37;22;15
1;260416;260400;26-035;361;224;223;190;33
2;260416;260400;26-035;333;233;231;172;59
3;260416;260400;26-035;529;343;339;272;67
4;260416;260400;26-035;635;427;424;341;83
5;260416;260400;26-035;531;364;362;300;62
6;260416;260400;26-035;343;235;234;171;63
7;260416;260400;26-035;332;268;267;180;87
8;260416;260400;26-035;275;209;208;132;76
9;260416;260400;26-035;530;376;372;257;115
10;260416;260400;26-035;485;302;301;232;69
1;260417;260400;26-052;784;611;611;325;286
2;260417;260400;26-052;708;563;558;254;304
3;260417;260400;26-052;982;749;744;366;378
4;260417;260400;26-052;907;655;649;320;329
5;260417;260400;26-052;890;643;631;348;283
6;260417;260400;26-052;448;313;313;183;130
7;260417;260400;26-052;942;654;647;471;176
8;260417;260400;26-052;345;245;243;173;70
1;260418;260400;26-067;847;608;608;431;177
2;260418;260400;26-067;1018;766;759;503;256
3;260418;260400;26-067;1203;911;908;751;157
4;260418;260400;26-067;732;531;531;476;55
5;260418;260400;26-067;1248;894;886;720;166
6;260418;260400;26-067;1122;841;839;652;187
7;260418;260400;26-067;930;634;627;475;152
8;260418;260400;26-067;735;528;523;381;142
9;260418;260400;26-067;344;261;257;212;45
10;260418;260400;26-067;342;266;264;233;31
11;260418;260400;26-067;47;12;12;11;1
1;260419;260400;26-050;452;326;320;188;132
2;260419;260400;26-050;1305;995;985;478;507
3;260419;260400;26-050;453;352;349;202;147
4;260419;260400;26-050;1486;1084;1074;675;399
5;260419;260400;26-050;517;368;366;252;114
6;260419;260400;26-050;1108;793;782;480;302
7;260419;260400;26-050;423;285;281;225;56
8;260419;260400;26-050;690;487;481;326;155
9;260419;260400;26-050;649;459;459;309;150
10;260419;260400;26-050;958;699;686;397;289
11;260419;260400;26-050;417;275;275;207;68
12;260419;260400;26-050;274;202;202;98;104
13;260419;260400;26-050;961;708;705;436;269
1;260501;260500;26-260;958;668;664;541;123
2;260501;260500;26-260;1300;964;950;707;243
3;260501;260500;26-260;413;286;285;253;32
4;260501;260500;26-260;185;139;137;108;29
5;260501;260500;26-260;279;187;185;152;33
6;260501;260500;26-260;206;153;153;133;20
1;260502;260500;26-225;1047;726;720;493;227
2;260502;260500;26-225;480;327;324;228;96
3;260502;260500;26-225;783;525;522;420;102
4;260502;260500;26-225;626;417;411;341;70
5;260502;260500;26-225;670;451;449;357;92
1;260503;260500;26-200;1128;819;815;420;395
2;260503;260500;26-200;1145;837;830;388;442
3;260503;260500;26-200;937;626;625;326;299
4;260503;260500;26-200;1322;973;964;486;478
5;260503;260500;26-200;1069;885;877;406;471
6;260503;260500;26-200;1032;802;799;424;375
7;260503;260500;26-200;846;627;620;359;261
8;260503;260500;26-200;1242;945;936;420;516
9;260503;260500;26-200;1129;801;798;400;398
10;260503;260500;26-200;1033;733;724;352;372
11;260503;260500;26-200;1146;793;783;404;379
12;260503;260500;26-200;1604;1129;1123;578;545
13;260503;260500;26-200;678;475;472;365;107
14;260503;260500;26-200;581;397;394;220;174
15;260503;260500;26-200;1216;768;766;506;260
16;260503;260500;26-200;1362;908;904;537;367
17;260503;260500;26-200;1295;877;868;400;468
18;260503;260500;26-200;593;432;430;252;178
19;260503;260500;26-220;382;266;264;178;86
20;260503;260500;26-200;1124;808;796;644;152
21;260503;260500;26-200;1247;890;880;638;242
22;260503;260500;26-200;1735;1249;1244;953;291
23;260503;260500;26-200;1373;1008;999;715;284
24;260503;260500;26-200;232;182;179;90;89
25;260503;260500;26-200;272;196;193;138;55
26;260503;260500;26-200;114;65;64;53;11
27;260503;260500;26-200;370;142;138;82;56
1;260504;260500;26-230;1378;949;936;751;185
2;260504;260500;26-230;1082;728;722;553;169
3;260504;260500;26-230;791;536;532;405;127
4;260504;260500;26-230;729;515;513;426;87
5;260504;260500;26-230;423;319;318;259;59
6;260504;260500;26-230;475;325;323;262;61
7;260504;260500;26-230;842;626;621;535;86
8;260504;260500;26-230;400;270;267;233;34
9;260504;260500;26-212;417;272;268;226;42
1;260505;260500;26-242;303;218;217;143;74
2;260505;260500;26-242;853;602;597;358;239
3;260505;260500;26-242;217;155;155;113;42
4;260505;260500;26-242;531;394;391;355;36
5;260505;260500;26-242;228;165;165;121;44
6;260505;260500;26-242;257;184;182;134;48
1;260506;260500;26-234;521;363;362;268;94
2;260506;260500;26-234;260;171;168;127;41
3;260506;260500;26-234;619;442;438;351;87
4;260506;260500;26-234;401;302;300;263;37
5;260506;260500;26-234;381;251;248;192;56
6;260506;260500;26-234;201;143;142;114;28
7;260506;260500;26-234;58;30;23;18;5
1;260507;260500;26-212;320;223;222;168;54
2;260507;260500;26-212;803;558;553;442;111
3;260507;260500;26-212;259;168;168;130;38
4;260507;260500;26-212;807;513;510;374;136
5;260507;260500;26-212;380;275;272;224;48
6;260507;260500;26-212;185;142;142;129;13
7;260507;260500;26-212;200;159;158;124;34
1;260508;260500;26-220;676;403;400;210;190
2;260508;260500;26-220;681;426;425;239;186
3;260508;260500;26-220;945;620;618;312;306
4;260508;260500;26-220;985;666;665;359;306
5;260508;260500;26-220;713;451;447;244;203
6;260508;260500;26-220;657;413;409;260;149
7;260508;260500;26-220;939;548;542;385;157
8;260508;260500;26-220;661;418;414;236;178
9;260508;260500;26-220;781;523;517;278;239
10;260508;260500;26-220;313;219;216;178;38
11;260508;260500;26-220;716;508;502;368;134
12;260508;260500;26-220;419;270;269;187;82
13;260508;260500;26-220;478;289;285;175;110
14;260508;260500;26-220;502;311;309;234;75
15;260508;260500;26-220;465;278;276;182;94
16;260508;260500;26-220;593;383;380;267;113
17;260508;260500;26-220;640;382;380;261;119
18;260508;260500;26-220;404;288;288;237;51
19;260508;260500;26-220;305;204;203;126;77
20;260508;260500;26-220;228;154;152;127;25
21;260508;260500;26-220;264;181;180;128;52
22;260508;260500;26-220;109;100;100;66;34
1;260601;260600;27-552;1713;1160;1156;917;239
2;260601;260600;27-552;804;542;542;454;88
3;260601;260600;27-552;633;387;385;325;60
4;260601;260600;27-552;502;333;332;289;43
5;260601;260600;27-552;39;22;20;14;6
1;260602;260600;27-570;1681;1212;1205;931;274
2;260602;260600;27-570;769;491;491;416;75
3;260602;260600;27-570;268;167;165;137;28
4;260602;260600;27-570;244;157;155;139;16
5;260602;260600;27-570;471;344;343;297;46
6;260602;260600;27-570;321;187;185;155;30
7;260602;260600;27-570;305;237;233;205;28
8;260602;260600;27-570;302;195;195;164;31
9;260602;260600;27-570;176;114;113;103;10
10;260602;260600;27-570;214;141;140;126;14
11;260602;260600;27-570;248;178;175;155;20
12;260602;260600;27-570;45;32;27;17;10
1;260603;260600;27-540;280;200;198;139;59
2;260603;260600;27-545;1117;687;676;516;160
3;260603;260600;27-540;277;192;192;135;57
4;260603;260600;27-540;339;220;215;188;27
5;260603;260600;27-540;245;148;147;106;41
6;260603;260600;27-540;384;245;242;202;40
7;260603;260600;27-540;222;152;151;111;40
8;260603;260600;27-540;230;156;152;129;23
9;260603;260600;27-540;194;116;115;98;17
10;260603;260600;27-540;140;103;101;91;10
11;260603;260600;27-540;335;202;200;159;41
12;260603;260600;27-641;162;95;95;78;17
1;260604;260600;27-500;1131;750;742;442;300
2;260604;260600;27-500;1083;680;672;410;262
3;260604;260600;27-500;1033;707;700;422;278
4;260604;260600;27-500;1356;934;926;563;363
5;260604;260600;27-500;633;404;397;303;94
6;260604;260600;27-500;298;187;186;133;53
7;260604;260600;27-500;550;350;344;284;60
8;260604;260600;27-500;511;351;347;273;74
9;260604;260600;27-500;363;242;240;189;51
10;260604;260600;27-500;968;583;579;444;135
11;260604;260600;27-500;166;115;112;72;40
12;260604;260600;27-500;215;156;154;102;52
13;260604;260600;27-500;108;103;94;80;14
14;260604;260600;27-500;38;38;38;37;1
15;260604;260600;27-500;65;27;27;17;10
1;260605;260600;27-530;1192;779;773;481;292
2;260605;260600;27-530;965;623;615;346;269
3;260605;260600;27-530;1017;646;645;352;293
4;260605;260600;27-530;273;163;162;105;57
5;260605;260600;27-530;434;254;253;196;57
6;260605;260600;27-530;141;103;100;74;26
7;260605;260600;27-530;351;217;217;159;58
8;260605;260600;27-530;505;318;316;245;71
9;260605;260600;27-530;432;269;267;210;57
10;260605;260600;27-530;417;243;240;183;57
11;260605;260600;27-530;400;234;230;148;82
12;260605;260600;27-630;196;113;112;87;25
13;260605;260600;27-530;186;130;129;100;29
14;260605;260600;27-530;302;198;195;124;71
15;260605;260600;27-530;411;252;250;188;62
16;260605;260600;27-530;223;162;162;119;43
17;260605;260600;27-530;168;92;92;75;17
18;260605;260600;27-530;163;97;96;80;16
19;260605;260600;27-530;45;44;41;31;10
20;260605;260600;27-530;32;26;25;21;4
21;260605;260600;27-530;22;21;19;15;4
1;260606;260600;27-580;594;358;356;314;42
2;260606;260600;27-580;598;410;405;265;140
3;260606;260600;27-580;440;282;279;218;61
4;260606;260600;27-580;420;282;279;245;34
5;260606;260600;27-580;233;160;158;122;36
6;260606;260600;27-580;207;131;131;116;15
7;260606;260600;27-580;255;167;166;132;34
8;260606;260600;27-580;218;131;130;101;29
1;260607;260600;27-515;1101;690;683;494;189
2;260607;260600;27-515;513;300;299;263;36
3;260607;260600;27-515;685;423;418;343;75
4;260607;260600;27-515;225;151;151;115;36
5;260607;260600;27-515;764;492;489;418;71
6;260607;260600;27-515;604;366;365;285;80
1;260608;260600;27-532;595;369;365;263;102
2;260608;260600;27-532;754;476;472;358;114
3;260608;260600;27-532;619;404;398;279;119
4;260608;260600;27-532;567;350;346;226;120
5;260608;260600;27-532;228;154;152;114;38
6;260608;260600;27-532;237;174;172;127;45
1;260701;260700;27-400;1152;727;722;389;333
2;260701;260700;27-400;1083;705;700;406;294
3;260701;260700;27-400;1355;837;824;477;347
4;260701;260700;27-400;1525;916;906;490;416
5;260701;260700;27-400;1228;733;723;318;405
6;260701;260700;27-400;863;501;498;246;252
7;260701;260700;27-400;1185;667;660;355;305
8;260701;260700;27-400;1191;680;670;368;302
9;260701;260700;27-400;1155;842;838;416;422
10;260701;260700;27-400;1185;803;797;403;394
11;260701;260700;27-400;1746;1108;1104;514;590
12;260701;260700;27-400;1264;786;778;374;404
13;260701;260700;27-400;1169;751;734;331;403
14;260701;260700;27-400;1519;967;958;462;496
15;260701;260700;27-400;1721;1093;1087;514;573
16;260701;260700;27-400;1641;1047;1041;578;463
17;260701;260700;27-400;1752;1182;1175;611;564
18;260701;260700;27-400;1117;736;733;370;363
19;260701;260700;27-400;1149;723;715;355;360
20;260701;260700;27-400;1244;855;844;465;379
21;260701;260700;27-400;1017;679;677;311;366
22;260701;260700;27-400;1804;1230;1222;639;583
23;260701;260700;27-400;968;670;665;346;319
24;260701;260700;27-400;897;629;623;324;299
25;260701;260700;27-400;988;654;652;302;350
26;260701;260700;27-400;978;629;627;318;309
27;260701;260700;27-400;912;627;622;316;306
28;260701;260700;27-400;916;619;613;317;296
29;260701;260700;27-400;1734;1262;1251;568;683
30;260701;260700;27-400;1764;1263;1253;563;690
31;260701;260700;27-400;1656;1164;1159;623;536
32;260701;260700;27-400;1367;972;967;457;510
33;260701;260700;27-400;2316;1569;1556;818;738
34;260701;260700;27-400;1458;1002;992;540;452
35;260701;260700;27-400;1567;933;920;535;385
36;260701;260700;27-400;146;124;120;42;78
37;260701;260700;27-400;97;50;46;16;30
38;260701;260700;27-400;328;127;126;84;42
1;260702;260700;27-423;635;428;423;229;194
2;260702;260700;27-423;515;334;331;219;112
3;260702;260700;27-423;220;155;154;115;39
4;260702;260700;27-423;489;305;303;247;56
5;260702;260700;27-423;72;54;54;45;9
6;260702;260700;27-423;198;122;119;95;24
7;260702;260700;27-423;171;116;112;92;20
8;260702;260700;27-423;234;144;143;88;55
9;260702;260700;27-423;150;104;103;79;24
1;260703;260700;27-420;1141;727;727;426;301
2;260703;260700;27-400;666;438;436;268;168
3;260703;260700;27-400;637;416;414;309;105
4;260703;260700;27-400;1653;1133;1122;609;513
5;260703;260700;27-400;275;187;184;124;60
6;260703;260700;27-400;623;375;372;227;145
7;260703;260700;27-400;851;544;540;342;198
8;260703;260700;27-400;653;404;399;230;169
9;260703;260700;27-420;494;323;319;186;133
10;260703;260700;27-420;520;338;333;222;111
11;260703;260700;27-420;639;389;383;220;163
12;260703;260700;27-400;341;214;213;164;49
13;260703;260700;27-400;532;324;319;215;104
14;260703;260700;27-400;360;207;205;143;62
15;260703;260700;27-400;318;219;218;117;101
16;260703;260700;27-400;211;141;140;99;41
1;260704;260700;27-440;1188;732;724;471;253
2;260704;260700;27-440;1553;944;937;579;358
3;260704;260700;27-440;532;348;343;215;128
4;260704;260700;27-440;322;198;197;119;78
5;260704;260700;27-440;310;188;188;144;44
6;260704;260700;27-440;320;204;200;139;61
7;260704;260700;27-440;552;334;331;203;128
8;260704;260700;27-440;374;244;241;144;97
9;260704;260700;27-440;223;138;137;106;31
1;260705;260700;27-415;390;260;256;200;56
2;260705;260700;27-415;205;129;129;106;23
3;260705;260700;27-415;344;226;225;177;48
4;260705;260700;27-415;857;578;573;371;202
5;260705;260700;27-415;957;629;624;403;221
6;260705;260700;27-415;1561;1055;1042;630;412
7;260705;260700;27-415;501;289;288;157;131
8;260705;260700;27-415;407;271;270;177;93
9;260705;260700;27-415;564;361;360;260;100
10;260705;260700;27-415;315;215;214;150;64
11;260705;260700;27-415;394;243;242;149;93
12;260705;260700;27-415;311;190;188;132;56
13;260705;260700;27-415;255;149;148;94;54
14;260705;260700;27-415;175;121;121;87;34
1;260706;260700;27-425;1058;689;689;520;169
2;260706;260700;27-425;620;393;390;328;62
3;260706;260700;27-425;537;362;362;322;40
4;260706;260700;27-425;583;372;370;299;71
5;260706;260700;27-425;434;276;273;213;60
6;260706;260700;27-425;577;392;390;354;36
7;260706;260700;27-425;316;199;197;150;47
8;260706;260700;27-425;460;293;291;250;41
9;260706;260700;27-425;257;150;149;109;40
10;260706;260700;27-425;185;128;126;111;15
1;260801;260800;28-440;736;433;428;272;156
2;260801;260800;28-440;842;541;540;382;158
3;260801;260800;28-440;823;519;513;413;100
4;260801;260800;28-440;437;254;254;148;106
5;260801;260800;28-440;567;353;353;239;114
6;260801;260800;28-440;504;320;317;242;75
1;260802;260800;28-404;274;191;191;131;60
2;260802;260800;28-404;1296;861;852;649;203
3;260802;260800;28-404;669;471;471;397;74
4;260802;260800;28-404;817;606;604;437;167
5;260802;260800;28-404;254;174;172;127;45
6;260802;260800;28-404;171;128;128;96;32
1;260803;260800;28-411;581;427;424;286;138
2;260803;260800;28-411;627;421;420;329;91
3;260803;260800;28-411;1215;813;807;523;284
4;260803;260800;28-411;432;260;256;225;31
5;260803;260800;28-411;305;210;210;180;30
6;260803;260800;28-411;393;262;261;202;59
1;260804;260800;28-400;1038;674;671;387;284
2;260804;260800;28-400;962;641;640;334;306
3;260804;260800;28-400;1140;728;722;405;317
4;260804;260800;28-400;1263;832;825;398;427
5;260804;260800;28-400;1248;851;848;473;375
6;260804;260800;28-400;950;689;686;380;306
7;260804;260800;28-400;888;598;594;307;287
8;260804;260800;28-400;1031;706;701;498;203
9;260804;260800;28-400;1172;772;768;514;254
10;260804;260800;28-400;845;532;530;442;88
11;260804;260800;28-400;1145;704;698;519;179
12;260804;260800;28-400;782;512;508;419;89
13;260804;260800;28-400;805;510;505;326;179
14;260804;260800;28-400;819;492;488;346;142
15;260804;260800;28-400;911;562;559;431;128
16;260804;260800;28-400;157;28;25;14;11
17;260804;260800;28-400;76;20;19;11;8
18;260804;260800;28-400;612;486;473;114;359
1;260805;260800;28-425;1097;681;679;449;230
2;260805;260800;28-425;981;625;623;415;208
3;260805;260800;28-425;839;567;566;462;104
4;260805;260800;28-425;289;206;205;151;54
5;260805;260800;28-425;291;212;211;164;47
1;260901;260900;27-600;1622;1097;1089;634;455
2;260901;260900;27-600;1396;929;920;487;433
3;260901;260900;27-600;1050;734;727;381;346
4;260901;260900;27-600;617;460;455;210;245
5;260901;260900;27-600;1088;756;753;403;350
6;260901;260900;27-600;1400;893;888;440;448
7;260901;260900;27-600;838;610;609;253;356
8;260901;260900;27-600;1502;1016;1009;501;508
9;260901;260900;27-600;1340;980;974;387;587
10;260901;260900;27-600;977;646;643;352;291
11;260901;260900;27-600;1158;851;848;374;474
12;260901;260900;27-600;1664;1205;1200;554;646
13;260901;260900;27-600;1883;1253;1245;685;560
14;260901;260900;27-600;366;161;155;108;47
15;260901;260900;27-600;85;50;47;35;12
1;260902;260900;27-620;1313;820;812;492;320
2;260902;260900;27-600;352;233;231;154;77
3;260902;260900;27-620;307;188;186;117;69
4;260902;260900;27-600;575;391;385;276;109
5;260902;260900;27-620;485;295;293;170;123
6;260902;260900;27-620;484;272;268;165;103
7;260902;260900;27-620;544;328;325;193;132
8;260902;260900;27-600;609;367;367;261;106
9;260902;260900;27-620;242;166;166;118;48
10;260902;260900;27-620;350;217;215;159;56
11;260902;260900;27-620;182;120;120;75;45
12;260902;260900;27-620;249;141;140;101;39
13;260902;260900;27-620;306;198;197;116;81
14;260902;260900;27-600;479;318;313;193;120
1;260903;260900;27-640;754;491;487;288;199
2;260903;260900;27-640;447;284;283;229;54
3;260903;260900;27-640;235;166;164;132;32
4;260903;260900;27-640;414;276;276;201;75
5;260903;260900;27-640;520;317;316;240;76
6;260903;260900;27-640;570;380;379;334;45
7;260903;260900;27-640;353;229;227;199;28
8;260903;260900;27-640;293;177;176;137;39
9;260903;260900;27-640;369;223;218;188;30
10;260903;260900;27-640;388;246;243;190;53
11;260903;260900;27-640;310;206;204;182;22
12;260903;260900;27-640;254;172;171;129;42
13;260903;260900;27-640;192;134;133;126;7
14;260903;260900;27-640;645;430;426;270;156
15;260903;260900;27-640;238;160;158;125;33
1;260904;260900;27-660;1839;1258;1254;927;327
2;260904;260900;27-660;384;263;262;200;62
3;260904;260900;27-660;359;251;249;207;42
4;260904;260900;27-660;423;283;283;216;67
5;260904;260900;27-660;281;186;185;153;32
6;260904;260900;27-660;388;271;268;198;70
7;260904;260900;27-660;555;357;355;267;88
8;260904;260900;27-660;265;198;196;146;50
9;260904;260900;27-660;200;131;131;115;16
10;260904;260900;27-660;165;100;99;68;31
11;260904;260900;27-660;177;118;118;84;34
1;260905;260900;27-670;2188;1473;1455;1084;371
2;260905;260900;27-670;587;390;387;324;63
3;260905;260900;27-670;851;576;574;434;140
4;260905;260900;27-670;1188;814;803;631;172
5;260905;260900;27-670;148;96;93;68;25
6;260905;260900;27-670;365;245;245;188;57
7;260905;260900;27-670;382;254;254;207;47
1;260906;260900;27-641;679;410;408;250;158
2;260906;260900;27-641;789;562;562;452;110
3;260906;260900;27-641;633;411;404;283;121
4;260906;260900;27-641;961;605;604;498;106
5;260906;260900;27-600;728;505;502;267;235
6;260906;260900;27-641;283;188;186;156;30
7;260906;260900;27-641;817;553;548;429;119
1;260907;260900;27-650;565;386;384;279;105
2;260907;260900;27-650;806;598;591;437;154
3;260907;260900;27-650;782;554;546;387;159
4;260907;260900;27-650;422;286;283;200;83
5;260907;260900;27-650;813;512;507;367;140
6;260907;260900;27-650;819;513;513;368;145
7;260907;260900;27-650;851;566;563;354;209
8;260907;260900;27-650;438;301;300;247;53
9;260907;260900;27-650;382;274;273;214;59
10;260907;260900;27-650;536;382;382;293;89
1;260908;260900;27-612;854;539;536;389;147
2;260908;260900;27-612;341;214;213;142;71
3;260908;260900;27-612;299;217;212;146;66
4;260908;260900;27-612;568;371;369;254;115
5;260908;260900;27-612;325;201;201;144;57
6;260908;260900;27-612;170;127;127;97;30
7;260908;260900;27-612;245;155;153;122;31
1;260909;260900;27-630;1285;879;867;564;303
2;260909;260900;27-630;449;236;235;161;74
3;260909;260900;27-630;660;370;364;284;80
4;260909;260900;27-630;163;106;104;75;29
5;260909;260900;27-630;168;105;103;91;12
6;260909;260900;27-530;194;133;130;94;36
7;260909;260900;27-630;287;181;178;101;77
1;261001;261000;26-110;1064;710;702;403;299
2;261001;261000;26-110;1087;800;793;396;397
3;261001;261000;26-110;1096;717;711;353;358
4;261001;261000;26-110;607;398;396;217;179
5;261001;261000;26-110;998;582;576;312;264
6;261001;261000;26-110;666;445;440;250;190
7;261001;261000;26-110;549;280;277;169;108
8;261001;261000;26-110;632;419;414;209;205
9;261001;261000;26-110;999;767;755;340;415
10;261001;261000;26-110;759;537;532;317;215
11;261001;261000;26-110;1160;823;818;404;414
12;261001;261000;26-110;1447;976;966;513;453
13;261001;261000;26-110;883;589;580;287;293
14;261001;261000;26-110;1388;931;926;526;400
15;261001;261000;26-110;713;464;461;226;235
16;261001;261000;26-110;956;740;734;287;447
17;261001;261000;26-110;811;558;548;244;304
18;261001;261000;26-110;1117;819;814;393;421
19;261001;261000;26-110;1441;1050;1041;481;560
20;261001;261000;26-110;1128;811;800;429;371
21;261001;261000;26-110;1449;1041;1034;500;534
22;261001;261000;26-110;990;674;669;325;344
23;261001;261000;26-110;945;706;699;354;345
24;261001;261000;26-110;1436;931;917;466;451
25;261001;261000;26-110;1561;1021;1012;485;527
26;261001;261000;26-110;842;512;508;270;238
27;261001;261000;26-110;1150;827;823;402;421
28;261001;261000;26-110;950;628;617;280;337
29;261001;261000;26-110;869;625;623;316;307
30;261001;261000;26-110;794;530;528;254;274
31;261001;261000;26-110;798;511;507;230;277
32;261001;261000;26-110;92;66;66;46;20
33;261001;261000;26-110;34;9;9;4;5
34;261001;261000;26-110;42;17;17;3;14
35;261001;261000;26-110;57;48;44;29;15
1;261002;261000;26-120;1300;934;920;515;405
2;261002;261000;26-120;1934;1238;1225;703;522
3;261002;261000;26-120;1446;915;907;666;241
4;261002;261000;26-120;830;543;540;417;123
5;261002;261000;26-120;568;386;380;267;113
1;261003;261000;26-140;784;572;566;415;151
2;261003;261000;26-140;234;171;170;115;55
3;261003;261000;26-140;213;115;115;85;30
4;261003;261000;26-140;585;429;426;318;108
5;261003;261000;26-140;471;310;302;240;62
6;261003;261000;26-140;924;638;633;501;132
7;261003;261000;26-140;254;182;176;142;34
8;261003;261000;26-140;451;303;297;224;73
1;261004;261000;26-115;683;434;424;296;128
2;261004;261000;26-115;196;156;155;106;49
3;261004;261000;26-115;824;548;546;353;193
4;261004;261000;26-110;857;575;567;306;261
5;261004;261000;26-115;515;373;368;288;80
6;261004;261000;26-115;306;216;212;151;61
7;261004;261000;26-115;1032;707;699;411;288
1;261005;261000;26-130;593;407;405;242;163
2;261005;261000;26-130;883;626;623;316;307
3;261005;261000;26-130;517;350;347;134;213
4;261005;261000;26-130;652;472;467;207;260
5;261005;261000;26-130;583;397;393;206;187
6;261005;261000;26-130;479;295;295;142;153
7;261005;261000;26-130;475;298;293;176;117
8;261005;261000;26-130;966;695;692;328;364
9;261005;261000;26-130;830;543;539;301;238
10;261005;261000;26-130;704;465;462;298;164
11;261005;261000;26-130;313;210;210;119;91
12;261005;261000;26-130;332;224;223;114;109
1;261101;261100;27-200;1798;1253;1246;646;600
2;261101;261100;27-200;1131;696;687;380;307
3;261101;261100;27-200;1232;791;788;377;411
4;261101;261100;27-200;1689;1103;1093;561;532
5;261101;261100;27-200;1890;1373;1362;594;768
6;261101;261100;27-200;1288;911;904;436;468
7;261101;261100;27-200;2169;1468;1456;714;742
8;261101;261100;27-200;1018;737;732;350;382
9;261101;261100;27-200;1580;1118;1113;525;588
10;261101;261100;27-200;1864;1262;1252;607;645
11;261101;261100;27-200;1216;789;783;399;384
12;261101;261100;27-200;1733;1071;1056;588;468
13;261101;261100;27-200;1628;1110;1093;554;539
14;261101;261100;27-200;1093;692;690;339;351
15;261101;261100;27-200;1460;939;928;505;423
16;261101;261100;27-200;1142;751;749;474;275
17;261101;261100;27-200;1200;820;814;433;381
18;261101;261100;27-200;1435;1006;994;472;522
19;261101;261100;27-200;1995;1353;1345;765;580
20;261101;261100;27-200;1761;1288;1273;560;713
21;261101;261100;27-200;1692;1187;1170;566;604
22;261101;261100;27-200;1513;1032;1022;570;452
23;261101;261100;27-200;324;117;117;73;44
24;261101;261100;27-200;111;38;37;28;9
1;261102;261100;27-230;733;511;505;312;193
2;261102;261100;27-230;637;456;452;273;179
3;261102;261100;27-230;661;423;419;302;117
4;261102;261100;27-230;672;443;437;292;145
5;261102;261100;27-230;683;442;441;312;129
6;261102;261100;27-230;381;264;260;190;70
7;261102;261100;27-230;749;467;466;317;149
8;261102;261100;27-230;773;518;510;384;126
9;261102;261100;27-230;466;317;314;230;84
10;261102;261100;27-230;624;393;393;291;102
11;261102;261100;27-230;807;484;480;324;156
12;261102;261100;27-230;911;594;592;415;177
13;261102;261100;27-230;76;29;27;19;8
1;261103;261100;27-220;1010;729;725;516;209
2;261103;261100;27-220;409;302;297;242;55
3;261103;261100;27-220;654;454;454;387;67
4;261103;261100;27-220;920;620;617;491;126
5;261103;261100;27-220;615;435;431;281;150
6;261103;261100;27-220;707;491;488;339;149
7;261103;261100;27-220;595;404;400;326;74
8;261103;261100;27-220;406;297;296;202;94
9;261103;261100;27-220;715;535;532;403;129
10;261103;261100;27-220;308;225;225;178;47
1;261104;261100;27-225;473;337;335;291;44
2;261104;261100;27-225;552;353;352;286;66
3;261104;261100;27-225;1109;775;772;608;164
4;261104;261100;27-225;432;310;308;263;45
5;261104;261100;27-225;1460;975;967;735;232
6;261104;261100;27-225;747;560;558;496;62
7;261104;261100;27-225;424;273;272;224;48
8;261104;261100;27-225;1198;733;726;600;126
9;261104;261100;27-225;1501;982;977;800;177
10;261104;261100;27-225;667;433;430;354;76
11;261104;261100;27-225;493;332;332;271;61
12;261104;261100;27-225;460;338;335;296;39
13;261104;261100;27-225;589;392;390;336;54
14;261104;261100;27-225;307;203;203;170;33
15;261104;261100;27-225;397;254;249;206;43
16;261104;261100;27-225;648;431;428;356;72
17;261104;261100;27-225;86;46;42;25;17
1;261105;261100;27-215;999;710;706;409;297
2;261105;261100;27-215;972;650;644;355;289
3;261105;261100;27-215;1151;799;789;525;264
4;261105;261100;27-215;1108;767;760;434;326
5;261105;261100;27-215;440;262;260;154;106
6;261105;261100;27-215;399;265;265;156;109
1;261201;261200;28-210;1430;992;985;683;302
2;261201;261200;28-210;787;517;513;389;124
3;261201;261200;28-210;398;273;271;212;59
4;261201;261200;28-210;213;145;144;118;26
5;261201;261200;28-210;1277;834;827;652;175
6;261201;261200;28-210;844;540;537;450;87
7;261201;261200;28-210;479;298;298;214;84
8;261201;261200;28-210;274;198;197;168;29
9;261201;261200;28-210;151;98;97;83;14
10;261201;261200;28-210;68;34;24;17;7
1;261202;261200;28-232;1167;777;766;588;178
2;261202;261200;28-232;638;425;424;358;66
3;261202;261200;28-232;851;563;559;471;88
4;261202;261200;28-232;514;371;365;308;57
1;261203;261200;28-220;442;287;286;242;44
2;261203;261200;28-220;851;554;551;397;154
3;261203;261200;28-220;700;438;435;318;117
4;261203;261200;28-220;220;129;129;82;47
5;261203;261200;28-220;267;165;164;121;43
6;261203;261200;28-220;168;114;114;90;24
7;261203;261200;28-220;330;183;183;132;51
1;261204;261200;28-221;1500;1052;1046;861;185
2;261204;261200;28-221;213;139;139;100;39
3;261204;261200;28-221;512;345;343;302;41
4;261204;261200;28-221;730;512;512;480;32
5;261204;261200;28-221;808;570;570;537;33
6;261204;261200;28-221;327;204;203;164;39
7;261204;261200;28-221;483;348;345;315;30
8;261204;261200;28-221;567;393;391;362;29
9;261204;261200;28-221;356;255;254;225;29
10;261204;261200;28-221;195;148;148;137;11
11;261204;261200;28-221;165;117;117;102;15
1;261205;261200;28-230;987;707;703;461;242
2;261205;261200;28-230;873;732;726;443;283
3;261205;261200;28-230;1322;928;926;608;318
4;261205;261200;28-230;774;534;529;336;193
5;261205;261200;28-230;1041;730;725;501;224
6;261205;261200;28-230;836;613;611;427;184
7;261205;261200;28-230;348;234;234;206;28
8;261205;261200;28-230;556;382;380;313;67
9;261205;261200;28-230;616;403;398;339;59
10;261205;261200;28-230;504;352;350;279;71
11;261205;261200;28-230;196;141;141;121;20
12;261205;261200;28-230;181;124;123;108;15
13;261205;261200;28-230;270;181;181;151;30
1;261206;261200;28-236;1540;1046;1038;680;358
2;261206;261200;28-230;138;108;107;80;27
3;261206;261200;28-236;702;442;436;325;111
4;261206;261200;28-221;324;228;225;209;16
5;261206;261200;28-236;448;311;308;257;51
6;261206;261200;28-236;332;210;207;152;55
7;261206;261200;28-236;320;219;218;176;42
8;261206;261200;28-230;261;185;183;161;22
9;261206;261200;28-221;264;168;166;143;23
10;261206;261200;28-236;351;246;243;201;42
11;261206;261200;28-236;236;157;156;110;46
1;261207;261200;28-200;1569;1187;1183;615;568
2;261207;261200;28-200;716;502;499;265;234
3;261207;261200;28-200;831;553;549;316;233
4;261207;261200;28-200;802;573;569;209;360
5;261207;261200;28-200;941;561;558;333;225
6;261207;261200;28-200;975;670;666;421;245
7;261207;261200;28-200;788;578;573;359;214
8;261207;261200;28-200;663;460;458;257;201
9;261207;261200;28-200;535;335;327;233;94
10;261207;261200;28-200;880;616;610;349;261
11;261207;261200;28-200;800;547;543;315;228
12;261207;261200;28-200;850;600;593;351;242
13;261207;261200;28-200;827;540;537;317;220
14;261207;261200;28-200;539;332;329;277;52
15;261207;261200;28-200;486;312;310;225;85
16;261207;261200;28-200;1001;625;620;520;100
17;261207;261200;28-200;737;479;476;348;128
18;261207;261200;28-200;787;548;544;425;119
19;261207;261200;28-200;555;353;352;256;96
20;261207;261200;28-200;666;456;454;331;123
21;261207;261200;28-200;625;402;401;294;107
22;261207;261200;28-200;806;514;509;328;181
23;261207;261200;28-200;577;384;382;294;88
24;261207;261200;28-200;262;156;154;140;14
25;261207;261200;28-200;239;140;140;122;18
26;261207;261200;28-200;374;288;288;196;92
27;261207;261200;28-200;50;28;28;12;16
28;261207;261200;28-200;85;57;57;48;9
29;261207;261200;28-200;31;20;19;15;4
1;261208;261200;28-225;526;382;379;283;96
2;261208;261200;28-225;493;332;330;258;72
3;261208;261200;28-225;699;437;434;341;93
4;261208;261200;28-225;845;652;646;430;216
5;261208;261200;28-225;453;309;308;259;49
6;261208;261200;28-225;555;402;399;327;72
7;261208;261200;28-225;24;14;14;7;7
1;261301;261300;29-120;1185;874;863;657;206
2;261301;261300;29-120;635;432;430;349;81
3;261301;261300;29-120;859;632;629;514;115
4;261301;261300;29-120;811;584;583;482;101
5;261301;261300;29-120;532;394;388;311;77
1;261302;261300;29-105;1800;1284;1277;939;338
2;261302;261300;29-105;656;452;449;370;79
3;261302;261300;29-105;764;557;552;468;84
4;261302;261300;29-105;1827;1297;1291;989;302
5;261302;261300;29-105;651;443;441;380;61
6;261302;261300;29-105;755;509;504;398;106
7;261302;261300;29-105;1555;1062;1055;781;274
1;261303;261300;29-130;923;606;605;463;142
2;261303;261300;29-130;837;549;545;389;156
3;261303;261300;29-130;223;153;152;122;30
4;261303;261300;29-130;200;132;132;117;15
1;261304;261300;29-135;479;283;282;205;77
2;261304;261300;29-135;638;408;405;301;104
3;261304;261300;29-135;841;578;574;368;206
1;261305;261300;29-145;987;705;700;432;268
2;261305;261300;29-145;537;350;349;277;72
3;261305;261300;29-145;439;290;289;212;77
4;261305;261300;29-145;373;259;257;192;65
5;261305;261300;29-145;297;177;177;136;41
6;261305;261300;29-145;597;417;414;324;90
7;261305;261300;29-145;472;305;301;224;77
8;261305;261300;29-145;51;31;27;9;18
1;261306;261300;29-100;987;764;757;497;260
2;261306;261300;29-100;1685;1230;1224;782;442
3;261306;261300;29-100;887;644;640;374;266
4;261306;261300;29-100;1833;1231;1214;670;544
5;261306;261300;29-100;1845;1355;1345;776;569
6;261306;261300;29-100;1716;1171;1165;897;268
7;261306;261300;29-100;761;488;487;384;103
8;261306;261300;29-100;1173;820;812;608;204
9;261306;261300;29-100;934;666;663;490;173
10;261306;261300;29-100;816;595;591;493;98
11;261306;261300;29-100;994;717;709;586;123
12;261306;261300;29-100;470;327;323;237;86
13;261306;261300;29-100;320;195;192;154;38
14;261306;261300;29-100;83;57;56;45;11
15;261306;261300;29-100;83;53;45;39;6
1;266101;266100;25-546;1997;1446;1432;631;801
2;266101;266100;25-542;1721;1208;1193;637;556
3;266101;266100;25-410;1579;1208;1197;570;627
4;266101;266100;25-411;892;694;692;325;367
5;266101;266100;25-410;1477;1121;1118;518;600
6;266101;266100;25-435;1263;975;965;413;552
7;266101;266100;25-523;1723;1370;1351;544;807
8;266101;266100;25-533;1794;1345;1317;564;753
9;266101;266100;25-520;1849;1404;1392;633;759
10;266101;266100;25-522;1258;898;892;487;405
11;266101;266100;25-317;1586;1190;1184;550;634
12;266101;266100;25-003;1676;1240;1229;512;717
13;266101;266100;25-525;1104;722;711;346;365
14;266101;266100;25-310;1481;1020;1016;503;513
15;266101;266100;25-355;1300;951;940;352;588
16;266101;266100;25-365;1488;1099;1085;410;675
17;266101;266100;25-371;1457;1097;1090;407;683
18;266101;266100;25-669;1698;1170;1157;786;371
19;266101;266100;25-672;1618;1174;1167;679;488
20;266101;266100;25-651;1932;1411;1395;695;700
21;266101;266100;25-659;1805;1339;1326;704;622
22;266101;266100;25-639;1753;1251;1234;793;441
23;266101;266100;25-640;1840;1509;1498;497;1001
24;266101;266100;25-640;1743;1404;1393;523;870
25;266101;266100;25-640;1528;1226;1221;478;743
26;266101;266100;25-636;1971;1512;1496;653;843
27;266101;266100;25-636;1515;1185;1170;429;741
28;266101;266100;25-628;2049;1597;1581;735;846
29;266101;266100;25-628;1840;1418;1407;630;777
30;266101;266100;25-613;1583;1097;1089;579;510
31;266101;266100;25-619;1620;1058;1051;572;479
32;266101;266100;25-623;1980;1347;1334;674;660
33;266101;266100;25-625;1738;1169;1155;594;561
34;266101;266100;25-563;1203;896;890;397;493
35;266101;266100;25-548;2083;1624;1608;658;950
36;266101;266100;25-414;1972;1595;1581;680;901
37;266101;266100;25-549;2169;1652;1632;755;877
38;266101;266100;25-549;1791;1318;1304;582;722
39;266101;266100;25-549;1733;1294;1285;547;738
40;266101;266100;25-435;1245;956;945;450;495
41;266101;266100;25-435;1461;1108;1099;522;577
42;266101;266100;25-431;1897;1448;1434;649;785
43;266101;266100;25-431;2017;1552;1541;710;831
44;266101;266100;25-431;2118;1625;1608;762;846
45;266101;266100;25-437;1830;1433;1424;666;758
46;266101;266100;25-432;1757;1383;1368;656;712
47;266101;266100;25-432;2026;1514;1496;672;824
48;266101;266100;25-432;1889;1377;1365;685;680
49;266101;266100;25-321;1375;1020;1007;469;538
50;266101;266100;25-322;1552;1183;1170;515;655
51;266101;266100;25-327;2104;1676;1665;689;976
52;266101;266100;25-341;1722;1268;1260;579;681
53;266101;266100;25-344;1563;1167;1157;528;629
54;266101;266100;25-344;1442;1042;1032;472;560
55;266101;266100;25-356;1418;993;986;470;516
56;266101;266100;25-361;1497;1104;1099;494;605
57;266101;266100;25-346;2058;1638;1629;691;938
58;266101;266100;25-330;1389;1068;1056;588;468
59;266101;266100;25-395;1919;1451;1439;617;822
60;266101;266100;25-150;2034;1577;1564;663;901
61;266101;266100;25-150;1710;1270;1257;564;693
62;266101;266100;25-150;1997;1513;1500;647;853
63;266101;266100;25-217;1963;1525;1509;590;919
64;266101;266100;25-209;2205;1687;1673;825;848
65;266101;266100;25-825;576;418;413;257;156
66;266101;266100;25-750;1501;1187;1176;512;664
67;266101;266100;25-732;1689;1244;1229;571;658
68;266101;266100;25-750;1571;1189;1178;488;690
69;266101;266100;25-734;1255;1000;993;412;581
70;266101;266100;25-736;1725;1097;1081;600;481
71;266101;266100;25-729;1452;1018;1009;517;492
72;266101;266100;25-604;1712;1236;1223;566;657
73;266101;266100;25-018;1743;1312;1303;644;659
74;266101;266100;25-019;1456;1062;1051;482;569
75;266101;266100;25-801;1273;920;912;499;413
76;266101;266100;25-811;2185;1592;1581;911;670
77;266101;266100;25-804;770;526;521;260;261
78;266101;266100;25-093;1141;822;810;354;456
79;266101;266100;25-033;2186;1665;1650;598;1052
80;266101;266100;25-130;1707;1362;1354;557;797
81;266101;266100;25-120;2106;1645;1636;632;1004
82;266101;266100;25-145;763;595;588;450;138
83;266101;266100;25-147;1363;1017;1010;656;354
84;266101;266100;25-371;98;42;40;26;14
85;266101;266100;25-394;97;52;52;29;23
86;266101;266100;25-369;59;36;36;22;14
87;266101;266100;25-375;50;30;29;20;9
88;266101;266100;25-563;928;637;627;132;495
89;266101;266100;25-316;54;35;35;15;20
90;266101;266100;25-124;64;30;29;10;19
91;266101;266100;25-736;633;276;273;160;113
92;266101;266100;25-734;141;113;111;67;44
93;266101;266100;25-734;140;59;57;45;12
94;266101;266100;25-734;59;29;26;15;11
95;266101;266100;25-562;71;26;25;14;11
1;280101;280100;11-200;1363;838;827;327;500
2;280101;280100;11-200;1668;1156;1146;525;621
3;280101;280100;11-200;1766;1142;1133;480;653
4;280101;280100;11-200;1465;1035;1029;515;514
5;280101;280100;11-200;1386;789;784;350;434
6;280101;280100;11-200;1768;1158;1156;464;692
7;280101;280100;11-200;1584;1096;1092;435;657
8;280101;280100;11-200;1905;1255;1249;592;657
9;280101;280100;11-200;429;291;290;136;154
10;280101;280100;11-200;1567;1064;1057;456;601
11;280101;280100;11-200;887;584;568;247;321
12;280101;280100;11-200;151;40;40;22;18
13;280101;280100;11-200;57;20;19;11;8
1;280102;280100;11-220;1330;846;842;387;455
2;280102;280100;11-220;1433;848;844;381;463
1;280103;280100;11-200;712;454;446;217;229
2;280103;280100;11-200;988;581;570;353;217
3;280103;280100;11-214;861;520;514;287;227
4;280103;280100;11-200;582;320;315;186;129
5;280103;280100;11-200;861;468;465;265;200
6;280103;280100;11-200;556;266;266;166;100
7;280103;280100;11-200;659;382;382;237;145
8;280103;280100;11-200;517;321;317;201;116
9;280103;280100;11-200;488;283;280;191;89
10;280103;280100;11-214;472;292;291;162;129
11;280103;280100;11-200;384;202;202;137;65
12;280103;280100;11-200;662;460;458;234;224
13;280103;280100;11-200;12;12;12;8;4
1;280104;280100;11-230;810;400;398;204;194
2;280104;280100;11-230;836;541;536;246;290
3;280104;280100;11-230;202;110;110;47;63
4;280104;280100;11-230;276;146;143;113;30
5;280104;280100;11-230;589;249;246;145;101
6;280104;280100;11-230;594;308;305;150;155
7;280104;280100;11-230;283;154;154;102;52
8;280104;280100;11-230;195;121;120;58;62
9;280104;280100;11-230;281;176;175;127;48
10;280104;280100;11-230;330;180;179;124;55
1;280105;280100;11-220;723;353;350;216;134
2;280105;280100;11-220;907;490;488;198;290
3;280105;280100;11-220;1011;482;481;291;190
4;280105;280100;11-220;764;429;425;273;152
5;280105;280100;11-220;643;286;282;165;117
6;280105;280100;11-220;355;167;166;104;62
7;280105;280100;11-220;402;220;217;155;62
8;280105;280100;11-220;968;763;745;56;689
9;280105;280100;11-220;28;14;13;6;7
1;280106;280100;11-210;831;503;501;267;234
2;280106;280100;11-210;447;213;211;124;87
3;280106;280100;11-210;344;180;177;118;59
4;280106;280100;11-210;616;247;246;91;155
5;280106;280100;11-210;492;277;274;187;87
6;280106;280100;11-210;369;217;213;130;83
7;280106;280100;11-210;179;105;105;66;39
8;280106;280100;11-210;238;147;147;88;59
9;280106;280100;11-210;261;128;128;83;45
10;280106;280100;11-210;551;362;361;193;168
11;280106;280100;11-210;25;14;14;10;4
1;280201;280200;14-500;1336;817;810;319;491
2;280201;280200;14-500;1230;806;795;361;434
3;280201;280200;14-500;1387;804;792;361;431
4;280201;280200;14-500;1306;843;838;356;482
5;280201;280200;14-500;1492;996;993;415;578
6;280201;280200;14-500;1551;1104;1094;456;638
7;280201;280200;14-500;1313;879;874;386;488
8;280201;280200;14-500;1679;1106;1102;486;616
9;280201;280200;14-500;158;40;39;20;19
10;280201;280200;14-500;103;88;86;18;68
1;280202;280200;14-500;995;522;517;340;177
2;280202;280200;14-500;277;180;178;103;75
3;280202;280200;14-500;837;501;499;318;181
4;280202;280200;14-500;551;306;305;173;132
5;280202;280200;14-500;261;118;118;68;50
6;280202;280200;14-500;661;394;393;199;194
7;280202;280200;14-500;268;166;162;111;51
8;280202;280200;14-500;185;105;104;72;32
9;280202;280200;14-500;355;192;191;110;81
1;280203;280200;14-530;844;432;427;227;200
2;280203;280200;14-530;965;610;603;225;378
3;280203;280200;14-530;661;456;452;180;272
4;280203;280200;14-530;167;94;94;60;34
1;280204;280200;14-521;833;495;492;299;193
2;280204;280200;14-521;499;223;218;134;84
3;280204;280200;14-521;260;137;135;81;54
4;280204;280200;14-521;373;137;134;83;51
1;280205;280200;14-520;1115;744;740;354;386
2;280205;280200;14-520;794;500;498;215;283
3;280205;280200;14-520;842;436;431;301;130
4;280205;280200;14-520;376;217;215;155;60
5;280205;280200;14-520;336;154;154;77;77
6;280205;280200;14-520;338;184;184;124;60
7;280205;280200;14-520;556;292;291;187;104
1;280206;280200;14-526;735;424;420;248;172
2;280206;280200;14-526;462;244;243;109;134
3;280206;280200;14-526;403;214;214;138;76
4;280206;280200;14-526;184;117;116;82;34
1;280207;280200;14-405;589;343;339;183;156
2;280207;280200;14-405;433;233;226;134;92
3;280207;280200;14-405;582;303;300;152;148
4;280207;280200;14-405;418;200;199;134;65
1;280301;280300;13-200;2023;1511;1503;715;788
2;280301;280300;13-200;951;667;660;301;359
3;280301;280300;13-200;920;632;630;300;330
4;280301;280300;13-200;945;587;586;290;296
5;280301;280300;13-200;1512;919;911;484;427
6;280301;280300;13-200;1223;809;802;367;435
7;280301;280300;13-200;1227;781;774;365;409
8;280301;280300;13-200;1061;733;731;361;370
9;280301;280300;13-200;795;538;531;235;296
10;280301;280300;13-200;1116;749;741;412;329
11;280301;280300;13-200;933;669;665;290;375
12;280301;280300;13-200;2213;1484;1469;701;768
13;280301;280300;13-200;100;59;58;38;20
14;280301;280300;13-200;88;74;72;15;57
1;280302;280300;13-200;374;208;208;112;96
2;280302;280300;13-200;308;186;184;121;63
3;280302;280300;13-200;264;178;178;143;35
4;280302;280300;13-200;629;392;392;244;148
5;280302;280300;13-200;499;316;316;195;121
6;280302;280300;13-200;480;245;244;186;58
7;280302;280300;13-200;386;252;252;148;104
8;280302;280300;13-200;409;253;252;141;111
9;280302;280300;13-200;558;333;329;210;119
10;280302;280300;13-200;514;345;343;204;139
11;280302;280300;13-200;379;173;170;127;43
12;280302;280300;13-200;203;113;112;81;31
13;280302;280300;13-200;232;109;109;73;36
14;280302;280300;13-200;226;146;145;119;26
15;280302;280300;13-200;217;135;133;111;22
16;280302;280300;13-200;288;170;167;138;29
17;280302;280300;14-120;354;179;178;151;27
18;280302;280300;13-200;325;171;169;134;35
19;280302;280300;13-200;212;121;120;78;42
20;280302;280300;13-200;272;199;193;97;96
21;280302;280300;13-200;70;34;32;18;14
1;280303;280300;13-240;758;545;541;320;221
2;280303;280300;13-240;1442;975;968;570;398
3;280303;280300;13-240;662;369;367;223;144
4;280303;280300;13-240;472;285;283;231;52
5;280303;280300;13-240;1355;827;819;562;257
6;280303;280300;13-240;193;135;133;90;43
7;280303;280300;13-240;156;96;95;80;15
8;280303;280300;13-240;184;112;110;83;27
1;280304;280300;13-230;1291;879;873;453;420
2;280304;280300;13-230;1479;949;939;522;417
3;280304;280300;13-230;1242;750;743;425;318
4;280304;280300;13-230;781;444;439;270;169
5;280304;280300;13-230;1373;798;787;506;281
6;280304;280300;13-230;492;266;263;207;56
7;280304;280300;13-230;371;236;234;153;81
8;280304;280300;13-230;424;240;239;166;73
9;280304;280300;13-230;398;246;244;183;61
10;280304;280300;13-203;852;513;510;328;182
11;280304;280300;13-230;208;132;131;79;52
12;280304;280300;13-230;363;218;213;150;63
13;280304;280300;13-230;381;234;231;155;76
14;280304;280300;13-230;370;262;260;198;62
15;280304;280300;13-230;238;142;140;102;38
1;280305;280300;13-206;973;622;612;390;222
2;280305;280300;13-206;546;370;362;216;146
3;280305;280300;13-206;248;153;152;113;39
4;280305;280300;13-206;478;299;297;224;73
5;280305;280300;13-230;350;207;207;135;72
6;280305;280300;13-206;236;126;124;105;19
7;280305;280300;13-206;250;150;150;89;61
8;280305;280300;13-206;227;118;114;89;25
9;280305;280300;13-230;313;217;214;180;34
10;280305;280300;13-206;294;182;180;110;70
11;280305;280300;13-206;223;128;127;94;33
1;280306;280300;13-220;396;266;266;200;66
2;280306;280300;13-220;512;336;333;242;91
3;280306;280300;13-220;666;399;395;271;124
4;280306;280300;13-206;426;219;219;145;74
5;280306;280300;13-220;1039;731;723;473;250
6;280306;280300;13-220;484;268;264;181;83
7;280306;280300;13-220;417;276;275;227;48
8;280306;280300;13-220;1125;784;778;424;354
9;280306;280300;13-220;291;198;196;151;45
1;280401;280400;82-300;1059;609;602;346;256
2;280401;280400;82-300;684;399;398;217;181
3;280401;280400;82-300;1454;1034;1026;426;600
4;280401;280400;82-300;920;565;559;255;304
5;280401;280400;82-300;487;286;283;185;98
6;280401;280400;82-300;517;367;365;176;189
7;280401;280400;82-300;233;162;162;87;75
8;280401;280400;82-300;321;205;199;88;111
1;280402;280400;14-407;704;354;353;232;121
2;280402;280400;14-407;864;508;502;301;201
3;280402;280400;14-407;376;204;202;143;59
4;280402;280400;14-407;220;122;121;92;29
1;280403;280400;82-335;1594;967;963;427;536
2;280403;280400;82-335;1474;848;836;404;432
3;280403;280400;82-335;253;143;141;98;43
4;280403;280400;82-335;272;177;174;90;84
1;280404;280400;82-325;683;386;383;229;154
2;280404;280400;82-325;387;243;240;152;88
3;280404;280400;82-325;559;353;346;191;155
4;280404;280400;82-325;396;223;222;141;81
5;280404;280400;82-325;449;286;286;147;139
6;280404;280400;28-325;516;270;268;180;88
1;280405;280400;82-316;1557;1101;1089;568;521
2;280405;280400;82-316;980;587;580;327;253
1;280406;280400;14-420;1244;818;805;337;468
2;280406;280400;14-420;1181;673;664;369;295
3;280406;280400;14-420;665;382;380;230;150
4;280406;280400;14-420;213;154;154;99;55
1;280407;280400;14-400;1051;755;750;319;431
2;280407;280400;14-400;910;622;613;266;347
3;280407;280400;14-400;937;637;631;256;375
4;280407;280400;14-400;1093;703;695;263;432
5;280407;280400;14-400;834;573;569;198;371
6;280407;280400;14-400;899;615;613;237;376
7;280407;280400;14-400;925;544;537;243;294
8;280407;280400;14-400;1035;687;682;273;409
9;280407;280400;14-400;1112;769;763;358;405
10;280407;280400;14-400;419;227;227;128;99
11;280407;280400;14-400;930;450;444;207;237
12;280407;280400;14-400;1246;626;619;331;288
13;280407;280400;14-400;934;515;512;326;186
14;280407;280400;14-400;866;458;455;261;194
15;280407;280400;14-400;224;128;128;61;67
16;280407;280400;14-400;242;148;147;67;80
17;280407;280400;14-400;236;134;132;78;54
18;280407;280400;14-400;29;29;28;17;11
1;280408;280400;14-411;779;431;424;230;194
2;280408;280400;14-411;733;417;415;221;194
3;280408;280400;14-411;1247;620;612;355;257
1;280409;280400;82-340;473;296;294;130;164
2;280409;280400;82-340;637;419;415;197;218
3;280409;280400;82-340;546;318;315;164;151
4;280409;280400;82-340;1809;1154;1147;557;590
5;280409;280400;82-340;92;37;35;21;14
6;280409;280400;82-340;577;383;383;219;164
7;280409;280400;82-340;332;221;221;85;136
8;280409;280400;82-340;153;80;78;48;30
9;280409;280400;82-340;153;67;66;33;33
1;280501;280500;19-300;2730;1713;1703;890;813
2;280501;280500;19-300;2038;1377;1365;708;657
3;280501;280500;19-300;2424;1728;1713;829;884
4;280501;280500;19-300;2359;1489;1478;721;757
5;280501;280500;19-300;1505;946;939;476;463
6;280501;280500;19-300;2304;1448;1434;709;725
7;280501;280500;19-300;1291;817;810;412;398
8;280501;280500;19-300;2296;1245;1236;605;631
9;280501;280500;19-300;2277;1264;1255;660;595
10;280501;280500;19-300;2304;1190;1180;634;546
11;280501;280500;19-300;2378;1275;1266;711;555
12;280501;280500;19-300;2476;1460;1448;658;790
13;280501;280500;19-300;1931;1208;1199;559;640
14;280501;280500;19-300;2461;1777;1762;801;961
15;280501;280500;19-300;2368;1498;1494;738;756
16;280501;280500;19-300;2122;1335;1329;713;616
17;280501;280500;19-300;2054;1319;1309;706;603
18;280501;280500;19-300;2691;1835;1824;997;827
19;280501;280500;19-300;1277;704;696;376;320
20;280501;280500;19-300;98;50;48;22;26
21;280501;280500;19-300;71;16;16;7;9
22;280501;280500;19-300;108;45;41;20;21
1;280502;280500;19-300;623;362;357;225;132
2;280502;280500;19-301;615;459;453;208;245
3;280502;280500;19-301;451;294;292;190;102
4;280502;280500;19-321;1059;637;632;380;252
5;280502;280500;19-321;789;400;399;284;115
6;280502;280500;19-300;930;695;688;282;406
7;280502;280500;19-301;278;141;138;92;46
8;280502;280500;12-250;411;233;231;154;77
9;280502;280500;19-300;593;378;376;183;193
10;280502;280500;19-300;686;479;478;250;228
11;280502;280500;19-325;1662;983;980;492;488
12;280502;280500;19-311;289;165;163;99;64
13;280502;280500;19-300;156;94;92;63;29
14;280502;280500;19-300;249;168;168;61;107
15;280502;280500;19-321;160;101;101;66;35
16;280502;280500;19-311;158;69;69;42;27
17;280502;280500;19-321;204;59;56;31;25
1;280503;280500;19-314;1560;851;848;590;258
2;280503;280500;19-314;625;331;331;257;74
3;280503;280500;19-314;605;281;276;203;73
4;280503;280500;19-314;679;342;340;235;105
5;280503;280500;19-314;597;315;313;209;104
6;280503;280500;19-314;747;395;386;263;123
7;280503;280500;19-314;45;36;33;19;14
1;280504;280500;19-335;786;429;429;253;176
2;280504;280500;19-335;923;490;482;284;198
3;280504;280500;19-335;542;330;326;224;102
4;280504;280500;19-335;788;360;359;274;85
5;280504;280500;19-335;350;161;158;99;59
6;280504;280500;19-335;674;339;335;252;83
7;280504;280500;19-335;547;231;229;162;67
8;280504;280500;19-335;603;312;309;249;60
1;280505;280500;19-330;1043;622;619;356;263
2;280505;280500;19-330;284;136;133;82;51
3;280505;280500;19-330;356;163;160;98;62
4;280505;280500;19-330;1130;641;638;334;304
1;280601;280600;11-500;1533;1071;1061;455;606
2;280601;280600;11-500;1951;1383;1372;486;886
3;280601;280600;11-500;2378;1519;1506;579;927
4;280601;280600;11-500;2156;1412;1403;540;863
5;280601;280600;11-500;2422;1509;1499;597;902
6;280601;280600;11-500;2302;1558;1539;582;957
7;280601;280600;11-500;2658;1833;1810;697;1113
8;280601;280600;11-500;2463;1607;1600;660;940
9;280601;280600;11-500;2404;1633;1620;577;1043
10;280601;280600;11-500;79;53;50;8;42
11;280601;280600;11-500;84;51;50;28;22
12;280601;280600;11-500;126;38;34;18;16
13;280601;280600;11-500;24;18;18;10;8
1;280604;280600;11-500;404;226;225;90;135
2;280604;280600;11-500;524;327;325;152;173
3;280604;280600;11-500;453;317;313;140;173
4;280604;280600;11-500;707;525;522;216;306
5;280604;280600;11-500;501;391;387;154;233
6;280604;280600;11-500;291;232;232;94;138
7;280604;280600;11-500;422;247;242;126;116
8;280604;280600;11-500;211;113;113;68;45
9;280604;280600;11-500;557;416;413;155;258
10;280604;280600;11-500;319;216;214;83;131
11;280604;280600;11-500;192;118;118;64;54
12;280604;280600;11-500;521;371;369;168;201
13;280604;280600;11-500;380;203;196;118;78
14;280604;280600;11-500;391;289;288;116;172
15;280604;280600;11-500;189;168;166;66;100
16;280604;280600;11-500;219;148;146;79;67
17;280604;280600;11-500;176;106;106;64;42
18;280604;280600;11-500;523;436;429;138;291
19;280604;280600;11-500;608;453;447;132;315
1;280605;280600;11-612;1205;843;839;291;548
2;280605;280600;11-612;316;212;210;80;130
3;280605;280600;11-612;509;286;280;168;112
4;280605;280600;11-612;416;222;222;114;108
1;280606;280600;11-513;1198;738;732;413;319
2;280606;280600;11-513;559;313;313;212;101
3;280606;280600;11-513;1285;845;837;400;437
1;280608;280600;11-520;870;482;474;240;234
2;280608;280600;11-520;634;472;466;198;268
3;280608;280600;11-520;911;566;560;238;322
4;280608;280600;11-520;367;223;222;96;126
5;280608;280600;11-520;1084;595;589;360;229
6;280608;280600;11-520;290;157;157;94;63
7;280608;280600;11-520;311;251;249;138;111
1;280610;280600;11-510;593;335;333;183;150
2;280610;280600;11-510;283;151;150;103;47
3;280610;280600;11-510;307;167;165;97;68
4;280610;280600;11-510;545;329;322;212;110
5;280610;280600;11-510;702;471;464;214;250
6;280610;280600;11-510;328;175;174;128;46
7;280610;280600;11-510;297;161;159;114;45
8;280610;280600;11-510;355;207;206;150;56
9;280610;280600;11-510;238;125;121;86;35
10;280610;280600;11-510;977;634;632;304;328
11;280610;280600;11-510;36;21;21;11;10
1;280701;280700;14-200;1902;1451;1440;598;842
2;280701;280700;14-200;1389;931;926;436;490
3;280701;280700;14-200;1464;1042;1036;427;609
4;280701;280700;14-200;1322;891;884;384;500
5;280701;280700;14-200;1785;1313;1301;565;736
6;280701;280700;14-200;783;532;532;230;302
7;280701;280700;14-200;1399;1045;1039;457;582
8;280701;280700;14-200;1680;1316;1300;481;819
9;280701;280700;14-200;1563;1090;1077;498;579
10;280701;280700;14-200;1008;687;682;314;368
11;280701;280700;14-200;1331;911;901;419;482
12;280701;280700;14-200;1336;950;941;419;522
13;280701;280700;14-200;2217;1537;1528;643;885
14;280701;280700;14-200;1793;1252;1244;604;640
15;280701;280700;14-200;1435;996;989;375;614
16;280701;280700;14-200;1225;769;761;370;391
17;280701;280700;14-200;47;22;22;12;10
18;280701;280700;14-200;233;118;117;68;49
19;280701;280700;14-200;1113;832;815;130;685
1;280702;280700;14-260;2245;1568;1551;802;749
2;280702;280700;14-260;1982;1426;1418;784;634
3;280702;280700;14-260;1445;992;986;549;437
4;280702;280700;14-260;1645;1149;1138;648;490
1;280703;280700;14-202;630;370;364;257;107
2;280703;280700;14-200;700;482;479;258;221
3;280703;280700;14-202;647;377;375;251;124
4;280703;280700;14-202;549;338;333;277;56
5;280703;280700;14-230;651;439;436;174;262
6;280703;280700;14-200;646;413;408;228;180
7;280703;280700;14-200;650;387;383;226;157
8;280703;280700;14-200;499;304;301;174;127
9;280703;280700;14-200;962;684;673;263;410
10;280703;280700;14-200;880;655;644;250;394
11;280703;280700;14-200;459;308;307;202;105
12;280703;280700;14-200;292;192;190;141;49
13;280703;280700;14-200;282;155;154;100;54
14;280703;280700;14-200;864;555;555;332;223
15;280703;280700;14-202;626;375;372;241;131
16;280703;280700;14-200;497;332;330;170;160
1;280704;280700;14-220;895;554;552;301;251
2;280704;280700;14-220;727;424;422;286;136
3;280704;280700;14-220;317;208;206;164;42
4;280704;280700;14-220;265;184;184;131;53
5;280704;280700;14-220;635;302;300;204;96
6;280704;280700;14-220;257;137;136;108;28
7;280704;280700;14-220;516;274;272;202;70
8;280704;280700;14-220;254;141;141;81;60
9;280704;280700;14-220;250;173;172;137;35
10;280704;280700;14-220;220;138;136;79;57
1;280705;280700;14-260;780;528;525;335;190
2;280705;280700;14-260;1408;878;877;732;145
3;280705;280700;14-260;404;276;272;224;48
4;280705;280700;14-260;659;474;472;363;109
5;280705;280700;14-229;770;456;453;340;113
6;280705;280700;14-229;1095;751;749;564;185
7;280705;280700;14-229;532;357;352;282;70
8;280705;280700;14-260;1373;873;867;610;257
9;280705;280700;14-260;437;330;327;202;125
10;280705;280700;14-260;507;365;362;270;92
1;280706;280700;14-240;870;510;510;264;246
2;280706;280700;14-240;1261;839;835;417;418
3;280706;280700;14-240;1326;919;913;463;450
4;280706;280700;14-240;889;502;496;336;160
5;280706;280700;14-240;489;233;231;156;75
6;280706;280700;14-240;703;341;337;234;103
7;280706;280700;14-240;475;286;286;198;88
8;280706;280700;14-240;653;384;381;279;102
9;280706;280700;14-240;537;268;262;190;72
10;280706;280700;14-240;792;433;431;299;132
11;280706;280700;14-240;759;424;420;266;154
1;280707;280700;14-230;1576;1016;1009;491;518
2;280707;280700;14-230;1384;721;717;414;303
3;280707;280700;14-230;1242;657;653;391;262
4;280707;280700;14-230;801;424;420;219;201
1;280801;280800;11-400;1791;1118;1107;450;657
2;280801;280800;11-400;880;607;600;268;332
3;280801;280800;11-400;918;607;599;267;332
4;280801;280800;11-400;1210;802;793;337;456
5;280801;280800;11-400;1568;1100;1092;457;635
6;280801;280800;11-400;1488;957;955;418;537
7;280801;280800;11-400;1929;1326;1317;508;809
8;280801;280800;11-400;846;478;476;195;281
9;280801;280800;11-400;954;634;632;255;377
10;280801;280800;11-400;1178;732;722;324;398
11;280801;280800;11-400;1043;657;651;294;357
12;280801;280800;11-400;1633;1031;1024;393;631
13;280801;280800;11-400;2010;1241;1234;526;708
14;280801;280800;11-400;1259;792;782;362;420
15;280801;280800;11-400;48;27;25;11;14
16;280801;280800;11-400;29;27;26;15;11
1;280802;280800;11-410;1412;796;789;471;318
2;280802;280800;11-410;711;360;354;206;148
3;280802;280800;11-410;626;327;323;185;138
4;280802;280800;11-410;889;387;385;240;145
5;280802;280800;11-410;651;318;317;214;103
1;280803;280800;11-400;277;146;143;99;44
2;280803;280800;11-400;459;254;253;160;93
3;280803;280800;11-400;752;429;428;234;194
4;280803;280800;11-400;466;229;225;123;102
5;280803;280800;11-440;467;202;200;116;84
6;280803;280800;11-400;400;244;243;105;138
7;280803;280800;11-400;784;361;358;179;179
8;280803;280800;11-400;628;387;385;166;219
9;280803;280800;11-400;503;303;302;155;147
10;280803;280800;11-400;410;233;231;132;99
11;280803;280800;11-400;312;133;133;92;41
12;280803;280800;11-400;382;232;230;140;90
1;280804;280800;11-430;1127;622;616;386;230
2;280804;280800;11-430;718;445;444;241;203
3;280804;280800;11-430;1078;650;648;334;314
4;280804;280800;11-430;605;310;309;200;109
5;280804;280800;11-430;989;493;490;285;205
6;280804;280800;11-430;403;209;206;156;50
7;280804;280800;11-430;570;257;254;174;80
8;280804;280800;11-430;377;162;160;99;61
9;280804;280800;11-430;738;338;333;224;109
10;280804;280800;11-430;223;154;150;30;120
1;280805;280800;11-440;1019;654;652;293;359
2;280805;280800;11-440;666;408;404;179;225
3;280805;280800;11-440;615;356;353;137;216
4;280805;280800;11-440;819;529;528;220;308
5;280805;280800;11-440;598;341;334;190;144
6;280805;280800;11-440;713;445;440;248;192
7;280805;280800;11-440;296;154;152;104;48
8;280805;280800;11-440;296;160;158;103;55
9;280805;280800;11-440;187;99;99;50;49
10;280805;280800;11-440;185;118;118;54;64
11;280805;280800;11-440;95;9;9;3;6
1;280806;280800;11-420;547;291;291;180;111
2;280806;280800;11-420;184;82;82;39;43
3;280806;280800;11-420;732;482;481;217;264
4;280806;280800;11-420;660;381;378;223;155
5;280806;280800;11-420;640;300;295;178;117
1;280901;280900;11-100;1354;955;950;382;568
2;280901;280900;11-100;784;513;508;220;288
3;280901;280900;11-100;835;543;540;228;312
4;280901;280900;11-100;1299;871;858;327;531
5;280901;280900;11-100;676;441;437;206;231
6;280901;280900;11-100;699;458;456;154;302
7;280901;280900;11-100;1531;1055;1044;394;650
8;280901;280900;11-100;764;575;568;207;361
9;280901;280900;11-100;1483;944;935;393;542
10;280901;280900;11-100;1364;854;847;355;492
11;280901;280900;11-100;75;17;17;6;11
1;280902;280900;11-106;635;403;400;240;160
2;280902;280900;11-106;556;335;335;210;125
3;280902;280900;11-106;290;154;152;110;42
4;280902;280900;11-106;353;207;202;132;70
5;280902;280900;11-106;170;90;88;55;33
6;280902;280900;11-106;228;154;154;110;44
7;280902;280900;11-106;188;101;101;66;35
1;280903;280900;11-100;1156;623;619;332;287
2;280903;280900;11-100;719;391;387;217;170
3;280903;280900;11-100;704;427;426;199;227
4;280903;280900;11-100;661;412;403;217;186
5;280903;280900;11-100;402;209;206;120;86
6;280903;280900;11-100;291;155;152;89;63
7;280903;280900;11-100;274;150;150;87;63
8;280903;280900;11-100;363;189;189;132;57
9;280903;280900;11-100;205;114;113;48;65
10;280903;280900;11-100;165;105;105;61;44
1;280904;280900;11-135;1072;597;592;347;245
2;280904;280900;11-135;356;177;176;110;66
3;280904;280900;11-135;603;293;290;201;89
4;280904;280900;11-135;512;275;266;169;97
1;280905;280900;11-130;1618;973;972;418;554
2;280905;280900;11-130;1583;1067;1059;489;570
3;280905;280900;11-130;894;471;464;247;217
4;280905;280900;11-130;1178;698;689;297;392
5;280905;280900;11-130;1107;629;621;307;314
6;280905;280900;11-130;633;339;339;202;137
7;280905;280900;11-130;478;283;278;184;94
8;280905;280900;11-130;545;297;296;198;98
9;280905;280900;11-130;171;107;105;78;27
1;281001;281000;11-700;1141;826;818;312;506
2;281001;281000;11-700;1027;646;640;248;392
3;281001;281000;11-700;852;565;562;222;340
4;281001;281000;11-700;992;689;679;289;390
5;281001;281000;11-700;1947;1345;1336;592;744
6;281001;281000;11-700;2053;1267;1253;585;668
7;281001;281000;11-700;990;671;661;322;339
8;281001;281000;11-700;1946;1392;1384;620;764
9;281001;281000;11-700;1031;650;638;308;330
10;281001;281000;11-700;1082;710;707;336;371
11;281001;281000;11-700;997;667;661;254;407
12;281001;281000;11-700;1022;681;671;306;365
13;281001;281000;11-700;51;30;30;12;18
1;281002;281000;11-730;1470;1061;1055;394;661
2;281002;281000;11-730;1815;1371;1360;513;847
3;281002;281000;11-730;978;599;599;281;318
4;281002;281000;11-730;529;266;265;185;80
5;281002;281000;11-730;666;363;362;179;183
6;281002;281000;11-730;1097;655;650;338;312
7;281002;281000;11-730;90;44;38;19;19
1;281003;281000;11-700;615;365;356;194;162
2;281003;281000;11-700;583;402;398;150;248
3;281003;281000;11-700;533;355;351;142;209
4;281003;281000;11-700;409;251;250;157;93
5;281003;281000;11-700;899;427;424;244;180
6;281003;281000;11-700;577;343;341;194;147
7;281003;281000;11-700;492;327;325;125;200
8;281003;281000;11-700;1189;826;818;351;467
9;281003;281000;11-700;243;146;146;86;60
10;281003;281000;11-700;174;96;96;49;47
11;281003;281000;11-700;249;132;132;83;49
12;281003;281000;11-700;257;146;146;84;62
1;281004;281000;11-710;354;194;193;117;76
2;281004;281000;11-710;570;333;328;208;120
3;281004;281000;11-710;416;276;272;118;154
4;281004;281000;11-710;401;244;244;156;88
5;281004;281000;11-710;449;275;273;155;118
6;281004;281000;11-710;374;210;208;114;94
7;281004;281000;11-710;598;356;354;229;125
8;281004;281000;11-710;1395;824;821;411;410
9;281004;281000;11-710;761;479;474;297;177
10;281004;281000;11-710;243;126;126;84;42
11;281004;281000;11-710;262;152;150;92;58
1;281005;281000;11-731;663;404;402;171;231
2;281005;281000;11-731;518;285;281;139;142
3;281005;281000;11-731;1224;755;751;430;321
4;281005;281000;11-731;780;469;464;256;208
5;281005;281000;11-731;308;189;187;100;87
6;281005;281000;11-731;15;15;15;8;7
1;281101;281100;13-111;575;369;365;255;110
2;281101;281100;13-111;505;345;339;281;58
3;281101;281100;13-111;460;263;263;218;45
4;281101;281100;13-111;456;275;272;213;59
5;281101;281100;13-111;377;212;210;157;53
1;281102;281100;13-113;439;275;271;185;86
2;281102;281100;13-113;487;346;345;276;69
3;281102;281100;13-113;692;435;433;265;168
4;281102;281100;13-113;287;146;146;107;39
1;281103;281100;13-124;537;292;290;183;107
2;281103;281100;13-124;467;285;284;154;130
3;281103;281100;13-124;702;404;402;294;108
4;281103;281100;13-124;331;170;169;128;41
5;281103;281100;13-124;593;325;324;195;129
6;281103;281100;13-124;510;266;264;210;54
7;281103;281100;13-124;380;238;234;175;59
8;281103;281100;13-124;444;195;192;128;64
9;281103;281100;13-124;263;177;176;146;30
1;281104;281100;13-100;1184;830;824;432;392
2;281104;281100;13-100;816;535;530;289;241
3;281104;281100;13-100;846;576;572;317;255
4;281104;281100;13-100;1084;723;718;330;388
5;281104;281100;13-100;1390;945;931;439;492
6;281104;281100;13-100;1276;824;812;408;404
7;281104;281100;13-100;932;612;607;347;260
8;281104;281100;13-100;1056;679;676;366;310
9;281104;281100;13-100;1002;718;714;327;387
10;281104;281100;13-100;901;543;536;279;257
11;281104;281100;13-100;324;220;218;135;83
12;281104;281100;13-100;947;602;590;307;283
13;281104;281100;13-100;437;278;268;206;62
14;281104;281100;13-100;1116;728;721;386;335
15;281104;281100;13-100;274;164;164;101;63
16;281104;281100;13-100;343;200;199;94;105
17;281104;281100;13-100;317;212;211;180;31
18;281104;281100;13-100;318;175;174;130;44
19;281104;281100;13-100;596;343;342;241;101
20;281104;281100;13-100;86;29;28;14;14
1;281201;281200;13-300;865;523;519;228;291
2;281201;281200;13-300;1325;884;876;435;441
3;281201;281200;13-300;1680;1162;1147;577;570
4;281201;281200;13-300;1442;927;923;409;514
5;281201;281200;13-300;933;600;597;261;336
6;281201;281200;13-300;1212;822;811;389;422
7;281201;281200;13-300;38;25;25;15;10
1;281202;281200;13-340;916;542;537;308;229
2;281202;281200;13-330;700;448;446;261;185
3;281202;281200;13-334;885;512;505;382;123
4;281202;281200;13-334;744;474;470;239;231
5;281202;281200;13-334;550;338;336;236;100
6;281202;281200;13-340;216;124;122;72;50
7;281202;281200;13-340;466;269;269;178;91
8;281202;281200;13-340;455;292;290;201;89
9;281202;281200;13-330;555;339;334;176;158
10;281202;281200;13-340;251;158;158;116;42
11;281202;281200;13-340;224;116;115;87;28
12;281202;281200;13-334;171;124;123;71;52
13;281202;281200;13-332;204;138;136;80;56
14;281202;281200;13-340;476;277;273;153;120
1;281203;281200;13-324;781;533;531;380;151
2;281203;281200;13-324;212;146;146;94;52
3;281203;281200;13-324;197;142;142;116;26
4;281203;281200;13-324;659;405;399;291;108
5;281203;281200;13-324;403;255;255;208;47
6;281203;281200;13-324;806;528;522;394;128
7;281203;281200;13-324;280;195;194;147;47
8;281203;281200;13-324;291;179;176;146;30
9;281203;281200;13-324;240;141;139;93;46
10;281203;281200;13-324;194;126;126;101;25
11;281203;281200;13-324;309;194;192;160;32
12;281203;281200;13-324;205;153;150;117;33
1;281204;281200;13-306;605;415;411;292;119
2;281204;281200;13-306;1210;796;790;518;272
3;281204;281200;13-306;846;559;557;384;173
4;281204;281200;13-306;691;408;406;265;141
5;281204;281200;13-306;1186;808;801;448;353
6;281204;281200;13-306;212;150;150;117;33
7;281204;281200;13-306;203;140;140;120;20
8;281204;281200;13-306;322;206;206;154;52
9;281204;281200;13-306;260;165;163;97;66
10;281204;281200;13-306;303;194;191;136;55
11;281204;281200;13-306;297;211;209;164;45
12;281204;281200;13-306;385;236;232;183;49
13;281204;281200;13-306;264;173;172;105;67
1;281205;281200;13-300;525;334;329;181;148
2;281205;281200;13-300;1191;739;735;476;259
3;281205;281200;13-332;957;573;570;348;222
4;281205;281200;13-300;457;295;292;186;106
5;281205;281200;13-304;500;300;299;203;96
6;281205;281200;13-300;480;356;352;183;169
7;281205;281200;13-300;562;324;319;232;87
8;281205;281200;13-300;442;274;273;191;82
9;281205;281200;13-304;230;148;146;96;50
10;281205;281200;13-300;297;188;188;101;87
11;281205;281200;13-332;178;119;119;73;46
12;281205;281200;13-300;174;117;116;78;38
13;281205;281200;13-304;164;113;112;93;19
1;281303;281300;19-420;399;168;168;133;35
2;281303;281300;19-420;945;439;432;245;187
3;281303;281300;19-420;584;307;305;160;145
4;281303;281300;19-420;662;357;356;246;110
5;281303;281300;19-420;843;441;437;260;177
6;281303;281300;19-420;46;33;32;16;16
1;281304;281300;19-400;1227;808;799;405;394
2;281304;281300;19-400;1193;759;749;392;357
3;281304;281300;19-400;1434;879;871;434;437
4;281304;281300;19-400;1246;727;723;360;363
5;281304;281300;19-400;1181;776;773;404;369
6;281304;281300;19-400;1157;786;781;377;404
7;281304;281300;19-400;877;584;582;322;260
8;281304;281300;19-400;471;243;241;130;111
9;281304;281300;19-400;1291;817;812;439;373
10;281304;281300;19-400;959;659;655;305;350
11;281304;281300;19-400;735;381;378;223;155
12;281304;281300;19-400;351;177;176;109;67
13;281304;281300;19-400;495;242;241;156;85
14;281304;281300;19-400;638;316;315;224;91
15;281304;281300;19-400;883;485;482;300;182
16;281304;281300;19-400;451;310;309;185;124
17;281304;281300;19-400;413;241;241;163;78
18;281304;281300;19-400;63;20;18;10;8
19;281304;281300;19-400;78;12;11;10;1
1;281305;281300;19-411;974;553;551;326;225
2;281305;281300;19-411;483;243;242;142;100
3;281305;281300;19-411;421;232;232;145;87
4;281305;281300;19-411;431;244;244;157;87
5;281305;281300;19-411;444;211;211;125;86
1;281306;281300;19-404;478;305;304;178;126
2;281306;281300;19-404;490;279;274;205;69
3;281306;281300;19-404;351;203;200;139;61
4;281306;281300;19-404;558;315;311;241;70
5;281306;281300;19-404;434;219;217;151;66
6;281306;281300;19-404;14;9;9;7;2
1;281401;281400;11-010;909;594;591;290;301
2;281401;281400;11-010;722;488;482;227;255
3;281401;281400;11-010;944;694;687;248;439
4;281401;281400;11-010;1101;749;743;321;422
5;281401;281400;11-010;659;360;355;172;183
6;281401;281400;11-010;886;625;620;285;335
7;281401;281400;11-010;683;400;399;189;210
8;281401;281400;11-010;343;214;213;130;83
9;281401;281400;11-010;424;238;235;144;91
10;281401;281400;11-010;644;393;392;210;182
11;281401;281400;11-010;1091;719;710;364;346
12;281401;281400;11-010;632;452;449;156;293
13;281401;281400;11-010;265;158;156;64;92
14;281401;281400;11-010;633;343;341;189;152
15;281401;281400;10-376;608;506;504;169;335
16;281401;281400;11-010;1203;977;973;323;650
17;281401;281400;11-010;732;491;488;191;297
18;281401;281400;11-010;410;263;261;116;145
19;281401;281400;11-010;529;255;253;132;121
20;281401;281400;11-010;129;33;30;16;14
21;281401;281400;11-010;502;432;426;65;361
22;281401;281400;11-010;51;1;1;1;0
1;281402;281400;11-300;837;577;571;227;344
2;281402;281400;11-300;918;590;585;248;337
3;281402;281400;11-300;946;562;556;227;329
4;281402;281400;11-300;670;422;420;161;259
5;281402;281400;11-300;890;559;554;198;356
6;281402;281400;11-300;688;467;461;171;290
7;281402;281400;11-300;1221;831;822;325;497
8;281402;281400;11-300;1182;791;786;305;481
9;281402;281400;11-300;259;157;156;71;85
10;281402;281400;11-300;921;518;513;255;258
11;281402;281400;11-300;281;168;165;76;89
12;281402;281400;11-300;215;119;118;67;51
13;281402;281400;11-300;298;137;137;82;55
14;281402;281400;11-300;260;122;122;66;56
15;281402;281400;11-300;457;254;250;145;105
16;281402;281400;11-300;338;169;166;92;74
17;281402;281400;11-300;312;145;144;78;66
18;281402;281400;11-300;287;161;160;105;55
19;281402;281400;11-300;482;237;236;139;97
20;281402;281400;11-300;385;188;185;86;99
21;281402;281400;11-300;274;188;188;85;103
22;281402;281400;11-300;360;196;193;113;80
23;281402;281400;11-300;309;167;167;99;68
24;281402;281400;11-300;210;108;107;65;42
25;281402;281400;11-300;153;63;63;45;18
26;281402;281400;11-300;269;139;138;101;37
27;281402;281400;11-300;62;58;58;27;31
1;281403;281400;11-040;716;480;475;215;260
2;281403;281400;11-040;1227;867;858;407;451
3;281403;281400;11-040;1333;807;801;412;389
4;281403;281400;11-040;725;444;439;239;200
5;281403;281400;11-040;1426;852;849;424;425
6;281403;281400;11-040;1611;1076;1067;512;555
7;281403;281400;11-040;587;366;363;213;150
8;281403;281400;11-040;444;284;281;129;152
9;281403;281400;11-040;453;312;303;202;101
10;281403;281400;11-040;381;232;227;113;114
11;281403;281400;11-040;522;343;336;201;135
12;281403;281400;11-040;316;150;149;93;56
13;281403;281400;11-040;304;141;140;95;45
14;281403;281400;11-040;512;339;338;185;153
15;281403;281400;11-040;369;194;192;132;60
16;281403;281400;11-040;491;232;227;138;89
17;281403;281400;11-040;72;12;12;9;3
18;281403;281400;11-040;15;4;4;1;3
1;281404;281400;11-001;1567;1219;1205;435;770
2;281404;281400;11-001;1458;1145;1136;445;691
3;281404;281400;11-001;543;407;401;188;213
4;281404;281400;11-001;402;258;256;140;116
5;281404;281400;11-001;325;170;167;90;77
6;281404;281400;11-001;203;116;113;63;50
7;281404;281400;10-381;552;404;397;158;239
8;281404;281400;10-371;1724;1393;1380;512;868
9;281404;281400;11-001;1376;1062;1054;382;672
10;281404;281400;11-001;563;467;458;109;349
11;281404;281400;11-001;202;116;116;46;70
12;281404;281400;11-001;246;132;129;55;74
13;281404;281400;11-001;323;231;231;116;115
14;281404;281400;11-001;215;117;116;75;41
15;281404;281400;11-001;315;193;192;68;124
16;281404;281400;11-001;249;150;149;76;73
17;281404;281400;11-001;63;22;21;9;12
1;281405;281400;11-036;1046;804;796;218;578
2;281405;281400;11-036;953;743;736;281;455
3;281405;281400;11-036;705;475;471;176;295
4;281405;281400;11-036;1581;1170;1157;567;590
5;281405;281400;11-036;1070;605;600;273;327
6;281405;281400;11-036;32;16;12;6;6
1;281406;281400;11-320;1163;722;721;342;379
2;281406;281400;11-320;1009;574;570;315;255
3;281406;281400;11-320;369;204;200;104;96
4;281406;281400;11-320;982;535;526;296;230
5;281406;281400;11-320;563;300;297;213;84
6;281406;281400;11-320;727;384;380;268;112
7;281406;281400;11-320;173;89;88;61;27
8;281406;281400;11-320;228;148;147;91;56
9;281406;281400;11-320;187;103;103;64;39
10;281406;281400;11-320;77;40;36;9;27
11;281406;281400;11-311;41;41;40;2;38
1;281407;281400;11-042;1870;1407;1389;489;900
2;281407;281400;11-042;1291;842;834;383;451
3;281407;281400;11-042;645;405;398;194;204
4;281407;281400;11-042;1150;791;783;322;461
5;281407;281400;11-042;909;610;607;206;401
6;281407;281400;11-042;45;23;23;14;9
1;281408;281400;11-311;817;412;409;239;170
2;281408;281400;11-311;716;419;415;243;172
3;281408;281400;11-311;695;377;373;245;128
1;281409;281400;11-015;550;431;425;180;245
2;281409;281400;11-015;663;437;436;223;213
3;281409;281400;11-015;754;524;520;265;255
4;281409;281400;11-015;594;384;384;183;201
5;281409;281400;11-015;763;443;441;224;217
6;281409;281400;11-015;737;478;473;235;238
7;281409;281400;11-015;646;464;461;178;283
8;281409;281400;11-015;582;393;391;194;197
9;281409;281400;11-015;249;127;126;89;37
10;281409;281400;11-015;315;173;171;82;89
11;281409;281400;11-015;607;407;401;173;228
12;281409;281400;11-015;541;371;369;174;195
13;281409;281400;11-015;445;285;282;137;145
14;281409;281400;11-015;770;484;478;191;287
15;281409;281400;11-015;314;230;227;133;94
16;281409;281400;11-015;344;218;215;115;100
17;281409;281400;11-015;393;220;214;136;78
18;281409;281400;11-015;295;180;179;108;71
19;281409;281400;11-015;291;192;190;103;87
20;281409;281400;11-015;306;165;162;87;75
21;281409;281400;11-015;132;45;45;25;20
1;281410;281400;11-030;1178;775;767;342;425
2;281410;281400;11-030;665;364;361;163;198
3;281410;281400;10-687;825;517;510;245;265
4;281410;281400;10-687;987;713;707;289;418
5;281410;281400;10-687;1525;1012;997;431;566
6;281410;281400;11-030;619;378;376;155;221
7;281410;281400;10-687;838;681;677;285;392
8;281410;281400;11-030;423;298;293;111;182
1;281411;281400;11-034;1152;944;937;283;654
2;281411;281400;11-034;927;727;721;195;526
3;281411;281400;11-034;640;446;443;176;267
4;281411;281400;11-034;720;615;609;173;436
5;281411;281400;11-034;773;644;631;159;472
6;281411;281400;10-687;586;458;448;187;261
7;281411;281400;10-687;875;712;708;254;454
8;281411;281400;10-687;775;621;611;239;372
9;281411;281400;10-687;629;460;459;175;284
10;281411;281400;11-034;186;126;123;44;79
11;281411;281400;10-687;847;720;713;227;486
12;281411;281400;10-687;831;676;673;249;424
13;281411;281400;10-687;692;559;556;152;404
14;281411;281400;10-687;809;628;624;217;407
15;281411;281400;11-034;51;32;31;3;28
1;281412;281400;11-008;619;404;400;229;171
2;281412;281400;11-008;719;418;414;236;178
3;281412;281400;11-008;533;301;297;182;115
4;281412;281400;11-008;306;136;136;96;40
5;281412;281400;11-008;445;256;254;130;124
6;281412;281400;11-008;239;104;104;62;42
1;281501;281500;14-100;1084;799;795;341;454
2;281501;281500;14-100;1209;935;926;335;591
3;281501;281500;14-100;1619;1144;1135;440;695
4;281501;281500;14-100;1057;463;461;208;253
5;281501;281500;14-100;1121;731;723;295;428
6;281501;281500;14-100;1392;850;847;339;508
7;281501;281500;14-100;1367;934;924;334;590
8;281501;281500;14-100;2110;1428;1420;553;867
9;281501;281500;14-100;1646;1024;1019;386;633
10;281501;281500;14-100;1384;1027;1020;349;671
11;281501;281500;14-100;840;613;610;269;341
12;281501;281500;14-100;1156;780;774;330;444
13;281501;281500;14-100;1154;821;815;285;530
14;281501;281500;14-100;904;659;658;238;420
15;281501;281500;14-100;1475;933;919;341;578
16;281501;281500;14-100;1031;761;753;261;492
17;281501;281500;14-100;1286;974;965;348;617
18;281501;281500;14-100;1296;962;959;313;646
19;281501;281500;14-100;52;40;39;21;18
1;281502;281500;14-120;846;578;574;289;285
2;281502;281500;14-120;242;118;118;70;48
3;281502;281500;14-120;769;371;360;206;154
4;281502;281500;14-120;509;288;286;196;90
5;281502;281500;14-120;204;122;121;82;39
6;281502;281500;14-120;515;290;284;195;89
1;281503;281500;14-107;1326;697;690;382;308
2;281503;281500;14-107;900;507;501;294;207
3;281503;281500;14-107;808;439;439;319;120
4;281503;281500;14-107;298;194;191;136;55
5;281503;281500;14-107;375;237;236;106;130
6;281503;281500;14-107;271;132;131;96;35
1;281504;281500;14-105;1759;1089;1078;458;620
2;281504;281500;14-105;486;259;257;153;104
3;281504;281500;14-105;436;287;284;118;166
4;281504;281500;14-105;248;178;177;73;104
5;281504;281500;14-105;258;120;119;50;69
6;281504;281500;14-105;303;170;170;120;50
1;281505;281500;14-330;699;430;427;167;260
2;281505;281500;14-330;1854;1042;1033;512;521
3;281505;281500;14-330;826;429;427;290;137
4;281505;281500;14-330;1011;463;462;297;165
1;281506;281500;14-310;1846;1154;1141;560;581
2;281506;281500;14-310;1064;520;518;333;185
3;281506;281500;14-310;520;285;283;152;131
4;281506;281500;14-310;294;161;159;104;55
5;281506;281500;14-310;200;107;107;62;45
1;281507;281500;14-140;1933;1257;1248;519;729
2;281507;281500;14-140;823;453;450;244;206
3;281507;281500;14-140;289;188;188;94;94
4;281507;281500;14-140;449;250;248;145;103
5;281507;281500;14-140;294;177;176;93;83
1;281508;281500;14-300;960;631;627;270;357
2;281508;281500;14-300;750;523;521;212;309
3;281508;281500;14-300;712;463;457;178;279
4;281508;281500;14-300;844;527;522;197;325
5;281508;281500;14-300;613;402;400;172;228
6;281508;281500;14-300;711;421;420;194;226
7;281508;281500;14-300;749;463;457;219;238
8;281508;281500;14-300;882;552;552;224;328
9;281508;281500;14-300;607;425;423;168;255
10;281508;281500;14-300;707;496;490;225;265
11;281508;281500;14-300;910;668;662;258;404
12;281508;281500;14-300;1546;1112;1103;434;669
13;281508;281500;14-300;770;502;500;263;237
14;281508;281500;14-300;647;353;350;193;157
15;281508;281500;14-300;526;330;325;195;130
16;281508;281500;14-300;904;492;489;250;239
17;281508;281500;14-300;428;219;217;116;101
18;281508;281500;14-300;196;114;113;62;51
19;281508;281500;14-300;444;234;232;131;101
20;281508;281500;14-300;674;358;355;234;121
21;281508;281500;14-300;418;299;294;136;158
22;281508;281500;14-300;215;136;136;63;73
23;281508;281500;14-300;177;101;100;82;18
24;281508;281500;14-300;412;235;234;143;91
25;281508;281500;14-300;336;180;180;109;71
26;281508;281500;14-300;356;216;216;173;43
27;281508;281500;14-300;572;270;269;185;84
28;281508;281500;14-300;380;232;231;130;101
29;281508;281500;14-300;64;41;41;19;22
1;281509;281500;14-100;640;354;351;238;113
2;281509;281500;14-106;735;414;409;244;165
3;281509;281500;14-100;1184;740;734;314;420
4;281509;281500;14-100;1248;902;893;366;527
5;281509;281500;14-100;653;404;400;221;179
6;281509;281500;14-100;615;399;392;196;196
7;281509;281500;14-133;754;499;494;197;297
8;281509;281500;14-106;584;323;321;180;141
9;281509;281500;14-100;1112;736;730;370;360
10;281509;281500;14-100;504;284;283;183;100
11;281509;281500;14-100;213;129;128;74;54
12;281509;281500;14-100;434;239;238;144;94
13;281509;281500;14-100;588;369;365;236;129
14;281509;281500;14-120;540;314;313;216;97
15;281509;281500;14-100;414;289;287;108;179
16;281509;281500;14-100;209;145;142;89;53
17;281509;281500;14-100;287;172;171;81;90
18;281509;281500;14-100;463;309;306;152;154
19;281509;281500;14-100;226;150;149;83;66
20;281509;281500;14-100;288;176;176;142;34
21;281509;281500;14-100;506;331;328;113;215
1;281601;281600;12-230;1167;639;634;416;218
2;281601;281600;12-230;1004;609;606;344;262
3;281601;281600;12-230;403;174;171;125;46
4;281601;281600;12-230;1478;790;787;566;221
5;281601;281600;12-230;449;206;205;179;26
6;281601;281600;12-230;445;232;231;189;42
7;281601;281600;12-230;473;255;255;227;28
8;281601;281600;12-230;556;300;298;223;75
9;281601;281600;12-230;773;416;414;240;174
10;281601;281600;12-230;585;383;380;221;159
11;281601;281600;12-230;487;244;241;155;86
12;281601;281600;12-230;252;177;175;152;23
1;281602;281600;12-250;1405;798;786;482;304
2;281602;281600;12-250;1445;911;904;489;415
3;281602;281600;12-250;1176;761;748;358;390
4;281602;281600;12-250;633;335;331;194;137
5;281602;281600;12-250;944;526;524;329;195
6;281602;281600;12-250;438;274;272;129;143
7;281602;281600;12-250;389;229;228;161;67
8;281602;281600;12-250;388;206;204;133;71
1;281603;281600;12-200;781;533;530;289;241
2;281603;281600;12-200;566;339;334;186;148
3;281603;281600;12-200;846;542;540;319;221
4;281603;281600;12-220;595;357;355;274;81
5;281603;281600;12-200;826;623;621;359;262
6;281603;281600;12-200;431;268;266;219;47
7;281603;281600;12-200;688;362;357;292;65
8;281603;281600;12-200;1222;774;771;490;281
9;281603;281600;12-200;717;419;408;326;82
10;281603;281600;12-200;1498;925;922;544;378
11;281603;281600;12-200;1641;976;969;608;361
12;281603;281600;12-200;888;563;559;308;251
13;281603;281600;12-200;844;493;487;267;220
14;281603;281600;12-200;1003;662;652;375;277
15;281603;281600;12-200;1078;639;631;361;270
16;281603;281600;12-200;599;365;360;185;175
17;281603;281600;12-200;780;484;478;309;169
18;281603;281600;12-200;1698;1052;1043;681;362
19;281603;281600;12-200;822;586;584;343;241
20;281603;281600;12-200;1164;694;687;413;274
21;281603;281600;12-200;1181;812;808;445;363
22;281603;281600;12-200;38;17;17;9;8
1;281604;281600;12-220;832;623;618;254;364
2;281604;281600;12-220;864;578;573;313;260
3;281604;281600;12-220;1004;673;669;345;324
4;281604;281600;12-220;676;422;418;229;189
5;281604;281600;12-220;864;616;612;286;326
6;281604;281600;12-220;929;596;591;305;286
7;281604;281600;12-220;973;631;629;316;313
8;281604;281600;12-220;415;299;298;119;179
9;281604;281600;12-220;32;18;17;10;7
1;281701;281700;12-100;849;613;611;288;323
2;281701;281700;12-100;721;547;545;204;341
3;281701;281700;12-100;660;414;411;196;215
4;281701;281700;12-100;534;363;361;143;218
5;281701;281700;12-100;982;629;621;285;336
6;281701;281700;12-100;707;532;530;269;261
7;281701;281700;12-100;1179;822;820;375;445
8;281701;281700;12-100;977;705;701;314;387
9;281701;281700;12-100;1276;869;862;441;421
10;281701;281700;12-100;1033;706;701;363;338
11;281701;281700;12-100;1119;747;742;381;361
12;281701;281700;12-100;1046;697;688;317;371
13;281701;281700;12-100;1393;941;938;444;494
14;281701;281700;12-100;1105;736;728;330;398
15;281701;281700;12-100;798;541;535;267;268
16;281701;281700;12-100;866;566;561;275;286
17;281701;281700;12-100;1347;932;924;476;448
18;281701;281700;12-100;93;61;57;40;17
19;281701;281700;12-100;124;23;23;7;16
20;281701;281700;12-100;113;98;94;10;84
1;281702;281700;12-120;905;517;515;279;236
2;281702;281700;12-120;877;547;541;260;281
3;281702;281700;12-120;421;236;236;151;85
4;281702;281700;12-120;614;302;301;184;117
5;281702;281700;12-120;769;471;469;287;182
6;281702;281700;12-120;543;325;322;203;119
7;281702;281700;12-120;406;231;229;144;85
8;281702;281700;12-120;525;346;345;172;173
1;281703;281700;12-122;1009;655;652;341;311
2;281703;281700;12-122;758;479;473;210;263
3;281703;281700;12-122;635;406;398;186;212
4;281703;281700;12-122;255;128;126;81;45
5;281703;281700;12-122;185;118;118;59;59
6;281703;281700;12-122;253;113;113;72;41
1;281704;281700;12-130;246;154;153;110;43
2;281704;281700;12-130;326;212;209;88;121
3;281704;281700;12-130;426;273;271;154;117
4;281704;281700;12-130;723;476;475;202;273
5;281704;281700;12-130;333;188;182;101;81
6;281704;281700;12-130;482;326;324;173;151
7;281704;281700;12-130;752;420;419;242;177
8;281704;281700;12-130;738;521;511;254;257
9;281704;281700;12-130;211;124;124;94;30
1;281705;281700;12-114;899;566;561;469;92
2;281705;281700;12-114;1106;692;684;436;248
3;281705;281700;12-114;443;246;246;173;73
4;281705;281700;12-114;633;374;368;302;66
5;281705;281700;12-114;268;156;155;117;38
6;281705;281700;12-114;330;193;192;144;48
7;281705;281700;12-114;393;197;194;153;41
1;281706;281700;12-100;879;616;604;265;339
2;281706;281700;12-100;381;238;233;119;114
3;281706;281700;12-100;564;364;359;149;210
4;281706;281700;12-100;364;253;251;116;135
5;281706;281700;12-100;344;215;215;149;66
6;281706;281700;12-100;640;361;358;240;118
7;281706;281700;12-100;425;248;247;175;72
8;281706;281700;12-100;693;396;396;227;169
9;281706;281700;12-100;896;637;632;322;310
10;281706;281700;12-100;1194;770;764;399;365
11;281706;281700;12-100;456;245;244;146;98
12;281706;281700;12-100;545;390;388;196;192
13;281706;281700;12-100;312;192;190;131;59
14;281706;281700;12-100;777;600;595;249;346
15;281706;281700;12-100;257;183;181;85;96
16;281706;281700;12-100;579;380;376;207;169
17;281706;281700;12-100;382;232;232;183;49
18;281706;281700;12-100;234;151;150;82;68
19;281706;281700;12-100;167;128;128;84;44
1;281707;281700;12-140;1113;726;721;437;284
2;281707;281700;12-140;255;148;146;82;64
3;281707;281700;12-150;1154;739;730;326;404
4;281707;281700;12-140;610;385;383;288;95
5;281707;281700;12-140;553;312;312;205;107
6;281707;281700;12-140;430;309;305;127;178
7;281707;281700;12-140;346;237;237;146;91
8;281707;281700;12-140;172;99;99;72;27
9;281707;281700;12-150;15;11;10;5;5
1;281708;281700;12-160;866;526;524;288;236
2;281708;281700;12-160;699;429;423;265;158
3;281708;281700;12-160;880;497;486;364;122
4;281708;281700;12-160;925;547;541;343;198
5;281708;281700;12-160;397;239;238;179;59
6;281708;281700;12-160;905;467;460;363;97
1;281801;281800;19-520;921;518;514;230;284
2;281801;281800;19-520;581;301;298;188;110
3;281801;281800;19-520;513;264;263;153;110
4;281801;281800;19-520;652;323;320;187;133
1;281802;281800;19-504;862;483;481;301;180
2;281802;281800;19-504;405;226;225;166;59
3;281802;281800;19-504;763;408;405;276;129
1;281803;281800;19-500;640;323;320;182;138
2;281803;281800;19-500;362;194;193;126;67
3;281803;281800;19-500;316;165;165;95;70
4;281803;281800;19-500;486;261;260;172;88
5;281803;281800;19-500;511;282;278;118;160
6;281803;281800;19-500;472;217;216;141;75
7;281803;281800;19-500;664;358;354;215;139
8;281803;281800;19-500;650;309;309;204;105
9;281803;281800;19-500;1592;1000;996;426;570
10;281803;281800;19-500;1313;846;845;361;484
11;281803;281800;19-500;1020;670;666;282;384
12;281803;281800;19-500;1168;736;732;320;412
13;281803;281800;19-500;1138;721;719;367;352
14;281803;281800;19-500;1141;643;638;304;334
15;281803;281800;19-500;1887;1148;1141;489;652
16;281803;281800;19-500;307;181;180;93;87
17;281803;281800;19-500;63;26;26;9;17
18;281803;281800;19-500;285;253;251;119;132
1;281901;281900;11-606;676;384;381;228;153
2;281901;281900;11-606;649;292;286;177;109
3;281901;281900;11-606;256;153;153;90;63
4;281901;281900;11-606;338;194;193;135;58
5;281901;281900;11-606;165;106;106;69;37
1;281902;281900;11-610;837;486;481;256;225
2;281902;281900;11-610;849;526;526;251;275
3;281902;281900;11-610;824;537;533;257;276
1;281903;281900;11-600;892;659;654;232;422
2;281903;281900;11-600;723;494;491;186;305
3;281903;281900;11-600;783;530;528;211;317
4;281903;281900;11-600;933;692;691;263;428
5;281903;281900;11-600;666;440;439;185;254
6;281903;281900;11-600;771;481;479;196;283
7;281903;281900;11-600;810;528;523;245;278
8;281903;281900;11-600;661;415;412;195;217
9;281903;281900;11-600;742;496;493;190;303
10;281903;281900;11-600;851;572;568;217;351
11;281903;281900;11-600;645;328;327;160;167
12;281903;281900;11-600;583;302;302;179;123
13;281903;281900;11-600;701;417;413;176;237
14;281903;281900;11-600;632;330;326;181;145
15;281903;281900;11-600;885;497;493;222;271
16;281903;281900;11-600;262;173;172;69;103
17;281903;281900;11-600;255;152;148;88;60
18;281903;281900;11-600;77;27;27;15;12
19;281903;281900;11-600;54;37;37;15;22
20;281903;281900;11-600;87;33;31;25;6
21;281903;281900;11-600;60;27;27;19;8
1;286101;286100;82-300;1652;1158;1144;456;688
2;286101;286100;82-300;1556;1115;1101;509;592
3;286101;286100;82-300;1613;1130;1119;465;654
4;286101;286100;82-300;1687;1133;1124;493;631
5;286101;286100;82-300;1462;1062;1049;390;659
6;286101;286100;82-300;937;690;687;250;437
7;286101;286100;82-300;688;429;421;210;211
8;286101;286100;82-300;1360;936;922;326;596
9;286101;286100;82-300;679;487;483;142;341
10;286101;286100;82-300;1165;844;838;313;525
11;286101;286100;82-300;1486;1092;1079;454;625
12;286101;286100;82-300;1904;1413;1401;560;841
13;286101;286100;82-300;2077;1545;1533;510;1023
14;286101;286100;82-300;1913;1435;1424;548;876
15;286101;286100;82-300;1726;1191;1181;467;714
16;286101;286100;82-300;1698;1237;1231;484;747
17;286101;286100;82-300;1394;1021;1013;367;646
18;286101;286100;82-300;1508;996;991;467;524
19;286101;286100;82-300;1449;1042;1031;341;690
20;286101;286100;82-300;1489;1013;999;399;600
21;286101;286100;82-300;1585;1059;1049;411;638
22;286101;286100;82-300;1779;1156;1143;458;685
23;286101;286100;82-300;1277;887;881;342;539
24;286101;286100;82-300;1577;1059;1055;464;591
25;286101;286100;82-300;1497;905;896;420;476
26;286101;286100;82-300;1404;978;971;347;624
27;286101;286100;82-300;1432;989;983;309;674
28;286101;286100;82-300;1228;876;872;329;543
29;286101;286100;82-300;1216;829;824;353;471
30;286101;286100;82-300;114;41;38;19;19
31;286101;286100;82-300;1200;795;789;329;460
32;286101;286100;82-300;1314;918;907;361;546
33;286101;286100;82-300;1378;949;937;401;536
34;286101;286100;82-300;1590;1121;1115;522;593
35;286101;286100;82-300;2426;1708;1690;669;1021
36;286101;286100;82-300;1090;726;718;317;401
37;286101;286100;82-300;1449;960;946;386;560
38;286101;286100;82-300;1552;988;977;404;573
39;286101;286100;82-300;1622;1122;1109;428;681
40;286101;286100;82-300;1160;812;806;334;472
41;286101;286100;82-300;1356;1010;998;323;675
42;286101;286100;82-300;1630;1194;1188;425;763
43;286101;286100;82-300;1466;966;958;448;510
44;286101;286100;82-300;973;688;677;260;417
45;286101;286100;82-300;1523;1042;1028;378;650
46;286101;286100;82-300;1428;786;782;403;379
47;286101;286100;82-300;921;556;549;248;301
48;286101;286100;82-300;1667;1055;1045;489;556
49;286101;286100;82-300;1503;1000;988;362;626
50;286101;286100;82-300;1138;670;667;324;343
51;286101;286100;82-300;1469;974;964;430;534
52;286101;286100;82-300;1250;846;839;361;478
53;286101;286100;82-300;1490;1089;1073;453;620
54;286101;286100;82-300;1817;1308;1300;539;761
55;286101;286100;82-300;1328;947;943;392;551
56;286101;286100;82-300;1693;1176;1166;510;656
57;286101;286100;82-300;1172;855;847;363;484
58;286101;286100;82-300;250;174;171;72;99
59;286101;286100;82-300;135;72;69;26;43
60;286101;286100;82-300;36;22;21;8;13
61;286101;286100;82-300;20;1;1;1;0
62;286101;286100;82-300;233;201;195;24;171
1;286201;286200;10-113;883;556;544;207;337
2;286201;286200;10-551;630;444;441;165;276
3;286201;286200;10-551;901;594;590;197;393
4;286201;286200;10-450;778;551;547;247;300
5;286201;286200;10-553;1157;830;822;285;537
6;286201;286200;10-026;700;521;516;216;300
7;286201;286200;10-718;1765;1331;1310;489;821
8;286201;286200;10-558;785;598;593;229;364
9;286201;286200;10-089;1367;1044;1035;389;646
10;286201;286200;10-089;1362;1118;1109;385;724
11;286201;286200;10-083;2054;1549;1529;587;942
12;286201;286200;10-061;1266;910;897;323;574
13;286201;286200;10-045;1696;1211;1201;412;789
14;286201;286200;10-168;1215;838;828;288;540
15;286201;286200;10-168;1323;933;925;326;599
16;286201;286200;10-062;1731;1330;1315;421;894
17;286201;286200;10-148;1433;1177;1157;326;831
18;286201;286200;10-175;1627;1293;1282;453;829
19;286201;286200;11-041;1714;1285;1275;467;808
20;286201;286200;11-041;1509;1234;1226;413;813
21;286201;286200;11-041;1672;1441;1423;381;1042
22;286201;286200;10-822;1244;943;930;365;565
23;286201;286200;10-822;1419;1095;1085;416;669
24;286201;286200;10-823;1695;1388;1376;510;866
25;286201;286200;10-719;1346;1199;1192;347;845
26;286201;286200;10-088;1392;1194;1184;375;809
27;286201;286200;10-718;676;573;567;191;376
28;286201;286200;10-507;799;469;464;197;267
29;286201;286200;10-527;961;590;583;223;360
30;286201;286200;10-959;1032;696;686;284;402
31;286201;286200;10-507;1139;838;835;334;501
32;286201;286200;10-444;1157;795;791;297;494
33;286201;286200;10-444;1482;1055;1041;370;671
34;286201;286200;10-445;862;605;601;236;365
35;286201;286200;10-431;1127;774;770;369;401
36;286201;286200;10-465;975;690;681;275;406
37;286201;286200;10-461;1078;819;810;332;478
38;286201;286200;10-449;1180;880;869;298;571
39;286201;286200;10-950;939;732;722;251;471
40;286201;286200;10-450;1308;940;931;373;558
41;286201;286200;10-561;1294;926;920;326;594
42;286201;286200;10-561;1126;880;874;370;504
43;286201;286200;10-561;1244;876;867;335;532
44;286201;286200;10-560;1045;755;748;283;465
45;286201;286200;10-561;1129;834;828;321;507
46;286201;286200;10-601;1897;1415;1400;524;876
47;286201;286200;10-608;1650;1270;1263;498;765
48;286201;286200;10-560;2300;1793;1774;669;1105
49;286201;286200;10-685;1457;1077;1069;410;659
50;286201;286200;10-684;2400;1779;1773;628;1145
51;286201;286200;10-684;1522;1098;1077;415;662
52;286201;286200;10-684;1602;1219;1212;372;840
53;286201;286200;10-684;1136;840;831;320;511
54;286201;286200;10-692;2556;2017;1993;726;1267
55;286201;286200;10-692;1769;1411;1395;468;927
56;286201;286200;10-699;1419;1093;1087;350;737
57;286201;286200;10-699;1513;1275;1268;379;889
58;286201;286200;10-687;1174;940;938;331;607
59;286201;286200;10-693;1815;1504;1493;473;1020
60;286201;286200;10-693;2064;1682;1663;518;1145
61;286201;286200;10-693;1590;1267;1254;486;768
62;286201;286200;10-699;803;620;618;194;424
63;286201;286200;10-699;1642;1286;1275;454;821
64;286201;286200;10-687;1707;1318;1307;467;840
65;286201;286200;10-690;1474;1123;1113;410;703
66;286201;286200;10-686;1506;1123;1114;451;663
67;286201;286200;10-686;1411;1043;1035;381;654
68;286201;286200;10-690;1611;1233;1221;483;738
69;286201;286200;10-690;1144;883;875;330;545
70;286201;286200;10-691;1629;1256;1243;437;806
71;286201;286200;10-691;2043;1635;1616;484;1132
72;286201;286200;10-691;1884;1509;1498;542;956
73;286201;286200;10-691;1827;1423;1410;476;934
74;286201;286200;10-691;2001;1550;1528;574;954
75;286201;286200;10-275;1209;760;752;309;443
76;286201;286200;10-295;1766;1211;1195;449;746
77;286201;286200;10-224;1273;799;794;348;446
78;286201;286200;10-224;1877;1345;1329;491;838
79;286201;286200;10-271;1756;1113;1096;459;637
80;286201;286200;10-233;837;583;573;164;409
81;286201;286200;10-321;1065;789;781;333;448
82;286201;286200;10-275;1726;1179;1168;453;715
83;286201;286200;10-280;2463;1752;1742;694;1048
84;286201;286200;10-280;1082;805;796;333;463
85;286201;286200;10-256;1214;798;790;342;448
86;286201;286200;10-256;855;580;572;232;340
87;286201;286200;10-144;1014;745;739;264;475
88;286201;286200;10-685;986;886;879;279;600
89;286201;286200;10-243;1395;1099;1093;400;693
90;286201;286200;10-561;208;148;147;67;80
91;286201;286200;10-228;250;70;70;38;32
92;286201;286200;10-045;143;70;70;30;40
93;286201;286200;10-229;53;16;14;4;10
94;286201;286200;10-228;111;78;76;38;38
95;286201;286200;10-357;99;62;61;25;36
96;286201;286200;10-082;87;64;61;32;29
97;286201;286200;10-685;146;69;69;47;22
98;286201;286200;10-211;124;49;49;22;27
99;286201;286200;11-041;91;35;34;11;23
100;286201;286200;10-144;35;19;18;9;9
101;286201;286200;10-165;64;43;41;28;13
102;286201;286200;10-575;155;130;130;30;100
103;286201;286200;10-626;277;187;186;37;149
104;286201;286200;10-175;53;49;49;26;23
1;300101;300100;64-800;1927;1398;1385;461;924
2;300101;300100;64-800;1678;1176;1163;346;817
3;300101;300100;64-800;1650;1226;1219;362;857
4;300101;300100;64-800;1531;1076;1063;393;670
5;300101;300100;64-800;1589;1039;1031;352;679
6;300101;300100;64-800;1653;1053;1044;370;674
7;300101;300100;64-800;1010;708;695;202;493
8;300101;300100;64-800;1877;1408;1401;477;924
9;300101;300100;64-800;87;45;44;13;31
10;300101;300100;64-800;95;80;79;34;45
11;300101;300100;64-800;97;86;85;47;38
1;300102;300100;64-840;1414;975;968;391;577
2;300102;300100;64-840;1956;1368;1354;585;769
3;300102;300100;64-840;480;248;246;131;115
4;300102;300100;64-841;345;167;165;102;63
5;300102;300100;64-834;738;446;442;213;229
6;300102;300100;64-840;291;173;171;104;67
7;300102;300100;64-834;310;180;179;99;80
8;300102;300100;64-840;166;117;114;41;73
9;300102;300100;64-840;225;139;138;71;67
10;300102;300100;64-834;282;163;161;85;76
1;300103;300100;64-800;999;766;757;229;528
2;300103;300100;64-800;633;392;389;148;241
3;300103;300100;64-813;950;575;571;284;287
4;300103;300100;64-800;398;273;270;127;143
5;300103;300100;64-800;520;340;337;165;172
6;300103;300100;64-800;296;185;181;62;119
7;300103;300100;64-800;238;166;165;96;69
8;300103;300100;64-800;617;396;393;178;215
1;300104;300100;64-830;672;486;477;153;324
2;300104;300100;64-830;599;398;391;177;214
3;300104;300100;64-830;259;190;189;126;63
4;300104;300100;64-830;413;273;267;100;167
5;300104;300100;64-830;408;252;248;145;103
6;300104;300100;64-830;255;154;151;68;83
7;300104;300100;64-830;398;255;253;141;112
8;300104;300100;64-830;584;399;394;229;165
9;300104;300100;64-830;286;206;200;59;141
10;300104;300100;64-830;969;723;719;255;464
11;300104;300100;64-830;35;26;25;7;18
1;300105;300100;64-820;1467;953;944;426;518
2;300105;300100;64-820;1417;943;932;431;501
3;300105;300100;64-820;852;488;486;318;168
4;300105;300100;64-820;499;273;267;172;95
5;300105;300100;64-820;767;521;518;241;277
6;300105;300100;64-820;234;124;124;70;54
7;300105;300100;64-820;327;217;214;153;61
1;300201;300200;64-700;1440;1014;1007;333;674
2;300201;300200;64-700;1519;1054;1041;346;695
3;300201;300200;64-700;1480;896;890;341;549
4;300201;300200;64-700;1654;1221;1200;388;812
5;300201;300200;64-700;1383;1019;1012;365;647
6;300201;300200;64-700;55;17;16;4;12
1;300202;300200;64-704;627;424;422;258;164
2;300202;300200;64-705;202;128;124;92;32
3;300202;300200;64-707;797;497;494;313;181
4;300202;300200;64-708;404;283;281;130;151
5;300202;300200;64-700;1060;761;754;325;429
6;300202;300200;64-700;245;167;167;86;81
7;300202;300200;64-713;702;445;439;219;220
8;300202;300200;64-713;603;334;329;188;141
9;300202;300200;64-700;1043;644;643;282;361
10;300202;300200;64-704;621;370;363;211;152
11;300202;300200;64-700;594;396;391;173;218
12;300202;300200;64-700;384;261;259;106;153
13;300202;300200;64-700;215;162;161;95;66
14;300202;300200;64-700;200;135;134;72;62
15;300202;300200;64-700;232;167;167;117;50
16;300202;300200;64-705;212;147;145;80;65
17;300202;300200;64-700;363;211;209;112;97
1;300203;300200;64-733;1200;793;785;420;365
2;300203;300200;64-731;737;509;507;255;252
3;300203;300200;64-733;551;379;374;227;147
4;300203;300200;64-733;802;541;534;341;193
5;300203;300200;64-733;493;306;303;192;111
6;300203;300200;64-733;313;220;220;121;99
7;300203;300200;64-733;325;199;197;105;92
1;300204;300200;64-761;1916;1206;1196;518;678
2;300204;300200;64-761;1412;876;866;440;426
3;300204;300200;64-761;1942;1256;1246;582;664
4;300204;300200;64-761;222;143;142;90;52
5;300204;300200;64-761;508;296;296;156;140
6;300204;300200;64-761;210;109;109;55;54
1;300205;300200;64-720;756;520;517;257;260
2;300205;300200;64-720;821;571;567;268;299
3;300205;300200;64-720;714;535;531;208;323
4;300205;300200;64-720;374;232;231;105;126
5;300205;300200;64-720;647;431;426;231;195
6;300205;300200;64-720;352;235;234;117;117
7;300205;300200;64-720;568;441;439;195;244
8;300205;300200;64-720;356;233;231;135;96
9;300205;300200;64-720;235;156;151;101;50
10;300205;300200;64-720;237;167;164;81;83
11;300205;300200;64-720;346;200;197;97;100
12;300205;300200;64-720;205;146;146;60;86
1;300206;300200;64-710;2103;1491;1479;858;621
2;300206;300200;64-710;293;188;186;90;96
3;300206;300200;64-710;490;324;322;203;119
4;300206;300200;64-710;597;373;371;252;119
5;300206;300200;64-710;480;321;320;217;103
6;300206;300200;64-710;446;311;307;188;119
7;300206;300200;64-710;238;177;176;143;33
1;300207;300200;64-980;2151;1441;1429;483;946
2;300207;300200;64-980;1839;1237;1230;490;740
3;300207;300200;64-980;1762;1264;1258;411;847
4;300207;300200;64-980;2004;1340;1327;500;827
5;300207;300200;64-980;1997;1465;1458;552;906
6;300207;300200;64-980;2013;1388;1373;500;873
7;300207;300200;64-980;471;273;269;134;135
8;300207;300200;64-980;983;611;606;272;334
9;300207;300200;64-980;667;421;421;179;242
10;300207;300200;64-980;302;196;195;117;78
11;300207;300200;64-980;475;287;284;150;134
12;300207;300200;64-980;275;181;181;71;110
13;300207;300200;64-980;422;276;273;136;137
14;300207;300200;64-980;393;254;252;127;125
15;300207;300200;64-980;246;161;160;94;66
16;300207;300200;64-980;591;388;386;190;196
17;300207;300200;64-980;394;301;298;86;212
18;300207;300200;64-980;64;49;47;23;24
1;300208;300200;64-730;1413;813;800;413;387
2;300208;300200;64-730;406;277;276;196;80
3;300208;300200;64-730;1848;1235;1227;534;693
4;300208;300200;64-730;1075;654;648;342;306
5;300208;300200;64-730;970;629;622;252;370
6;300208;300200;64-730;893;450;445;223;222
7;300208;300200;64-730;732;419;416;234;182
8;300208;300200;64-730;690;393;389;203;186
9;300208;300200;64-730;711;469;464;218;246
10;300208;300200;64-730;269;91;87;73;14
11;300208;300200;64-730;32;15;14;6;8
1;300301;300300;62-200;650;407;401;175;226
2;300301;300300;62-200;1216;790;783;303;480
3;300301;300300;62-200;1135;745;741;285;456
4;300301;300300;62-200;654;399;396;183;213
5;300301;300300;62-200;937;552;549;234;315
6;300301;300300;62-200;910;503;498;240;258
7;300301;300300;62-200;1831;1007;1001;430;571
8;300301;300300;62-200;1878;1179;1176;566;610
9;300301;300300;62-200;2182;1661;1640;684;956
10;300301;300300;62-200;1791;1375;1356;463;893
11;300301;300300;62-200;1217;883;872;374;498
12;300301;300300;62-200;1982;1446;1435;533;902
13;300301;300300;62-200;1213;871;863;355;508
14;300301;300300;62-200;1187;874;866;369;497
15;300301;300300;62-200;1056;677;673;260;413
16;300301;300300;62-200;1366;986;980;406;574
17;300301;300300;62-200;1011;628;619;291;328
18;300301;300300;62-200;1211;972;960;446;514
19;300301;300300;62-200;1073;804;798;314;484
20;300301;300300;62-200;1217;909;901;282;619
21;300301;300300;62-200;1842;1306;1296;507;789
22;300301;300300;62-200;1959;1448;1430;581;849
23;300301;300300;62-200;1058;732;726;253;473
24;300301;300300;62-200;1067;743;737;311;426
25;300301;300300;62-200;1037;726;718;260;458
26;300301;300300;62-200;986;681;680;210;470
27;300301;300300;62-200;1972;1440;1423;493;930
28;300301;300300;62-200;1887;1482;1464;556;908
29;300301;300300;62-200;771;598;593;211;382
30;300301;300300;62-200;1890;1394;1386;532;854
31;300301;300300;62-200;1606;1181;1172;433;739
32;300301;300300;62-200;1642;1227;1217;453;764
33;300301;300300;62-200;1799;1340;1332;565;767
34;300301;300300;62-200;1061;770;764;338;426
35;300301;300300;62-200;1031;774;773;303;470
36;300301;300300;62-200;672;242;237;118;119
37;300301;300300;62-200;40;19;19;8;11
38;300301;300300;62-200;92;51;51;20;31
39;300301;300300;62-200;66;33;33;17;16
1;300302;300300;62-250;2004;1405;1386;745;641
2;300302;300300;62-250;494;357;354;186;168
3;300302;300300;62-241;1510;1060;1047;538;509
4;300302;300300;62-241;434;248;245;165;80
5;300302;300300;62-250;268;169;168;119;49
6;300302;300300;62-250;288;218;217;142;75
7;300302;300300;62-250;484;318;310;217;93
8;300302;300300;62-241;579;475;472;81;391
1;300303;300300;62-214;1501;1108;1102;433;669
2;300303;300300;62-214;1544;1198;1183;499;684
3;300303;300300;62-200;1174;883;874;341;533
4;300303;300300;62-200;1195;881;873;418;455
5;300303;300300;62-211;1287;891;882;513;369
6;300303;300300;62-200;1181;922;912;398;514
7;300303;300300;62-211;376;270;266;146;120
8;300303;300300;62-214;802;558;553;289;264
9;300303;300300;62-200;908;643;636;291;345
10;300303;300300;62-214;542;373;371;177;194
1;300304;300300;62-280;964;684;672;343;329
2;300304;300300;62-280;751;468;466;272;194
3;300304;300300;62-265;896;603;595;342;253
4;300304;300300;62-280;430;281;279;96;183
5;300304;300300;62-272;258;197;195;108;87
6;300304;300300;62-265;202;157;153;106;47
7;300304;300300;62-280;151;100;97;62;35
8;300304;300300;62-280;165;117;116;68;48
9;300304;300300;62-280;274;188;187;104;83
1;300305;300300;62-270;1030;725;720;368;352
2;300305;300300;62-270;798;610;599;339;260
3;300305;300300;62-270;461;363;360;191;169
4;300305;300300;62-270;155;108;105;75;30
5;300305;300300;62-271;1092;763;757;513;244
6;300305;300300;62-271;645;402;396;240;156
7;300305;300300;62-270;209;127;127;97;30
8;300305;300300;62-270;293;183;181;144;37
9;300305;300300;62-270;365;233;232;160;72
10;300305;300300;62-270;216;155;151;96;55
11;300305;300300;62-270;153;111;109;86;23
1;300306;300300;62-261;663;490;482;154;328
2;300306;300300;62-262;836;575;569;273;296
3;300306;300300;62-260;885;697;692;346;346
4;300306;300300;62-260;253;200;197;136;61
5;300306;300300;62-261;597;421;420;227;193
6;300306;300300;62-261;560;404;400;160;240
7;300306;300300;62-262;740;576;568;205;363
8;300306;300300;62-260;525;353;343;206;137
9;300306;300300;62-260;464;291;290;192;98
1;300307;300300;62-212;623;447;444;227;217
2;300307;300300;62-212;417;267;267;165;102
3;300307;300300;62-213;539;345;345;214;131
4;300307;300300;62-212;356;236;236;169;67
5;300307;300300;62-212;290;159;159;96;63
6;300307;300300;62-212;175;108;105;64;41
7;300307;300300;62-212;472;316;314;232;82
1;300308;300300;62-220;1527;1117;1102;645;457
2;300308;300300;62-220;761;499;488;353;135
3;300308;300300;62-220;623;388;384;244;140
4;300308;300300;62-220;1001;781;773;346;427
5;300308;300300;62-220;280;146;146;107;39
6;300308;300300;62-220;254;191;188;143;45
1;300309;300300;62-240;1375;875;863;449;414
2;300309;300300;62-240;1035;717;714;320;394
3;300309;300300;62-240;1473;960;951;450;501
4;300309;300300;62-240;579;341;339;183;156
5;300309;300300;62-240;969;577;571;314;257
6;300309;300300;62-240;362;242;240;172;68
7;300309;300300;62-240;466;308;305;142;163
8;300309;300300;62-240;438;234;232;127;105
9;300309;300300;62-240;961;663;651;337;314
10;300309;300300;62-240;1045;670;663;502;161
11;300309;300300;62-240;298;176;175;84;91
12;300309;300300;62-240;226;139;133;82;51
13;300309;300300;62-240;347;225;224;110;114
14;300309;300300;62-240;209;133;133;93;40
15;300309;300300;62-240;523;323;322;195;127
1;300310;300300;62-230;1166;867;863;312;551
2;300310;300300;62-230;1674;1248;1236;456;780
3;300310;300300;62-230;831;568;562;385;177
4;300310;300300;62-230;659;460;456;324;132
5;300310;300300;62-230;335;221;219;148;71
6;300310;300300;62-230;402;262;258;199;59
7;300310;300300;62-230;759;499;494;342;152
8;300310;300300;62-230;1388;987;980;543;437
9;300310;300300;62-230;882;606;596;352;244
10;300310;300300;62-230;701;509;503;154;349
11;300310;300300;62-230;263;207;206;126;80
12;300310;300300;62-230;240;162;162;119;43
13;300310;300300;62-230;384;235;233;160;73
14;300310;300300;62-230;190;115;115;71;44
1;300401;300400;63-810;1171;773;765;381;384
2;300401;300400;63-810;1255;826;818;455;363
3;300401;300400;63-810;567;309;308;197;111
4;300401;300400;63-810;709;397;394;310;84
5;300401;300400;63-810;924;541;536;412;124
6;300401;300400;63-810;381;222;218;162;56
7;300401;300400;63-810;175;115;113;92;21
8;300401;300400;63-810;275;181;180;122;58
1;300402;300400;63-800;854;618;613;349;264
2;300402;300400;63-800;776;504;501;232;269
3;300402;300400;63-800;966;664;658;324;334
4;300402;300400;63-800;843;572;569;253;316
5;300402;300400;63-800;1370;1034;1022;467;555
6;300402;300400;63-800;842;591;582;298;284
7;300402;300400;63-800;1071;767;761;392;369
8;300402;300400;63-800;821;568;561;246;315
9;300402;300400;63-800;963;662;657;336;321
10;300402;300400;63-800;827;527;523;247;276
11;300402;300400;63-800;989;648;641;268;373
12;300402;300400;63-800;960;670;668;329;339
13;300402;300400;63-800;1370;1061;1053;507;546
14;300402;300400;63-800;1201;861;850;414;436
15;300402;300400;63-800;726;500;496;207;289
16;300402;300400;63-800;334;227;224;142;82
17;300402;300400;63-800;316;204;204;152;52
18;300402;300400;63-800;1012;639;633;401;232
19;300402;300400;63-800;1029;710;704;435;269
20;300402;300400;63-800;666;383;382;242;140
21;300402;300400;63-800;264;180;179;129;50
22;300402;300400;63-800;589;382;377;229;148
23;300402;300400;63-800;331;208;207;168;39
24;300402;300400;63-800;223;147;145;114;31
25;300402;300400;63-800;316;214;213;141;72
26;300402;300400;63-800;199;132;131;110;21
27;300402;300400;63-800;451;308;306;245;61
28;300402;300400;63-840;215;164;163;120;43
29;300402;300400;63-800;78;21;21;9;12
1;300403;300400;63-840;1352;919;914;541;373
2;300403;300400;63-840;1987;1365;1360;694;666
3;300403;300400;63-840;349;225;224;141;83
4;300403;300400;63-842;1749;1131;1113;681;432
5;300403;300400;63-840;582;295;292;208;84
6;300403;300400;63-840;387;257;257;202;55
7;300403;300400;63-840;340;190;189;137;52
8;300403;300400;63-840;406;252;247;203;44
9;300403;300400;63-840;178;135;135;113;22
10;300403;300400;63-840;439;308;308;258;50
11;300403;300400;63-840;775;531;525;410;115
12;300403;300400;63-840;227;146;146;123;23
13;300403;300400;63-840;331;221;221;149;72
14;300403;300400;63-840;395;218;212;159;53
15;300403;300400;63-840;106;23;22;8;14
1;300404;300400;63-830;1398;958;949;558;391
2;300404;300400;63-830;272;177;177;112;65
3;300404;300400;63-830;401;276;275;181;94
4;300404;300400;63-830;283;197;193;141;52
5;300404;300400;63-830;227;155;154;94;60
6;300404;300400;63-830;352;250;244;169;75
7;300404;300400;63-830;167;126;124;89;35
8;300404;300400;63-830;562;386;383;298;85
9;300404;300400;63-830;345;242;238;187;51
10;300404;300400;63-830;372;264;263;212;51
1;300405;300400;63-820;498;376;371;175;196
2;300405;300400;63-820;874;606;599;266;333
3;300405;300400;63-820;397;253;252;161;91
4;300405;300400;63-820;377;258;254;168;86
5;300405;300400;63-820;475;322;321;240;81
6;300405;300400;63-820;598;418;413;275;138
7;300405;300400;63-820;412;302;300;230;70
8;300405;300400;63-840;328;224;224;176;48
9;300405;300400;63-800;323;244;238;166;72
10;300405;300400;63-820;643;398;397;288;109
11;300405;300400;63-820;948;670;661;348;313
12;300405;300400;63-820;466;283;282;196;86
13;300405;300400;63-820;97;61;61;31;30
14;300405;300400;63-820;72;13;13;5;8
1;300406;300400;63-860;1557;1010;1000;520;480
2;300406;300400;63-860;461;300;299;226;73
3;300406;300400;63-860;522;341;337;266;71
4;300406;300400;63-860;436;209;209;154;55
5;300406;300400;63-860;231;161;160;114;46
6;300406;300400;63-860;432;265;265;182;83
1;300407;300400;64-125;2146;1399;1386;710;676
2;300407;300400;64-125;795;452;447;297;150
3;300407;300400;63-805;653;407;402;336;66
4;300407;300400;64-125;217;144;143;114;29
5;300407;300400;63-805;591;368;363;278;85
6;300407;300400;64-125;355;221;220;139;81
7;300407;300400;64-125;366;217;214;144;70
8;300407;300400;63-805;370;205;203;157;46
9;300407;300400;64-125;183;131;131;95;36
1;300501;300500;62-066;1166;786;778;434;344
2;300501;300500;62-066;931;714;708;352;356
3;300501;300500;62-066;442;302;297;200;97
4;300501;300500;62-066;682;431;430;297;133
5;300501;300500;62-066;615;391;385;254;131
1;300502;300500;62-065;2002;1490;1480;609;871
2;300502;300500;62-065;2223;1615;1599;732;867
3;300502;300500;62-065;1206;828;821;384;437
4;300502;300500;62-065;1773;1313;1302;517;785
5;300502;300500;62-065;2009;1402;1390;605;785
6;300502;300500;62-065;935;634;631;402;229
7;300502;300500;62-065;2282;1439;1427;805;622
8;300502;300500;62-065;1540;993;988;455;533
9;300502;300500;62-065;782;492;489;295;194
10;300502;300500;62-065;88;34;34;14;20
1;300503;300500;64-061;994;740;732;335;397
2;300503;300500;64-061;939;561;557;354;203
3;300503;300500;64-060;742;504;498;309;189
4;300503;300500;64-060;936;569;563;370;193
5;300503;300500;64-061;971;649;646;461;185
6;300503;300500;64-060;308;205;204;122;82
1;300504;300500;62-067;1789;1251;1239;636;603
2;300504;300500;62-067;2292;1536;1516;797;719
3;300504;300500;62-068;1805;1188;1178;560;618
4;300504;300500;64-308;2100;1292;1277;704;573
5;300504;300500;62-073;1253;773;765;476;289
6;300504;300500;62-068;598;385;383;251;132
1;300505;300500;64-050;1269;839;833;414;419
2;300505;300500;64-050;737;461;457;317;140
3;300505;300500;64-050;1220;830;826;566;260
4;300505;300500;64-050;1344;854;844;528;316
5;300505;300500;64-050;479;309;302;198;104
1;300601;300600;63-233;327;225;224;155;69
2;300601;300600;63-233;589;383;381;261;120
3;300601;300600;63-233;1040;659;649;390;259
4;300601;300600;63-233;718;497;494;329;165
5;300601;300600;63-233;849;522;518;374;144
6;300601;300600;63-233;463;321;318;209;109
7;300601;300600;63-233;185;114;114;80;34
8;300601;300600;63-233;357;270;266;216;50
9;300601;300600;63-233;182;137;134;92;42
10;300601;300600;63-233;217;155;151;116;35
11;300601;300600;63-233;174;132;132;92;40
12;300601;300600;63-233;213;154;151;103;48
13;300601;300600;63-233;398;264;261;203;58
14;300601;300600;63-233;168;118;118;86;32
1;300602;300600;63-200;1801;1232;1220;724;496
2;300602;300600;63-200;2142;1445;1431;838;593
3;300602;300600;63-200;1521;1044;1028;643;385
4;300602;300600;63-200;658;413;407;311;96
5;300602;300600;63-200;1380;936;924;566;358
6;300602;300600;63-230;1655;1151;1141;620;521
7;300602;300600;63-230;1333;889;874;478;396
8;300602;300600;63-200;2703;1947;1927;836;1091
9;300602;300600;63-200;1228;924;914;397;517
10;300602;300600;63-200;2622;1860;1842;738;1104
11;300602;300600;63-200;1341;950;940;393;547
12;300602;300600;63-200;1612;1082;1068;583;485
13;300602;300600;63-200;1550;1039;1029;400;629
14;300602;300600;63-200;1514;1090;1076;479;597
15;300602;300600;63-200;1730;1290;1276;490;786
16;300602;300600;63-200;1773;1255;1246;520;726
17;300602;300600;63-200;1424;1071;1065;422;643
18;300602;300600;63-200;544;371;370;271;99
19;300602;300600;63-200;891;566;563;303;260
20;300602;300600;63-200;652;411;404;229;175
21;300602;300600;63-200;787;547;540;315;225
22;300602;300600;63-200;825;522;517;320;197
23;300602;300600;63-230;381;221;220;152;68
24;300602;300600;63-200;1850;1198;1177;610;567
25;300602;300600;63-200;63;34;33;20;13
1;300603;300600;63-220;1116;754;747;422;325
2;300603;300600;63-220;1265;897;888;479;409
3;300603;300600;63-220;695;437;433;305;128
4;300603;300600;63-220;150;103;103;80;23
5;300603;300600;63-220;512;296;290;198;92
6;300603;300600;63-220;197;142;141;87;54
7;300603;300600;63-220;187;131;131;110;21
8;300603;300600;63-220;199;139;136;78;58
9;300603;300600;63-220;280;161;161;115;46
10;300603;300600;63-220;391;240;236;165;71
11;300603;300600;63-220;181;116;114;89;25
12;300603;300600;63-220;25;18;17;10;7
1;300604;300600;63-210;1637;1228;1214;668;546
2;300604;300600;63-210;763;522;514;362;152
3;300604;300600;63-210;762;503;497;356;141
4;300604;300600;63-210;889;576;568;417;151
5;300604;300600;63-210;429;257;254;191;63
6;300604;300600;63-210;561;376;372;230;142
7;300604;300600;63-210;519;365;360;292;68
8;300604;300600;63-210;508;337;334;270;64
9;300604;300600;63-210;433;280;277;190;87
10;300604;300600;63-210;264;191;189;142;47
11;300604;300600;63-210;386;279;276;221;55
12;300604;300600;63-210;495;321;319;217;102
13;300604;300600;63-210;20;11;10;1;9
1;300701;300700;62-814;907;584;581;389;192
2;300701;300700;62-814;936;538;528;354;174
3;300701;300700;62-814;832;583;578;386;192
4;300701;300700;62-812;599;376;374;252;122
5;300701;300700;62-812;1886;1409;1401;775;626
6;300701;300700;62-800;1039;762;757;373;384
7;300701;300700;62-814;1025;655;650;405;245
8;300701;300700;62-814;422;283;281;193;88
1;300702;300700;62-874;533;388;387;220;167
2;300702;300700;62-874;458;353;352;208;144
3;300702;300700;62-874;295;186;185;132;53
4;300702;300700;62-874;663;454;451;363;88
5;300702;300700;62-874;382;240;240;201;39
6;300702;300700;62-874;721;536;532;372;160
7;300702;300700;62-874;477;301;300;211;89
8;300702;300700;62-874;372;274;273;203;70
9;300702;300700;62-874;180;128;127;102;25
10;300702;300700;62-874;231;168;164;106;58
11;300702;300700;62-874;166;101;99;75;24
1;300703;300700;62-834;1090;705;697;420;277
2;300703;300700;62-834;511;361;361;204;157
3;300703;300700;62-834;862;609;604;336;268
4;300703;300700;62-834;300;203;201;160;41
5;300703;300700;62-834;451;290;287;214;73
6;300703;300700;62-834;162;106;106;78;28
7;300703;300700;62-834;273;193;189;129;60
1;300704;300700;62-872;783;526;522;381;141
2;300704;300700;62-872;1047;718;712;502;210
3;300704;300700;62-872;706;439;434;284;150
4;300704;300700;62-872;1153;882;871;434;437
5;300704;300700;62-872;452;294;292;207;85
6;300704;300700;62-872;403;309;307;203;104
7;300704;300700;62-872;445;252;249;205;44
8;300704;300700;62-872;559;419;416;285;131
9;300704;300700;62-872;683;523;522;237;285
10;300704;300700;62-872;211;133;132;98;34
11;300704;300700;62-872;268;176;175;136;39
12;300704;300700;62-872;282;175;175;132;43
13;300704;300700;62-872;239;164;163;114;49
14;300704;300700;62-872;308;225;224;153;71
15;300704;300700;62-872;84;63;62;35;27
1;300705;300700;62-840;732;533;526;307;219
2;300705;300700;62-840;302;181;181;112;69
3;300705;300700;62-840;734;511;509;402;107
4;300705;300700;62-840;676;435;431;329;102
5;300705;300700;62-840;800;544;540;417;123
6;300705;300700;62-840;469;328;326;253;73
7;300705;300700;62-840;528;337;335;235;100
8;300705;300700;62-840;419;269;268;150;118
9;300705;300700;62-840;336;215;214;166;48
10;300705;300700;62-840;185;131;130;110;20
11;300705;300700;62-840;564;383;378;224;154
12;300705;300700;62-840;127;69;67;38;29
13;300705;300700;62-840;35;29;28;21;7
1;300706;300700;62-850;527;317;317;239;78
2;300706;300700;62-850;1003;637;633;516;117
3;300706;300700;62-850;1501;963;945;585;360
4;300706;300700;62-850;595;385;383;281;102
5;300706;300700;62-850;310;231;230;165;65
6;300706;300700;62-850;38;17;16;12;4
7;300706;300700;62-850;74;38;35;25;10
1;300707;300700;62-831;1022;663;659;471;188
2;300707;300700;62-831;726;455;452;344;108
3;300707;300700;62-831;837;487;481;349;132
4;300707;300700;62-831;414;289;287;214;73
5;300707;300700;62-831;358;248;245;187;58
6;300707;300700;62-831;304;225;220;142;78
1;300708;300700;62-860;1564;1146;1140;615;525
2;300708;300700;62-860;1174;861;856;539;317
3;300708;300700;62-860;1460;1154;1146;623;523
4;300708;300700;62-860;395;276;273;213;60
5;300708;300700;62-860;1857;1310;1301;803;498
6;300708;300700;62-860;927;665;656;471;185
7;300708;300700;62-860;316;229;227;173;54
8;300708;300700;62-860;298;204;203;168;35
9;300708;300700;62-860;191;135;135;104;31
1;300709;300700;62-820;1073;717;714;424;290
2;300709;300700;62-820;1491;929;918;604;314
3;300709;300700;62-830;1283;917;909;549;360
4;300709;300700;62-820;555;381;377;217;160
5;300709;300700;62-830;553;375;370;241;129
6;300709;300700;62-830;314;198;194;115;79
7;300709;300700;62-820;29;4;4;0;4
1;300710;300700;62-865;1093;782;774;565;209
2;300710;300700;62-865;957;676;672;487;185
3;300710;300700;62-865;794;590;589;447;142
4;300710;300700;62-862;1621;1147;1138;947;191
5;300710;300700;62-862;296;201;201;168;33
6;300710;300700;62-865;213;150;149;126;23
7;300710;300700;62-865;586;420;415;296;119
8;300710;300700;62-862;371;276;273;228;45
1;300711;300700;62-817;1274;923;917;644;273
2;300711;300700;62-817;1075;749;742;533;209
3;300711;300700;62-817;1199;906;897;552;345
4;300711;300700;62-817;480;359;357;251;106
5;300711;300700;62-817;1105;771;759;535;224
6;300711;300700;62-817;1159;888;884;463;421
7;300711;300700;62-817;482;355;351;222;129
8;300711;300700;62-817;488;313;309;241;68
1;300801;300800;63-604;1625;1214;1202;487;715
2;300801;300800;63-604;411;273;273;163;110
3;300801;300800;63-604;669;460;456;301;155
4;300801;300800;63-604;1076;754;749;411;338
5;300801;300800;63-604;1039;680;674;415;259
6;300801;300800;63-604;675;504;500;361;139
7;300801;300800;63-604;460;324;321;203;118
8;300801;300800;63-604;210;147;147;95;52
9;300801;300800;63-604;44;44;44;33;11
1;300802;300800;63-640;1172;886;877;425;452
2;300802;300800;63-640;953;690;688;287;401
3;300802;300800;63-640;529;324;320;203;117
4;300802;300800;63-640;703;484;478;271;207
5;300802;300800;63-640;701;472;465;243;222
6;300802;300800;63-640;344;249;247;172;75
7;300802;300800;63-640;224;168;168;99;69
1;300803;300800;63-600;1841;1301;1288;574;714
2;300803;300800;63-600;2193;1725;1713;636;1077
3;300803;300800;63-600;630;447;439;171;268
4;300803;300800;63-600;1656;1094;1087;462;625
5;300803;300800;63-600;943;731;723;262;461
6;300803;300800;63-600;1882;1344;1333;585;748
7;300803;300800;63-600;1922;1382;1367;666;701
8;300803;300800;63-600;1086;768;766;374;392
9;300803;300800;63-600;352;251;251;166;85
10;300803;300800;63-600;335;219;217;151;66
11;300803;300800;63-600;866;571;567;323;244
12;300803;300800;63-600;784;548;543;282;261
13;300803;300800;63-600;633;403;400;242;158
14;300803;300800;63-600;911;613;602;337;265
15;300803;300800;63-600;1256;844;831;537;294
16;300803;300800;63-600;554;386;378;165;213
17;300803;300800;63-600;53;20;20;10;10
18;300803;300800;63-600;49;20;18;11;7
1;300804;300800;63-645;1442;953;944;594;350
2;300804;300800;63-645;927;645;638;378;260
3;300804;300800;63-645;1030;677;674;392;282
4;300804;300800;63-645;562;400;393;286;107
1;300805;300800;63-642;1071;722;718;341;377
2;300805;300800;63-642;660;432;425;279;146
3;300805;300800;63-642;605;367;363;203;160
4;300805;300800;63-642;246;170;167;86;81
5;300805;300800;63-642;262;183;182;115;67
1;300806;300800;63-630;1228;836;830;450;380
2;300806;300800;63-630;402;263;261;200;61
3;300806;300800;63-630;365;221;218;139;79
4;300806;300800;63-630;622;330;330;211;119
5;300806;300800;63-630;200;138;138;77;61
1;300807;300800;63-620;1227;814;807;483;324
2;300807;300800;63-620;1264;881;874;552;322
3;300807;300800;63-620;601;395;390;263;127
4;300807;300800;63-620;266;195;195;156;39
5;300807;300800;63-620;189;137;134;94;40
6;300807;300800;63-620;257;165;163;105;58
1;300901;300900;62-600;1205;859;849;442;407
2;300901;300900;62-600;1050;557;552;354;198
3;300901;300900;62-600;1327;803;792;431;361
4;300901;300900;62-600;907;645;641;297;344
5;300901;300900;62-600;1195;849;840;431;409
6;300901;300900;62-600;1521;1063;1055;563;492
7;300901;300900;62-600;1976;1333;1322;690;632
8;300901;300900;62-600;1085;771;759;380;379
9;300901;300900;62-600;1235;907;899;453;446
10;300901;300900;62-600;1003;764;760;325;435
11;300901;300900;62-600;1233;859;854;401;453
12;300901;300900;62-600;956;643;633;307;326
13;300901;300900;62-600;88;44;43;28;15
14;300901;300900;62-600;48;24;22;17;5
15;300901;300900;62-600;43;20;20;14;6
1;300902;300900;62-620;1659;1166;1156;786;370
2;300902;300900;62-620;801;490;487;390;97
3;300902;300900;62-620;1154;748;746;599;147
4;300902;300900;62-620;1461;1035;1032;776;256
5;300902;300900;62-620;761;477;477;368;109
1;300903;300900;62-652;342;222;221;148;73
2;300903;300900;62-652;743;452;450;353;97
3;300903;300900;62-652;609;376;374;317;57
4;300903;300900;62-652;628;408;403;298;105
1;300904;300900;62-660;1425;968;964;676;288
2;300904;300900;62-660;907;613;608;487;121
3;300904;300900;62-660;354;251;248;193;55
4;300904;300900;62-660;1010;721;715;589;126
5;300904;300900;62-660;911;666;660;542;118
1;300905;300900;62-640;1499;1025;1018;668;350
2;300905;300900;62-640;502;365;363;262;101
3;300905;300900;62-640;552;330;327;250;77
4;300905;300900;62-640;554;334;332;267;65
5;300905;300900;62-640;284;190;188;138;50
6;300905;300900;62-640;450;286;282;206;76
7;300905;300900;62-640;395;268;263;205;58
1;300906;300900;62-650;1696;1119;1111;666;445
2;300906;300900;62-650;1211;766;760;456;304
3;300906;300900;62-650;1368;899;894;592;302
4;300906;300900;62-650;1081;676;665;412;253
5;300906;300900;62-650;794;517;511;372;139
6;300906;300900;62-650;435;287;281;206;75
7;300906;300900;62-650;783;541;534;422;112
8;300906;300900;62-650;588;405;401;305;96
9;300906;300900;62-650;500;305;305;253;52
10;300906;300900;62-650;436;289;288;213;75
11;300906;300900;62-650;298;174;174;137;37
1;300907;300900;62-600;1652;1202;1192;670;522
2;300907;300900;62-600;1033;704;700;505;195
3;300907;300900;62-600;508;324;320;255;65
4;300907;300900;62-600;1186;809;803;544;259
5;300907;300900;62-600;583;403;399;254;145
6;300907;300900;62-600;606;435;435;264;171
7;300907;300900;62-600;384;265;263;203;60
1;300908;300900;62-604;1172;752;750;586;164
2;300908;300900;62-604;1313;972;968;679;289
3;300908;300900;62-604;1308;899;894;600;294
4;300908;300900;62-604;1439;1054;1047;753;294
1;300909;300900;62-641;928;577;570;453;117
2;300909;300900;62-641;1356;869;864;704;160
3;300909;300900;62-641;561;355;348;299;49
4;300909;300900;62-641;509;337;337;268;69
1;300910;300900;62-613;1918;1290;1280;956;324
2;300910;300900;62-613;1057;709;699;533;166
3;300910;300900;62-600;1795;1285;1276;932;344
1;300911;300900;62-635;1219;779;777;536;241
2;300911;300900;62-635;984;659;657;520;137
3;300911;300900;62-635;856;516;514;400;114
1;301001;301000;62-590;1221;899;890;527;363
2;301001;301000;62-590;928;639;627;348;279
3;301001;301000;62-590;1372;1034;1028;567;461
4;301001;301000;62-590;665;474;468;280;188
5;301001;301000;62-590;608;426;419;272;147
6;301001;301000;62-590;1089;733;729;483;246
7;301001;301000;62-590;574;395;392;289;103
8;301001;301000;62-590;1185;743;734;414;320
9;301001;301000;62-590;458;355;353;230;123
10;301001;301000;62-590;569;391;391;235;156
11;301001;301000;62-590;832;568;567;405;162
1;301002;301000;62-580;909;609;601;355;246
2;301002;301000;62-580;612;357;354;276;78
3;301002;301000;62-580;888;560;556;433;123
4;301002;301000;62-580;637;420;414;340;74
5;301002;301000;62-580;818;531;526;366;160
1;301003;301000;62-530;608;408;405;310;95
2;301003;301000;62-530;1842;1230;1216;824;392
3;301003;301000;62-530;1272;901;889;559;330
4;301003;301000;62-530;635;418;413;323;90
5;301003;301000;62-530;414;298;294;179;115
6;301003;301000;62-530;1775;1405;1399;631;768
7;301003;301000;62-530;410;268;263;195;68
8;301003;301000;62-530;331;210;210;174;36
9;301003;301000;62-530;442;322;321;190;131
10;301003;301000;62-530;392;313;308;135;173
11;301003;301000;62-530;694;510;510;263;247
1;301004;301000;62-540;944;635;625;353;272
2;301004;301000;62-540;1017;676;672;452;220
3;301004;301000;62-540;1138;819;809;568;241
4;301004;301000;62-540;798;565;558;435;123
5;301004;301000;62-540;368;256;255;207;48
6;301004;301000;62-541;1197;801;797;599;198
7;301004;301000;62-541;1090;773;766;547;219
8;301004;301000;62-540;720;478;476;377;99
9;301004;301000;62-541;380;251;250;187;63
1;301005;301000;62-511;1031;719;718;502;216
2;301005;301000;62-511;1074;758;747;517;230
3;301005;301000;62-511;392;241;240;193;47
4;301005;301000;62-511;557;384;383;307;76
5;301005;301000;62-511;669;476;471;351;120
6;301005;301000;62-563;537;389;387;295;92
7;301005;301000;62-563;589;384;380;293;87
8;301005;301000;62-510;1369;1009;995;613;382
9;301005;301000;62-511;617;446;445;324;121
10;301005;301000;62-510;822;603;601;272;329
11;301005;301000;62-511;508;343;338;280;58
12;301005;301000;62-511;666;475;473;376;97
1;301006;301000;62-513;1624;1088;1075;779;296
2;301006;301000;62-513;810;548;543;382;161
3;301006;301000;62-513;1819;1309;1297;855;442
4;301006;301000;62-513;335;216;216;173;43
5;301006;301000;62-513;1071;763;758;557;201
6;301006;301000;62-513;607;414;412;309;103
1;301007;301000;62-573;840;577;576;478;98
2;301007;301000;62-570;716;479;479;365;114
3;301007;301000;62-570;1107;812;804;502;302
4;301007;301000;62-570;780;460;458;333;125
5;301007;301000;62-574;428;315;313;174;139
6;301007;301000;62-574;501;305;301;243;58
7;301007;301000;62-574;869;614;609;453;156
8;301007;301000;62-570;1000;672;666;449;217
1;301008;301000;62-586;1583;1070;1064;678;386
2;301008;301000;62-586;1928;1385;1375;826;549
3;301008;301000;62-586;944;601;599;450;149
4;301008;301000;62-586;1124;743;738;549;189
1;301009;301000;62-560;363;240;237;154;83
2;301009;301000;62-560;299;166;165;115;50
3;301009;301000;62-560;1366;904;888;529;359
4;301009;301000;62-560;620;405;403;323;80
5;301009;301000;62-560;303;209;209;155;54
6;301009;301000;62-560;294;190;188;144;44
7;301009;301000;62-560;507;304;298;212;86
8;301009;301000;62-560;413;258;256;202;54
9;301009;301000;62-560;483;294;290;258;32
1;301010;301000;62-610;1227;836;829;493;336
2;301010;301000;62-610;1019;697;693;480;213
3;301010;301000;62-610;1069;738;737;561;176
4;301010;301000;62-610;670;476;473;404;69
5;301010;301000;62-610;1557;1038;1032;756;276
6;301010;301000;62-610;981;691;687;593;94
7;301010;301000;62-610;440;306;304;266;38
8;301010;301000;62-610;861;579;575;426;149
1;301011;301000;62-571;1207;908;895;485;410
2;301011;301000;62-571;1204;937;925;438;487
3;301011;301000;62-571;1634;1248;1240;588;652
4;301011;301000;62-571;447;307;304;166;138
5;301011;301000;62-571;958;633;630;435;195
6;301011;301000;62-571;555;382;380;265;115
7;301011;301000;62-571;546;365;359;277;82
8;301011;301000;62-500;829;626;622;308;314
9;301011;301000;62-571;1040;764;756;551;205
10;301011;301000;62-571;637;461;457;304;153
11;301011;301000;62-570;503;360;357;256;101
1;301012;301000;62-561;1329;940;927;459;468
2;301012;301000;62-561;1029;739;734;400;334
3;301012;301000;62-561;575;405;400;289;111
4;301012;301000;62-561;974;643;640;392;248
5;301012;301000;62-561;1241;845;842;576;266
6;301012;301000;62-561;920;585;580;446;134
7;301012;301000;62-561;1665;1079;1069;725;344
8;301012;301000;62-561;768;505;503;330;173
9;301012;301000;62-563;1551;1080;1070;745;325
10;301012;301000;62-561;516;375;371;246;125
11;301012;301000;62-561;437;291;290;231;59
12;301012;301000;62-561;20;4;4;2;2
1;301013;301000;62-610;735;459;458;386;72
2;301013;301000;62-619;671;430;429;364;65
3;301013;301000;62-619;830;541;539;458;81
4;301013;301000;62-619;726;481;478;371;107
5;301013;301000;62-619;532;326;323;276;47
6;301013;301000;62-619;829;572;566;448;118
7;301013;301000;62-618;745;458;455;375;80
8;301013;301000;62-619;265;170;169;141;28
1;301014;301000;62-550;980;654;645;495;150
2;301014;301000;62-550;1006;715;705;419;286
3;301014;301000;62-550;380;273;269;161;108
4;301014;301000;62-550;681;454;452;397;55
5;301014;301000;62-550;561;366;364;295;69
6;301014;301000;62-550;637;403;403;341;62
7;301014;301000;62-550;321;220;217;181;36
1;301101;301100;64-000;1385;1070;1058;380;678
2;301101;301100;64-000;1307;962;956;360;596
3;301101;301100;64-000;1650;1301;1289;433;856
4;301101;301100;64-000;893;695;684;233;451
5;301101;301100;64-000;786;571;564;219;345
6;301101;301100;64-000;1557;1191;1177;464;713
7;301101;301100;64-000;1414;1072;1056;388;668
8;301101;301100;64-000;1784;1286;1271;459;812
9;301101;301100;64-000;1764;1358;1349;456;893
10;301101;301100;64-000;2435;1732;1717;656;1061
11;301101;301100;64-000;1077;729;724;289;435
12;301101;301100;64-000;1131;781;776;289;487
13;301101;301100;64-000;301;191;189;103;86
14;301101;301100;64-000;144;77;74;40;34
1;301102;301100;64-020;1239;884;878;392;486
2;301102;301100;64-020;1198;852;846;334;512
3;301102;301100;64-020;431;291;290;113;177
4;301102;301100;64-020;279;174;172;120;52
5;301102;301100;64-020;1003;669;664;298;366
6;301102;301100;64-020;246;148;148;79;69
7;301102;301100;64-020;715;484;479;252;227
8;301102;301100;64-020;557;392;389;226;163
9;301102;301100;64-020;404;271;268;156;112
10;301102;301100;64-020;162;101;101;73;28
11;301102;301100;64-020;437;260;258;129;129
12;301102;301100;64-020;192;134;134;62;72
13;301102;301100;64-020;380;267;265;152;113
14;301102;301100;64-020;567;388;384;158;226
15;301102;301100;64-020;854;633;617;244;373
16;301102;301100;64-020;70;48;47;26;21
1;301103;301100;64-000;819;540;536;335;201
2;301103;301100;64-000;973;683;676;320;356
3;301103;301100;64-000;691;419;414;213;201
4;301103;301100;64-000;1135;801;791;330;461
5;301103;301100;64-000;1544;1071;1053;465;588
6;301103;301100;64-000;1629;1103;1094;479;615
7;301103;301100;64-000;703;486;480;289;191
8;301103;301100;64-000;619;393;390;246;144
9;301103;301100;64-000;632;464;458;227;231
10;301103;301100;64-000;1545;1040;1034;575;459
11;301103;301100;64-000;1041;804;793;409;384
12;301103;301100;64-000;967;643;636;327;309
1;301104;301100;64-010;465;331;329;245;84
2;301104;301100;64-010;1116;767;760;448;312
3;301104;301100;64-010;1270;920;911;614;297
4;301104;301100;64-010;522;348;347;245;102
5;301104;301100;64-010;416;268;264;137;127
6;301104;301100;64-010;367;230;227;146;81
7;301104;301100;64-010;204;142;142;124;18
8;301104;301100;64-010;171;116;115;80;35
9;301104;301100;64-010;294;206;205;140;65
10;301104;301100;64-010;296;198;198;143;55
11;301104;301100;64-010;209;146;145;119;26
12;301104;301100;64-010;261;169;168;126;42
13;301104;301100;64-010;162;120;119;99;20
14;301104;301100;64-010;192;102;102;77;25
15;301104;301100;64-010;246;174;171;142;29
16;301104;301100;64-010;431;291;290;216;74
17;301104;301100;64-010;355;205;200;127;73
18;301104;301100;64-010;395;256;253;168;85
1;301105;301100;64-030;1039;720;714;324;390
2;301105;301100;64-030;1009;706;701;335;366
3;301105;301100;64-030;912;584;576;272;304
4;301105;301100;64-030;1124;742;733;303;430
5;301105;301100;64-030;488;330;323;166;157
6;301105;301100;64-030;1115;724;718;443;275
7;301105;301100;64-030;518;355;351;177;174
8;301105;301100;64-030;282;194;192;139;53
9;301105;301100;64-030;1224;831;818;441;377
10;301105;301100;64-030;322;194;194;123;71
11;301105;301100;64-030;741;481;478;315;163
12;301105;301100;64-030;495;283;281;232;49
13;301105;301100;64-030;471;296;294;200;94
14;301105;301100;64-030;433;292;290;213;77
15;301105;301100;64-030;625;386;381;249;132
16;301105;301100;64-030;325;223;218;117;101
17;301105;301100;64-030;275;186;185;133;52
18;301105;301100;64-030;224;163;162;95;67
19;301105;301100;64-030;533;346;343;246;97
20;301105;301100;64-030;303;177;177;129;48
21;301105;301100;64-030;437;285;283;167;116
22;301105;301100;64-030;37;35;35;20;15
1;301201;301200;63-750;796;538;536;350;186
2;301201;301200;63-750;621;410;406;245;161
3;301201;301200;63-750;667;442;432;255;177
1;301202;301200;63-740;1298;836;822;470;352
2;301202;301200;63-740;1092;713;709;413;296
3;301202;301200;63-740;204;121;121;103;18
4;301202;301200;63-740;1025;646;639;431;208
5;301202;301200;63-740;524;347;344;228;116
6;301202;301200;63-740;235;155;154;95;59
7;301202;301200;63-740;616;394;390;315;75
8;301202;301200;63-740;312;189;187;115;72
9;301202;301200;63-740;295;179;177;124;53
10;301202;301200;63-740;341;209;203;143;60
1;301203;301200;63-720;1297;887;872;434;438
2;301203;301200;63-720;1884;1284;1267;553;714
3;301203;301200;63-720;832;539;535;209;326
4;301203;301200;63-720;1072;733;726;575;151
5;301203;301200;63-720;1451;924;917;675;242
6;301203;301200;63-720;905;573;569;424;145
7;301203;301200;63-720;695;459;456;338;118
8;301203;301200;63-720;797;463;457;323;134
9;301203;301200;63-720;778;534;530;223;307
10;301203;301200;63-720;42;34;31;18;13
1;301204;301200;63-700;1720;1276;1264;604;660
2;301204;301200;63-700;1605;1130;1118;550;568
3;301204;301200;63-700;1163;792;788;365;423
4;301204;301200;63-700;1059;752;741;315;426
5;301204;301200;63-700;1119;774;771;314;457
6;301204;301200;63-700;993;745;737;317;420
7;301204;301200;63-700;1050;716;713;339;374
8;301204;301200;63-700;889;584;575;264;311
9;301204;301200;63-700;1312;809;798;372;426
10;301204;301200;63-700;921;669;666;312;354
11;301204;301200;63-700;1618;1010;1000;472;528
12;301204;301200;63-700;1576;1096;1081;525;556
13;301204;301200;63-700;1643;1185;1176;516;660
14;301204;301200;63-700;2030;1448;1435;591;844
15;301204;301200;63-700;1906;1365;1354;654;700
16;301204;301200;63-700;513;310;309;242;67
17;301204;301200;63-700;959;670;663;438;225
18;301204;301200;63-714;886;599;594;365;229
19;301204;301200;63-714;685;452;446;353;93
20;301204;301200;63-714;1081;715;704;425;279
21;301204;301200;63-750;732;439;437;287;150
22;301204;301200;63-700;140;88;87;66;21
23;301204;301200;63-700;359;218;217;165;52
24;301204;301200;63-700;327;236;234;155;79
25;301204;301200;63-700;311;200;199;105;94
26;301204;301200;63-700;209;151;150;112;38
27;301204;301200;63-714;576;407;406;303;103
28;301204;301200;63-714;223;141;141;97;44
29;301204;301200;63-714;285;197;195;139;56
30;301204;301200;63-714;213;130;125;69;56
31;301204;301200;63-714;409;269;267;205;62
32;301204;301200;63-714;374;261;260;163;97
33;301204;301200;63-714;387;255;255;186;69
34;301204;301200;63-700;29;7;7;4;3
35;301204;301200;63-700;29;17;17;9;8
1;301205;301200;63-708;1236;881;867;541;326
2;301205;301200;63-708;687;445;443;350;93
3;301205;301200;63-708;656;444;442;353;89
4;301205;301200;63-708;262;187;187;147;40
5;301205;301200;63-708;206;145;141;116;25
6;301205;301200;63-708;368;259;257;202;55
7;301205;301200;63-708;338;241;240;195;45
1;301206;301200;63-760;1570;1033;1023;526;497
2;301206;301200;63-760;1610;1059;1044;587;457
3;301206;301200;63-760;258;159;158;104;54
4;301206;301200;63-700;679;490;487;273;214
5;301206;301200;63-760;332;245;245;107;138
6;301206;301200;63-760;220;169;169;117;52
7;301206;301200;63-760;359;224;221;159;62
8;301206;301200;63-760;386;200;199;125;74
9;301206;301200;63-760;136;80;80;51;29
1;301301;301300;64-120;997;651;641;484;157
2;301301;301300;64-120;1367;879;872;488;384
3;301301;301300;64-122;1507;930;924;508;416
4;301301;301300;64-120;1083;713;709;451;258
5;301301;301300;64-120;764;508;505;316;189
6;301301;301300;64-120;233;168;166;118;48
7;301301;301300;64-120;204;136;136;95;41
8;301301;301300;64-120;115;80;80;40;40
1;301302;301300;64-111;1035;657;655;464;191
2;301302;301300;64-111;1351;1006;990;447;543
3;301302;301300;64-115;1531;1147;1139;439;700
4;301302;301300;64-111;339;224;223;146;77
5;301302;301300;64-111;670;484;477;207;270
6;301302;301300;64-111;438;330;326;140;186
7;301302;301300;64-111;439;274;270;133;137
8;301302;301300;64-115;1354;1013;1000;442;558
1;301303;301300;64-113;1849;1322;1303;524;779
2;301303;301300;64-113;2166;1486;1466;756;710
3;301303;301300;64-113;502;339;335;213;122
4;301303;301300;64-113;226;152;147;102;45
5;301303;301300;64-113;716;458;451;297;154
6;301303;301300;64-113;402;297;296;172;124
7;301303;301300;64-113;341;221;215;107;108
8;301303;301300;64-113;304;211;208;156;52
9;301303;301300;64-113;234;150;146;98;48
10;301303;301300;64-113;384;255;251;176;75
11;301303;301300;64-113;99;86;83;44;39
1;301304;301300;64-130;1349;1060;1052;400;652
2;301304;301300;64-130;1126;820;806;367;439
3;301304;301300;64-130;1473;1117;1104;400;704
4;301304;301300;64-130;517;382;377;215;162
5;301304;301300;64-130;347;233;230;138;92
6;301304;301300;64-130;283;154;154;107;47
7;301304;301300;64-130;277;156;154;95;59
8;301304;301300;64-130;506;374;371;196;175
9;301304;301300;64-130;1099;735;728;378;350
10;301304;301300;64-130;533;331;329;216;113
11;301304;301300;64-130;304;198;193;134;59
12;301304;301300;64-130;36;12;10;1;9
1;301305;301300;64-115;2441;1761;1748;872;876
2;301305;301300;64-115;1767;1149;1142;531;611
3;301305;301300;64-100;1169;819;817;408;409
4;301305;301300;64-100;968;626;620;345;275
1;301306;301300;64-150;1375;946;937;542;395
2;301306;301300;64-150;1553;1062;1048;626;422
1;301307;301300;64-140;1250;870;855;362;493
2;301307;301300;64-140;1467;998;987;556;431
3;301307;301300;64-117;734;458;452;304;148
4;301307;301300;64-140;1228;798;783;495;288
5;301307;301300;64-117;1189;732;728;420;308
6;301307;301300;64-140;1851;1332;1320;573;747
1;301401;301400;64-412;1358;876;867;412;455
2;301401;301400;64-412;1201;709;704;429;275
3;301401;301400;64-412;119;81;76;23;53
1;301402;301400;64-420;2030;1301;1280;564;716
2;301402;301400;64-420;1231;738;734;413;321
3;301402;301400;64-423;1580;942;930;540;390
1;301403;301400;64-400;1481;1026;1013;364;649
2;301403;301400;64-400;1532;1053;1046;370;676
3;301403;301400;64-400;1807;1209;1197;403;794
4;301403;301400;64-400;1444;915;896;301;595
5;301403;301400;64-400;691;482;480;172;308
6;301403;301400;64-400;959;673;666;266;400
7;301403;301400;64-400;1758;1152;1135;464;671
8;301403;301400;64-421;923;598;594;314;280
9;301403;301400;64-426;837;569;563;288;275
10;301403;301400;64-400;626;400;396;182;214
11;301403;301400;64-426;306;189;189;115;74
12;301403;301400;64-400;207;132;131;58;73
13;301403;301400;64-400;234;186;182;69;113
14;301403;301400;64-400;247;157;155;63;92
15;301403;301400;64-400;500;349;344;146;198
16;301403;301400;64-400;47;33;32;10;22
17;301403;301400;64-400;23;19;19;7;12
1;301404;301400;64-410;1730;1083;1074;454;620
2;301404;301400;64-410;1870;1183;1172;445;727
3;301404;301400;64-410;2066;1295;1284;535;749
4;301404;301400;64-410;875;546;544;320;224
1;301501;301500;64-316;1602;1092;1082;559;523
2;301501;301500;64-316;1483;939;925;589;336
3;301501;301500;64-316;962;661;651;364;287
1;301502;301500;64-310;965;724;714;311;403
2;301502;301500;64-310;1167;805;798;320;478
3;301502;301500;64-310;494;323;320;183;137
4;301502;301500;64-310;763;424;422;230;192
5;301502;301500;64-310;818;506;496;290;206
6;301502;301500;64-310;1103;655;645;378;267
7;301502;301500;64-310;651;361;357;201;156
8;301502;301500;64-310;646;415;412;267;145
1;301503;301500;64-305;1910;1300;1286;651;635
2;301503;301500;64-361;1130;746;739;315;424
1;301504;301500;64-300;1085;818;810;256;554
2;301504;301500;64-300;900;593;587;199;388
3;301504;301500;64-300;1604;1187;1182;368;814
4;301504;301500;64-300;1882;1368;1363;494;869
5;301504;301500;64-300;1176;865;857;281;576
6;301504;301500;64-300;651;505;501;119;382
7;301504;301500;64-300;1301;980;973;302;671
8;301504;301500;64-300;1456;1038;1032;373;659
9;301504;301500;64-300;2175;1400;1388;664;724
10;301504;301500;64-300;749;511;501;228;273
11;301504;301500;64-300;661;465;455;188;267
12;301504;301500;64-300;611;422;416;179;237
13;301504;301500;64-300;1330;949;940;391;549
14;301504;301500;64-300;543;378;375;168;207
15;301504;301500;64-300;677;444;438;231;207
16;301504;301500;64-300;624;385;383;181;202
17;301504;301500;64-300;2221;1714;1689;547;1142
18;301504;301500;64-300;480;350;346;140;206
19;301504;301500;64-300;108;39;39;9;30
1;301505;301500;64-330;1703;1264;1249;515;734
2;301505;301500;64-330;1442;1043;1030;416;614
3;301505;301500;64-330;751;560;557;207;350
4;301505;301500;64-330;1632;1240;1220;482;738
5;301505;301500;64-330;1469;1011;1004;412;592
6;301505;301500;64-330;797;542;538;274;264
7;301505;301500;64-330;929;629;624;390;234
8;301505;301500;64-330;836;562;559;257;302
9;301505;301500;64-330;843;533;525;333;192
10;301505;301500;64-330;940;621;615;385;230
11;301505;301500;64-330;741;504;501;280;221
1;301506;301500;64-360;1480;1117;1097;399;698
2;301506;301500;64-360;472;327;323;162;161
3;301506;301500;64-360;989;703;696;283;413
4;301506;301500;64-360;1590;1123;1108;360;748
5;301506;301500;64-360;1263;868;860;291;569
6;301506;301500;64-360;471;314;313;159;154
7;301506;301500;64-360;596;413;410;226;184
8;301506;301500;64-360;415;261;259;137;122
9;301506;301500;64-360;850;611;602;291;311
10;301506;301500;64-360;673;444;439;260;179
11;301506;301500;64-360;702;512;505;228;277
12;301506;301500;64-360;278;170;169;85;84
13;301506;301500;64-360;603;368;365;146;219
1;301601;301600;64-600;1321;1002;986;417;569
2;301601;301600;64-600;1013;676;670;266;404
3;301601;301600;64-600;793;482;477;197;280
4;301601;301600;64-600;1027;676;668;216;452
5;301601;301600;64-600;1037;728;725;246;479
6;301601;301600;64-600;1059;783;777;255;522
7;301601;301600;64-600;1435;1055;1045;391;654
8;301601;301600;64-600;720;526;519;178;341
9;301601;301600;64-600;938;708;704;242;462
10;301601;301600;64-600;767;570;566;203;363
11;301601;301600;64-600;1056;763;751;286;465
12;301601;301600;64-600;1031;750;735;235;500
13;301601;301600;64-600;819;630;623;277;346
14;301601;301600;64-607;634;420;416;205;211
15;301601;301600;64-606;812;515;511;269;242
16;301601;301600;64-600;1129;826;818;324;494
17;301601;301600;64-600;1363;973;964;416;548
18;301601;301600;64-600;892;554;549;273;276
19;301601;301600;64-600;590;470;464;190;274
20;301601;301600;64-605;466;281;275;144;131
21;301601;301600;64-600;577;358;352;177;175
22;301601;301600;64-600;1280;1011;998;338;660
23;301601;301600;64-607;418;291;286;129;157
24;301601;301600;64-606;360;238;236;115;121
25;301601;301600;64-606;273;166;165;89;76
26;301601;301600;64-606;284;185;185;98;87
27;301601;301600;64-606;252;174;173;89;84
28;301601;301600;64-600;210;154;154;51;103
29;301601;301600;64-600;386;276;274;114;160
30;301601;301600;64-600;309;220;219;65;154
31;301601;301600;64-605;165;99;99;48;51
32;301601;301600;64-606;189;107;105;72;33
33;301601;301600;64-600;135;87;84;33;51
34;301601;301600;64-605;376;273;267;123;144
35;301601;301600;64-600;405;299;297;132;165
36;301601;301600;64-600;286;221;219;84;135
37;301601;301600;64-600;53;16;16;9;7
38;301601;301600;64-600;84;84;84;36;48
1;301602;301600;64-610;851;616;614;241;373
2;301602;301600;64-610;818;513;509;202;307
3;301602;301600;64-610;1035;777;772;308;464
4;301602;301600;64-610;728;490;488;187;301
5;301602;301600;64-610;972;688;686;287;399
6;301602;301600;64-610;704;499;496;164;332
7;301602;301600;64-610;1032;746;738;259;479
8;301602;301600;64-610;875;534;528;237;291
9;301602;301600;64-610;850;509;503;211;292
10;301602;301600;64-610;574;356;353;186;167
11;301602;301600;64-610;790;492;488;236;252
12;301602;301600;64-608;896;578;573;310;263
13;301602;301600;64-610;314;220;219;120;99
14;301602;301600;64-610;221;143;143;65;78
15;301602;301600;64-611;779;470;462;223;239
16;301602;301600;64-610;503;317;316;117;199
17;301602;301600;64-612;323;223;223;128;95
18;301602;301600;64-610;178;112;111;75;36
19;301602;301600;64-610;292;208;207;91;116
20;301602;301600;64-610;239;184;184;91;93
21;301602;301600;64-611;236;125;124;58;66
1;301603;301600;64-630;1070;720;714;337;377
2;301603;301600;64-630;413;268;266;180;86
3;301603;301600;64-603;767;474;470;217;253
4;301603;301600;64-630;250;141;140;108;32
5;301603;301600;64-630;442;260;258;141;117
6;301603;301600;64-603;716;419;416;225;191
7;301603;301600;64-630;295;191;189;98;91
8;301603;301600;64-630;259;148;146;77;69
9;301603;301600;64-630;311;191;188;125;63
10;301603;301600;64-630;746;527;526;205;321
1;301701;301700;63-400;1125;697;692;276;416
2;301701;301700;63-400;890;509;503;224;279
3;301701;301700;63-400;993;703;695;270;425
4;301701;301700;63-400;833;504;501;203;298
5;301701;301700;63-400;1004;660;653;234;419
6;301701;301700;63-400;968;625;620;267;353
7;301701;301700;63-400;1223;903;894;316;578
8;301701;301700;63-400;826;536;529;204;325
9;301701;301700;63-400;784;589;584;190;394
10;301701;301700;63-400;1243;901;893;310;583
11;301701;301700;63-400;1286;959;949;345;604
12;301701;301700;63-400;1570;1226;1215;405;810
13;301701;301700;63-400;1685;1284;1271;463;808
14;301701;301700;63-400;1373;994;986;379;607
15;301701;301700;63-400;1659;1282;1269;430;839
16;301701;301700;63-400;1009;760;753;249;504
17;301701;301700;63-400;1248;905;900;337;563
18;301701;301700;63-400;1053;740;730;233;497
19;301701;301700;63-400;1223;876;869;329;540
20;301701;301700;63-400;1217;864;857;365;492
21;301701;301700;63-400;1554;1107;1099;420;679
22;301701;301700;63-400;854;607;607;266;341
23;301701;301700;63-400;1233;938;932;399;533
24;301701;301700;63-400;1452;1090;1081;476;605
25;301701;301700;63-400;1311;986;975;412;563
26;301701;301700;63-400;1816;1304;1288;585;703
27;301701;301700;63-400;2119;1653;1637;620;1017
28;301701;301700;63-400;2170;1646;1630;642;988
29;301701;301700;63-400;1366;988;977;405;572
30;301701;301700;63-400;889;674;660;249;411
31;301701;301700;63-400;1301;946;935;362;573
32;301701;301700;63-400;1112;839;830;316;514
33;301701;301700;63-400;1751;1252;1245;557;688
34;301701;301700;63-400;1366;985;975;339;636
35;301701;301700;63-400;1412;1041;1034;443;591
36;301701;301700;63-400;1340;937;933;362;571
37;301701;301700;63-400;1665;1189;1182;451;731
38;301701;301700;63-400;1666;1149;1130;446;684
39;301701;301700;63-400;1770;1196;1183;463;720
40;301701;301700;63-400;194;114;114;62;52
41;301701;301700;63-400;220;173;173;48;125
42;301701;301700;63-400;68;54;53;17;36
43;301701;301700;63-400;22;7;7;5;2
44;301701;301700;63-400;56;13;11;7;4
1;301702;301700;63-460;1799;1243;1228;581;647
2;301702;301700;63-460;1641;1081;1068;464;604
3;301702;301700;63-460;1677;1223;1215;622;593
4;301702;301700;63-460;918;629;623;272;351
5;301702;301700;63-460;917;584;581;447;134
6;301702;301700;63-460;1007;648;646;378;268
7;301702;301700;63-460;513;318;316;206;110
8;301702;301700;63-460;1063;746;738;514;224
9;301702;301700;63-460;640;440;439;322;117
10;301702;301700;63-460;442;306;302;130;172
11;301702;301700;63-460;263;185;184;144;40
12;301702;301700;63-460;322;234;234;184;50
13;301702;301700;63-460;726;507;502;265;237
1;301703;301700;63-430;844;567;562;345;217
2;301703;301700;63-430;462;330;328;183;145
3;301703;301700;63-430;528;384;379;248;131
4;301703;301700;63-430;818;590;583;319;264
5;301703;301700;63-430;710;521;517;302;215
6;301703;301700;63-430;428;281;278;134;144
7;301703;301700;63-430;497;347;347;267;80
8;301703;301700;63-430;720;490;485;375;110
9;301703;301700;63-430;577;353;351;273;78
10;301703;301700;63-430;1049;723;716;510;206
11;301703;301700;63-430;1000;689;685;513;172
12;301703;301700;63-430;829;520;517;369;148
13;301703;301700;63-430;437;306;304;227;77
14;301703;301700;63-430;491;294;294;250;44
15;301703;301700;63-430;457;330;328;215;113
16;301703;301700;63-430;589;399;397;274;123
17;301703;301700;63-430;158;99;99;74;25
18;301703;301700;63-430;467;305;303;232;71
1;301704;301700;63-410;694;455;449;332;117
2;301704;301700;63-400;767;587;584;340;244
3;301704;301700;63-410;2105;1471;1464;854;610
4;301704;301700;63-400;885;650;646;358;288
5;301704;301700;63-400;917;663;657;336;321
6;301704;301700;63-400;1154;820;816;446;370
7;301704;301700;63-400;561;377;373;220;153
8;301704;301700;63-410;962;649;647;328;319
9;301704;301700;63-450;547;361;357;225;132
10;301704;301700;63-450;732;461;458;275;183
11;301704;301700;63-450;607;378;368;232;136
12;301704;301700;63-410;733;546;541;296;245
13;301704;301700;63-410;605;422;418;251;167
14;301704;301700;63-410;154;113;112;87;25
15;301704;301700;63-410;200;130;126;104;22
16;301704;301700;63-400;231;166;162;113;49
17;301704;301700;63-400;588;461;459;179;280
18;301704;301700;63-400;179;136;136;84;52
19;301704;301700;63-400;313;221;220;163;57
20;301704;301700;63-410;189;133;131;85;46
21;301704;301700;63-450;298;219;216;144;72
22;301704;301700;63-450;272;161;160;102;58
23;301704;301700;63-450;253;142;140;101;39
24;301704;301700;63-410;416;309;305;140;165
25;301704;301700;63-410;493;397;396;201;195
1;301705;301700;63-421;804;562;562;461;101
2;301705;301700;63-421;809;497;494;271;223
3;301705;301700;63-421;1022;628;625;377;248
4;301705;301700;63-421;1607;1183;1167;609;558
5;301705;301700;63-421;1775;1265;1243;613;630
6;301705;301700;63-421;1250;919;913;491;422
7;301705;301700;63-421;303;224;221;89;132
8;301705;301700;63-421;746;588;583;316;267
9;301705;301700;63-421;219;126;125;95;30
10;301705;301700;63-421;378;233;232;181;51
11;301705;301700;63-421;387;318;318;203;115
12;301705;301700;63-421;205;156;152;91;61
1;301706;301700;63-440;578;363;361;231;130
2;301706;301700;63-440;529;364;362;291;71
3;301706;301700;63-440;655;413;411;348;63
4;301706;301700;63-440;1716;1241;1230;708;522
5;301706;301700;63-440;632;432;420;246;174
6;301706;301700;63-440;942;670;663;425;238
7;301706;301700;63-440;1247;938;931;510;421
8;301706;301700;63-440;345;210;208;158;50
9;301706;301700;63-440;446;305;302;228;74
10;301706;301700;63-440;266;186;183;123;60
11;301706;301700;63-440;288;190;188;155;33
12;301706;301700;63-440;274;205;202;124;78
13;301706;301700;63-440;159;109;109;81;28
14;301706;301700;63-440;409;304;298;190;108
15;301706;301700;63-440;323;251;248;148;100
1;301707;301700;63-520;415;256;254;211;43
2;301707;301700;63-405;493;324;322;248;74
3;301707;301700;63-405;266;165;165;127;38
4;301707;301700;63-405;999;699;694;376;318
5;301707;301700;63-405;799;523;523;396;127
6;301707;301700;63-405;895;638;635;479;156
7;301707;301700;63-405;759;468;466;324;142
8;301707;301700;63-405;215;155;155;122;33
9;301707;301700;63-405;578;397;392;222;170
10;301707;301700;63-405;570;409;406;262;144
11;301707;301700;63-405;654;459;458;365;93
12;301707;301700;63-405;484;318;314;196;118
13;301707;301700;63-405;68;32;32;20;12
1;301708;301700;63-435;1294;904;898;566;332
2;301708;301700;63-435;651;380;379;276;103
3;301708;301700;63-435;790;469;465;282;183
4;301708;301700;63-435;411;258;256;180;76
5;301708;301700;63-435;970;663;658;485;173
6;301708;301700;63-435;364;212;210;128;82
7;301708;301700;63-435;239;171;171;130;41
8;301708;301700;63-435;195;121;121;88;33
1;301801;301800;63-524;1235;853;842;556;286
2;301801;301800;63-524;674;456;450;325;125
1;301802;301800;63-505;1536;1065;1055;567;488
2;301802;301800;63-505;418;273;268;178;90
3;301802;301800;63-505;500;359;358;292;66
4;301802;301800;63-505;295;181;179;130;49
5;301802;301800;63-505;484;301;300;246;54
6;301802;301800;63-505;278;188;186;126;60
7;301802;301800;63-505;260;175;175;119;56
8;301802;301800;63-505;220;133;133;97;36
1;301803;301800;63-520;1405;1033;1026;499;527
2;301803;301800;63-520;482;315;313;234;79
3;301803;301800;63-520;475;324;323;234;89
4;301803;301800;63-520;615;439;430;289;141
5;301803;301800;63-520;298;186;184;132;52
6;301803;301800;63-520;276;170;169;84;85
7;301803;301800;63-520;278;162;160;120;40
8;301803;301800;63-520;362;235;233;146;87
9;301803;301800;63-520;225;151;150;94;56
10;301803;301800;63-520;483;330;328;225;103
11;301803;301800;63-520;478;329;327;175;152
12;301803;301800;63-520;402;285;283;193;90
13;301803;301800;63-520;131;60;51;23;28
1;301804;301800;63-507;599;451;449;208;241
2;301804;301800;63-507;347;215;214;134;80
3;301804;301800;63-507;881;583;578;305;273
4;301804;301800;63-507;124;68;68;42;26
5;301804;301800;63-507;177;115;114;56;58
6;301804;301800;63-507;255;168;167;87;80
7;301804;301800;63-507;290;202;200;112;88
8;301804;301800;63-507;285;179;178;118;60
9;301804;301800;63-507;484;323;321;205;116
10;301804;301800;63-507;343;244;242;135;107
11;301804;301800;63-507;182;131;128;87;41
12;301804;301800;63-507;848;605;599;270;329
13;301804;301800;63-507;48;8;8;3;5
1;301805;301800;63-522;449;288;285;165;120
2;301805;301800;63-522;1127;747;741;417;324
3;301805;301800;63-522;699;461;458;322;136
4;301805;301800;63-522;188;142;140;99;41
5;301805;301800;63-522;230;159;156;104;52
1;301806;301800;63-510;1537;1107;1098;676;422
2;301806;301800;63-510;446;295;293;239;54
3;301806;301800;63-510;630;370;368;281;87
4;301806;301800;63-510;578;388;385;292;93
5;301806;301800;63-510;524;347;346;270;76
6;301806;301800;63-510;481;305;304;216;88
7;301806;301800;63-510;294;211;210;165;45
1;301807;301800;63-500;1106;811;804;378;426
2;301807;301800;63-500;1339;880;863;383;480
3;301807;301800;63-500;1880;1362;1357;590;767
4;301807;301800;63-500;1300;883;874;335;539
5;301807;301800;63-500;1676;1225;1212;446;766
6;301807;301800;63-500;871;657;652;254;398
7;301807;301800;63-500;567;425;422;199;223
8;301807;301800;63-500;621;413;410;202;208
9;301807;301800;63-500;984;692;681;313;368
10;301807;301800;63-500;293;178;178;86;92
11;301807;301800;63-500;1026;637;632;377;255
12;301807;301800;63-500;689;413;409;253;156
13;301807;301800;63-500;589;415;409;188;221
14;301807;301800;63-500;994;653;650;443;207
15;301807;301800;63-500;546;371;369;208;161
16;301807;301800;63-500;319;186;182;94;88
17;301807;301800;63-500;258;177;176;110;66
18;301807;301800;63-500;317;220;216;147;69
19;301807;301800;63-500;219;134;133;84;49
20;301807;301800;63-500;1149;831;821;326;495
21;301807;301800;63-500;1010;729;722;290;432
22;301807;301800;63-500;58;17;17;13;4
23;301807;301800;63-500;40;24;22;10;12
1;301901;301900;64-920;1271;936;929;334;595
2;301901;301900;64-920;1219;823;814;310;504
3;301901;301900;64-920;2249;1491;1482;616;866
4;301901;301900;64-920;2398;1482;1471;620;851
5;301901;301900;64-920;2335;1670;1655;632;1023
6;301901;301900;64-920;2053;1435;1426;519;907
7;301901;301900;64-920;1999;1436;1426;518;908
8;301901;301900;64-920;1420;1017;1011;407;604
9;301901;301900;64-920;1468;1114;1108;439;669
10;301901;301900;64-920;547;421;420;172;248
11;301901;301900;64-920;1605;1148;1140;402;738
12;301901;301900;64-920;1638;1275;1265;464;801
13;301901;301900;64-920;1066;750;746;299;447
14;301901;301900;64-920;725;582;576;180;396
15;301901;301900;64-920;565;434;430;142;288
16;301901;301900;64-920;945;767;761;183;578
17;301901;301900;64-920;1751;1284;1280;467;813
18;301901;301900;64-920;939;674;666;232;434
19;301901;301900;64-920;1152;933;925;249;676
20;301901;301900;64-920;2417;1942;1922;513;1409
21;301901;301900;64-920;1278;939;930;339;591
22;301901;301900;64-920;2026;1461;1442;549;893
23;301901;301900;64-920;1750;1074;1071;451;620
24;301901;301900;64-920;1099;743;738;242;496
25;301901;301900;64-920;867;579;572;210;362
26;301901;301900;64-920;1300;830;825;318;507
27;301901;301900;64-920;1428;974;964;323;641
28;301901;301900;64-920;1080;746;739;286;453
29;301901;301900;64-920;835;552;548;196;352
30;301901;301900;64-920;1513;1064;1059;385;674
31;301901;301900;64-920;1206;956;949;257;692
32;301901;301900;64-920;1112;693;689;265;424
33;301901;301900;64-920;1264;848;844;296;548
34;301901;301900;64-920;1205;919;912;369;543
35;301901;301900;64-920;1082;790;785;249;536
36;301901;301900;64-920;1435;1001;993;382;611
37;301901;301900;64-920;50;29;24;13;11
38;301901;301900;64-920;199;107;104;42;62
39;301901;301900;64-920;98;53;53;20;33
1;301902;301900;89-340;1089;758;754;429;325
2;301902;301900;89-340;961;646;641;337;304
3;301902;301900;89-334;387;268;266;152;114
4;301902;301900;89-340;503;310;308;211;97
5;301902;301900;89-340;328;245;242;152;90
6;301902;301900;89-340;182;127;127;82;45
1;301903;301900;64-810;692;491;487;256;231
2;301903;301900;64-810;2141;1600;1580;702;878
3;301903;301900;64-810;516;376;371;221;150
4;301903;301900;64-810;430;315;309;174;135
5;301903;301900;64-810;455;332;327;216;111
6;301903;301900;64-810;437;267;260;116;144
7;301903;301900;64-810;214;155;153;54;99
8;301903;301900;64-810;164;120;120;69;51
9;301903;301900;64-810;242;172;171;105;66
10;301903;301900;64-810;423;279;279;171;108
1;301904;301900;89-310;892;565;559;335;224
2;301904;301900;89-310;1216;825;813;455;358
3;301904;301900;89-310;324;223;220;183;37
4;301904;301900;89-310;962;537;528;365;163
5;301904;301900;89-310;830;514;509;373;136
6;301904;301900;89-310;500;332;330;218;112
7;301904;301900;89-310;149;72;71;38;33
8;301904;301900;89-310;221;139;138;117;21
9;301904;301900;89-310;207;114;113;95;18
10;301904;301900;89-310;143;95;94;88;6
11;301904;301900;89-310;283;198;196;141;55
12;301904;301900;89-310;181;106;104;91;13
13;301904;301900;89-310;160;102;99;75;24
14;301904;301900;89-310;285;203;201;158;43
15;301904;301900;89-310;431;222;221;158;63
1;301905;301900;89-350;858;586;580;238;342
2;301905;301900;89-350;593;349;347;193;154
3;301905;301900;89-350;352;217;216;135;81
4;301905;301900;89-350;307;192;189;105;84
5;301905;301900;89-350;186;110;110;61;49
1;301906;301900;64-930;1114;812;806;284;522
2;301906;301900;64-930;130;98;98;51;47
3;301906;301900;64-932;1054;652;645;337;308
4;301906;301900;64-930;367;213;212;127;85
5;301906;301900;64-930;591;381;380;187;193
6;301906;301900;64-930;510;369;366;90;276
7;301906;301900;64-930;623;418;415;183;232
8;301906;301900;64-930;370;232;232;98;134
9;301906;301900;64-930;561;418;412;153;259
10;301906;301900;64-930;183;119;118;66;52
11;301906;301900;64-930;408;265;260;125;135
12;301906;301900;64-930;475;307;301;161;140
13;301906;301900;64-930;915;767;765;200;565
1;301907;301900;64-850;1136;762;753;321;432
2;301907;301900;64-850;1425;939;934;402;532
3;301907;301900;64-850;421;272;269;151;118
4;301907;301900;64-850;369;237;237;118;119
5;301907;301900;64-850;759;534;522;302;220
6;301907;301900;64-850;723;476;473;223;250
7;301907;301900;64-850;211;153;152;74;78
8;301907;301900;64-850;495;324;323;161;162
9;301907;301900;64-850;185;124;124;65;59
1;301908;301900;89-300;1079;685;680;324;356
2;301908;301900;89-300;1127;680;676;319;357
3;301908;301900;89-300;1475;944;940;452;488
4;301908;301900;89-333;1449;861;852;477;375
5;301908;301900;89-333;1239;790;780;449;331
6;301908;301900;89-311;316;185;184;135;49
7;301908;301900;89-311;279;181;180;141;39
8;301908;301900;89-300;769;422;418;266;152
9;301908;301900;89-300;506;337;337;219;118
10;301908;301900;89-333;746;379;376;274;102
11;301908;301900;89-300;166;106;105;68;37
12;301908;301900;89-311;239;142;141;80;61
13;301908;301900;89-311;257;177;177;126;51
14;301908;301900;89-300;200;128;126;86;40
15;301908;301900;89-300;69;26;26;15;11
1;301909;301900;89-320;1880;1216;1201;607;594
2;301909;301900;89-320;414;222;221;170;51
3;301909;301900;89-320;174;87;87;56;31
4;301909;301900;89-320;277;155;153;111;42
5;301909;301900;89-320;478;273;272;177;95
6;301909;301900;89-320;271;156;156;95;61
7;301909;301900;89-321;162;108;107;79;28
8;301909;301900;89-320;192;127;125;78;47
9;301909;301900;89-320;250;134;134;90;44
10;301909;301900;89-320;272;150;149;97;52
11;301909;301900;89-321;171;123;123;89;34
12;301909;301900;89-320;141;97;96;43;53
1;302001;302000;63-313;1036;660;650;388;262
2;302001;302000;63-313;555;335;331;230;101
3;302001;302000;63-313;519;373;368;243;125
4;302001;302000;63-313;685;426;422;282;140
5;302001;302000;63-313;241;172;171;129;42
6;302001;302000;63-313;348;220;220;138;82
7;302001;302000;63-313;235;160;159;127;32
1;302002;302000;63-304;866;591;587;396;191
2;302002;302000;63-304;1211;834;825;552;273
3;302002;302000;63-304;545;362;358;276;82
4;302002;302000;63-304;188;133;131;92;39
5;302002;302000;63-304;328;191;189;116;73
6;302002;302000;63-304;292;208;206;132;74
7;302002;302000;63-304;228;173;169;139;30
1;302003;302000;63-330;893;597;590;318;272
2;302003;302000;63-330;446;300;293;227;66
3;302003;302000;63-330;610;363;361;258;103
4;302003;302000;63-330;554;342;335;204;131
5;302003;302000;63-330;398;262;260;143;117
6;302003;302000;63-330;1144;735;727;355;372
7;302003;302000;63-330;890;558;556;414;142
8;302003;302000;63-330;493;343;342;215;127
9;302003;302000;63-330;284;196;194;123;71
10;302003;302000;63-330;255;185;183;130;53
11;302003;302000;63-330;44;12;12;4;8
1;302004;302000;63-308;1161;738;731;479;252
2;302004;302000;63-308;672;464;460;328;132
3;302004;302000;63-308;540;353;350;289;61
4;302004;302000;63-308;556;329;327;235;92
5;302004;302000;63-308;275;201;199;144;55
6;302004;302000;63-308;262;189;189;163;26
1;302005;302000;63-322;1798;1336;1316;642;674
2;302005;302000;63-322;886;574;570;385;185
3;302005;302000;63-322;568;402;400;273;127
4;302005;302000;63-322;603;444;437;342;95
5;302005;302000;62-811;2217;1612;1596;839;757
6;302005;302000;63-322;795;519;512;369;143
7;302005;302000;63-322;423;254;251;157;94
8;302005;302000;63-322;324;226;225;127;98
9;302005;302000;63-322;143;91;90;58;32
10;302005;302000;63-322;511;339;336;265;71
11;302005;302000;63-322;179;163;160;106;54
1;302006;302000;63-300;1226;913;901;445;456
2;302006;302000;63-300;405;270;269;150;119
3;302006;302000;63-300;666;438;433;236;197
4;302006;302000;63-300;972;629;626;335;291
5;302006;302000;63-300;467;298;296;200;96
6;302006;302000;63-300;603;367;365;253;112
7;302006;302000;63-300;463;286;281;140;141
8;302006;302000;63-300;520;330;327;179;148
9;302006;302000;63-300;834;532;526;281;245
10;302006;302000;63-300;577;396;393;189;204
11;302006;302000;63-300;505;334;331;208;123
12;302006;302000;63-300;348;249;249;174;75
13;302006;302000;63-300;418;268;267;177;90
14;302006;302000;63-300;1331;913;907;396;511
15;302006;302000;63-300;1353;951;945;394;551
16;302006;302000;63-300;534;356;356;147;209
17;302006;302000;63-300;902;616;603;247;356
18;302006;302000;63-300;814;557;549;264;285
19;302006;302000;63-300;1247;873;864;358;506
20;302006;302000;63-300;1240;884;874;368;506
21;302006;302000;63-300;1415;998;991;422;569
22;302006;302000;63-300;1268;867;858;400;458
23;302006;302000;63-300;1081;785;780;339;441
24;302006;302000;63-300;1212;846;843;337;506
25;302006;302000;63-300;169;113;112;67;45
26;302006;302000;63-300;245;147;146;79;67
27;302006;302000;63-300;265;190;185;136;49
28;302006;302000;63-300;477;307;304;199;105
29;302006;302000;63-300;184;120;117;60;57
30;302006;302000;63-300;189;78;73;34;39
1;302101;302100;62-030;1726;1413;1403;419;984
2;302101;302100;62-030;1812;1485;1474;401;1073
3;302101;302100;62-030;2095;1700;1678;545;1133
4;302101;302100;62-030;1503;1155;1133;341;792
5;302101;302100;62-030;1875;1453;1437;399;1038
6;302101;302100;62-030;1948;1464;1451;466;985
7;302101;302100;62-030;1496;1129;1120;445;675
8;302101;302100;62-030;1878;1513;1501;469;1032
9;302101;302100;62-030;1779;1454;1440;329;1111
10;302101;302100;62-030;1735;1339;1328;436;892
11;302101;302100;62-030;821;563;561;204;357
12;302101;302100;62-030;1924;1505;1491;503;988
13;302101;302100;62-030;1755;1353;1336;457;879
14;302101;302100;62-030;1378;1138;1126;297;829
1;302102;302100;62-040;1694;1350;1337;378;959
2;302102;302100;62-040;964;792;786;254;532
3;302102;302100;62-040;956;760;751;258;493
4;302102;302100;62-040;1386;1155;1144;299;845
5;302102;302100;62-040;1010;812;806;207;599
6;302102;302100;62-040;1526;1224;1212;403;809
7;302102;302100;62-040;189;116;115;43;72
1;302103;302100;64-320;1849;1371;1354;577;777
2;302103;302100;64-320;2471;1841;1819;734;1085
3;302103;302100;64-320;1886;1372;1354;596;758
4;302103;302100;64-320;1486;1145;1136;448;688
5;302103;302100;64-320;1080;728;721;443;278
6;302103;302100;64-320;1048;754;748;436;312
1;302104;302100;62-005;1308;937;928;338;590
2;302104;302100;62-005;780;656;653;177;476
3;302104;302100;62-005;1565;1077;1065;372;693
4;302104;302100;62-004;1642;1239;1225;437;788
5;302104;302100;62-004;1048;854;845;243;602
6;302104;302100;62-004;1808;1476;1462;438;1024
7;302104;302100;62-004;2244;1845;1820;563;1257
8;302104;302100;62-028;972;764;760;261;499
9;302104;302100;62-028;1183;919;906;294;612
10;302104;302100;62-028;2073;1669;1655;475;1180
11;302104;302100;62-028;2034;1539;1522;544;978
12;302104;302100;62-028;2168;1739;1720;491;1229
13;302104;302100;62-005;1407;1173;1161;336;825
14;302104;302100;62-005;834;689;685;230;455
15;302104;302100;62-028;520;382;380;48;332
1;302105;302100;62-070;2067;1753;1732;452;1280
2;302105;302100;62-070;1431;1248;1238;196;1042
3;302105;302100;62-070;1752;1564;1544;312;1232
4;302105;302100;62-070;2432;2020;1998;540;1458
5;302105;302100;62-070;1620;1275;1264;454;810
6;302105;302100;62-070;1296;963;955;421;534
7;302105;302100;62-070;1576;1360;1346;390;956
8;302105;302100;62-070;1744;1329;1314;563;751
9;302105;302100;60-185;2483;2135;2120;533;1587
10;302105;302100;60-185;2208;1890;1868;460;1408
11;302105;302100;60-185;2175;1947;1920;380;1540
12;302105;302100;62-070;1132;841;834;246;588
13;302105;302100;62-070;1480;1251;1238;349;889
14;302105;302100;62-070;647;563;561;173;388
15;302105;302100;62-070;525;384;383;157;226
16;302105;302100;62-070;92;44;44;20;24
1;302106;302100;63-005;1560;1258;1243;595;648
2;302106;302100;63-004;2821;2337;2317;697;1620
3;302106;302100;63-004;2771;2390;2362;650;1712
4;302106;302100;63-006;921;693;687;372;315
1;302107;302100;62-052;2641;2170;2155;535;1620
2;302107;302100;62-052;2631;2243;2222;461;1761
3;302107;302100;62-052;2106;1739;1726;477;1249
4;302107;302100;62-064;1908;1617;1602;395;1207
5;302107;302100;62-064;2296;1907;1889;479;1410
6;302107;302100;62-064;2491;2057;2040;488;1552
7;302107;302100;62-064;2205;1845;1827;453;1374
8;302107;302100;62-052;1063;877;870;326;544
9;302107;302100;62-052;568;426;422;148;274
10;302107;302100;62-051;708;549;544;191;353
11;302107;302100;62-052;1252;998;987;258;729
12;302107;302100;62-052;878;707;698;208;490
13;302107;302100;62-051;1754;1406;1392;420;972
14;302107;302100;62-051;1436;1187;1174;346;828
1;302108;302100;62-025;1098;804;798;330;468
2;302108;302100;62-025;781;505;498;262;236
3;302108;302100;62-025;742;510;503;278;225
4;302108;302100;62-025;733;455;451;238;213
5;302108;302100;62-025;2059;1416;1405;720;685
6;302108;302100;62-025;2408;1935;1909;697;1212
7;302108;302100;62-025;1974;1507;1484;611;873
8;302108;302100;62-025;1304;1005;993;410;583
9;302108;302100;62-025;1365;932;916;429;487
10;302108;302100;62-025;1822;1295;1274;530;744
11;302108;302100;62-025;1026;738;730;298;432
1;302109;302100;62-035;717;577;574;227;347
2;302109;302100;62-035;1543;1234;1223;428;795
3;302109;302100;62-035;1367;1014;1002;403;599
4;302109;302100;62-035;1177;879;873;404;469
5;302109;302100;62-035;754;602;595;283;312
6;302109;302100;62-035;599;489;486;219;267
7;302109;302100;62-023;1437;1258;1243;300;943
8;302109;302100;62-035;435;287;283;147;136
9;302109;302100;62-035;593;415;405;189;216
10;302109;302100;62-023;1717;1402;1386;453;933
11;302109;302100;62-023;454;327;322;108;214
12;302109;302100;62-023;1272;1123;1112;218;894
13;302109;302100;62-023;1158;1000;996;226;770
14;302109;302100;62-023;2450;2107;2083;548;1535
15;302109;302100;62-023;1557;1337;1323;320;1003
16;302109;302100;62-035;1124;899;882;293;589
17;302109;302100;62-035;306;234;232;127;105
18;302109;302100;62-035;809;636;625;262;363
19;302109;302100;62-035;257;217;210;90;120
20;302109;302100;62-023;1766;1421;1406;435;971
21;302109;302100;62-035;421;331;330;131;199
22;302109;302100;62-035;404;251;248;116;132
23;302109;302100;62-035;174;126;125;56;69
24;302109;302100;62-035;225;170;167;55;112
25;302109;302100;62-023;170;99;97;62;35
26;302109;302100;62-035;723;620;613;166;447
27;302109;302100;62-035;1075;889;878;316;562
28;302109;302100;62-023;1266;1107;1093;246;847
1;302110;302100;61-160;2677;2144;2122;660;1462
2;302110;302100;61-160;359;218;218;121;97
3;302110;302100;61-160;1671;1360;1342;524;818
4;302110;302100;62-022;1418;1018;1009;440;569
5;302110;302100;62-022;543;384;380;167;213
6;302110;302100;62-022;234;183;181;104;77
7;302110;302100;62-053;655;469;462;218;244
8;302110;302100;62-053;1488;1062;1052;477;575
9;302110;302100;62-050;896;675;666;233;433
10;302110;302100;62-050;917;657;653;248;405
11;302110;302100;62-050;1169;882;873;298;575
12;302110;302100;62-050;1390;1072;1054;419;635
13;302110;302100;62-050;1708;1363;1352;395;957
14;302110;302100;62-050;835;640;637;231;406
15;302110;302100;62-050;1730;1244;1234;431;803
16;302110;302100;62-050;872;635;627;263;364
17;302110;302100;62-050;1360;1080;1069;317;752
18;302110;302100;62-050;994;769;762;266;496
19;302110;302100;62-050;865;668;663;250;413
20;302110;302100;62-050;935;764;752;207;545
21;302110;302100;62-050;443;319;315;156;159
22;302110;302100;62-053;321;234;232;98;134
23;302110;302100;62-050;632;454;449;202;247
24;302110;302100;62-022;475;383;381;112;269
25;302110;302100;62-022;359;303;298;134;164
26;302110;302100;61-160;669;518;512;180;332
27;302110;302100;62-050;236;166;166;86;80
28;302110;302100;62-050;84;61;60;28;32
1;302111;302100;62-095;644;478;472;168;304
2;302111;302100;62-095;480;313;310;147;163
3;302111;302100;62-095;698;499;494;180;314
4;302111;302100;62-095;592;474;472;161;311
5;302111;302100;62-095;757;552;550;204;346
6;302111;302100;62-095;895;590;586;219;367
7;302111;302100;62-095;751;584;580;200;380
8;302111;302100;62-095;1683;1165;1158;387;771
9;302111;302100;62-095;2053;1596;1581;493;1088
10;302111;302100;62-095;725;582;576;206;370
11;302111;302100;62-095;1660;1202;1186;400;786
12;302111;302100;62-095;1791;1406;1388;461;927
13;302111;302100;62-095;296;182;181;96;85
1;302112;302100;62-010;1267;997;987;319;668
2;302112;302100;62-010;880;616;609;240;369
3;302112;302100;62-010;908;678;670;241;429
4;302112;302100;62-010;1929;1421;1408;561;847
5;302112;302100;62-010;2320;1838;1825;609;1216
6;302112;302100;62-010;1029;742;735;312;423
7;302112;302100;62-010;636;488;484;145;339
8;302112;302100;62-010;655;376;372;211;161
9;302112;302100;62-010;1375;1019;1014;391;623
10;302112;302100;62-007;1517;1258;1251;431;820
11;302112;302100;62-007;2222;1820;1805;628;1177
12;302112;302100;62-010;289;235;233;92;141
13;302112;302100;62-010;187;128;128;73;55
14;302112;302100;62-007;252;189;188;97;91
15;302112;302100;62-010;267;173;171;89;82
16;302112;302100;62-010;243;158;157;100;57
17;302112;302100;62-010;76;76;72;20;52
1;302113;302100;62-090;1168;971;960;278;682
2;302113;302100;62-090;1411;1223;1206;300;906
3;302113;302100;62-090;2932;2398;2376;695;1681
4;302113;302100;62-090;2726;2296;2281;530;1751
5;302113;302100;62-090;1106;875;870;283;587
6;302113;302100;62-090;681;485;482;204;278
7;302113;302100;62-090;1559;1263;1256;419;837
8;302113;302100;62-090;649;504;500;130;370
9;302113;302100;62-090;2099;1714;1700;468;1232
10;302113;302100;62-090;307;231;228;114;114
11;302113;302100;62-090;2124;1861;1850;463;1387
1;302114;302100;62-060;1508;1161;1154;429;725
2;302114;302100;62-060;1573;1189;1179;394;785
3;302114;302100;62-060;1359;1008;998;416;582
4;302114;302100;62-060;1655;1236;1218;512;706
5;302114;302100;62-060;1650;1086;1067;466;601
6;302114;302100;62-060;1026;656;653;360;293
7;302114;302100;62-060;1208;857;848;342;506
8;302114;302100;62-060;1949;1394;1383;619;764
1;302115;302100;62-003;2336;1931;1911;530;1381
2;302115;302100;62-001;1638;1297;1287;543;744
3;302115;302100;62-002;2222;1960;1942;474;1468
4;302115;302100;62-002;1710;1449;1436;304;1132
5;302115;302100;62-002;2019;1737;1717;418;1299
6;302115;302100;62-002;1619;1410;1398;259;1139
7;302115;302100;62-002;2158;1790;1770;473;1297
8;302115;302100;62-001;1008;835;832;315;517
1;302116;302100;62-020;1830;1407;1394;510;884
2;302116;302100;62-020;1599;1297;1282;352;930
3;302116;302100;62-020;1458;1165;1155;359;796
4;302116;302100;62-020;1279;1085;1071;291;780
5;302116;302100;62-020;1694;1171;1159;478;681
6;302116;302100;62-020;1721;1343;1327;420;907
7;302116;302100;62-020;1774;1309;1297;485;812
8;302116;302100;62-020;1748;1317;1303;480;823
9;302116;302100;62-020;1425;900;896;364;532
10;302116;302100;62-020;1094;806;804;282;522
11;302116;302100;62-020;1287;1016;1012;376;636
12;302116;302100;62-020;1320;1009;1003;350;653
13;302116;302100;62-020;1513;1172;1159;418;741
14;302116;302100;62-020;1329;1018;1004;327;677
15;302116;302100;62-020;1527;1206;1192;357;835
16;302116;302100;62-020;1397;1116;1105;376;729
17;302116;302100;62-020;1578;1358;1351;366;985
18;302116;302100;62-020;1522;1293;1281;388;893
19;302116;302100;62-006;786;466;459;223;236
20;302116;302100;62-021;1697;1348;1325;458;867
21;302116;302100;62-006;1359;1154;1140;250;890
22;302116;302100;62-006;1231;951;943;384;559
23;302116;302100;62-006;817;653;646;217;429
24;302116;302100;62-020;851;762;757;155;602
25;302116;302100;62-020;1800;1497;1480;382;1098
26;302116;302100;62-006;373;278;275;132;143
27;302116;302100;62-020;1383;1185;1170;334;836
28;302116;302100;62-006;438;292;286;138;148
29;302116;302100;62-006;1153;966;955;269;686
30;302116;302100;62-020;1132;1004;993;224;769
31;302116;302100;62-006;46;41;41;7;34
1;302117;302100;62-080;2184;1795;1773;585;1188
2;302117;302100;62-080;1787;1535;1528;387;1141
3;302117;302100;62-081;1898;1555;1539;419;1120
4;302117;302100;62-080;477;349;344;142;202
5;302117;302100;62-081;2310;1936;1914;463;1451
6;302117;302100;62-081;1507;1134;1121;369;752
7;302117;302100;62-080;1611;1261;1248;404;844
8;302117;302100;62-080;1486;1281;1269;303;966
9;302117;302100;62-081;1749;1387;1372;436;936
10;302117;302100;62-081;933;829;825;164;661
11;302117;302100;62-080;377;332;329;122;207
12;302117;302100;62-080;1396;1182;1173;279;894
13;302117;302100;62-080;1227;991;979;271;708
14;302117;302100;62-080;1340;1105;1097;265;832
15;302117;302100;62-080;553;448;443;171;272
16;302117;302100;62-080;576;484;477;136;341
17;302117;302100;62-080;185;139;137;54;83
18;302117;302100;62-080;371;293;288;94;194
19;302117;302100;62-080;336;254;250;89;161
20;302117;302100;62-081;653;551;546;159;387
21;302117;302100;62-080;1201;1059;1048;241;807
1;302201;302200;63-940;888;580;577;262;315
2;302201;302200;63-940;1203;785;780;346;434
3;302201;302200;63-940;1280;837;826;375;451
4;302201;302200;63-940;1145;674;664;378;286
5;302201;302200;63-940;858;493;487;301;186
6;302201;302200;63-940;615;329;326;218;108
7;302201;302200;63-940;174;100;99;60;39
8;302201;302200;63-940;49;28;27;14;13
1;302202;302200;63-930;1439;970;956;528;428
2;302202;302200;63-930;665;357;352;265;87
3;302202;302200;63-930;553;339;338;227;111
4;302202;302200;63-930;1001;660;655;430;225
5;302202;302200;63-930;491;303;297;211;86
6;302202;302200;63-930;345;225;223;164;59
7;302202;302200;63-930;302;194;193;160;33
8;302202;302200;63-930;242;151;150;97;53
9;302202;302200;63-930;214;144;144;134;10
1;302203;302200;63-910;1403;975;960;516;444
2;302203;302200;63-910;1015;695;685;363;322
3;302203;302200;63-910;1016;583;575;403;172
4;302203;302200;63-910;634;395;389;276;113
5;302203;302200;63-910;461;280;278;185;93
6;302203;302200;63-910;318;237;236;150;86
7;302203;302200;63-910;513;345;344;228;116
8;302203;302200;63-910;305;192;191;130;61
9;302203;302200;63-910;186;140;136;104;32
10;302203;302200;63-910;399;208;208;154;54
11;302203;302200;63-910;209;135;134;68;66
12;302203;302200;63-910;311;198;196;158;38
13;302203;302200;63-910;185;128;128;86;42
1;302204;302200;63-921;812;518;517;345;172
2;302204;302200;63-920;598;395;395;280;115
3;302204;302200;63-920;874;636;621;357;264
4;302204;302200;63-920;660;422;415;287;128
5;302204;302200;63-921;363;246;243;161;82
6;302204;302200;63-920;307;201;198;144;54
7;302204;302200;63-920;49;24;23;17;6
1;302205;302200;63-900;1303;826;817;423;394
2;302205;302200;63-900;996;705;699;327;372
3;302205;302200;63-900;834;570;563;229;334
4;302205;302200;63-900;1514;1057;1045;403;642
5;302205;302200;63-900;1286;845;835;355;480
6;302205;302200;63-900;815;569;564;222;342
7;302205;302200;63-900;1685;1172;1158;406;752
8;302205;302200;63-900;1004;685;679;271;408
9;302205;302200;63-900;1171;826;823;301;522
10;302205;302200;63-900;610;384;379;185;194
11;302205;302200;63-900;1266;803;797;345;452
12;302205;302200;63-900;1261;774;766;328;438
13;302205;302200;63-900;544;366;361;190;171
14;302205;302200;63-900;686;433;425;308;117
15;302205;302200;63-900;919;566;561;357;204
16;302205;302200;63-900;1207;815;810;404;406
17;302205;302200;63-900;1288;925;915;370;545
18;302205;302200;63-900;1175;842;832;298;534
19;302205;302200;63-900;176;124;124;45;79
20;302205;302200;63-900;462;287;285;173;112
21;302205;302200;63-900;169;90;88;66;22
22;302205;302200;63-900;169;124;122;108;14
23;302205;302200;63-900;624;414;410;227;183
24;302205;302200;63-900;296;182;179;118;61
25;302205;302200;63-900;712;415;413;181;232
26;302205;302200;63-900;116;34;33;12;21
27;302205;302200;63-900;405;353;347;44;303
28;302205;302200;63-900;283;230;228;29;199
1;302301;302300;62-400;1089;765;759;330;429
2;302301;302300;62-400;1090;707;697;349;348
3;302301;302300;62-400;2001;1421;1412;635;777
4;302301;302300;62-400;1521;1093;1085;473;612
5;302301;302300;62-400;1341;945;938;433;505
6;302301;302300;62-400;1364;1038;1024;451;573
7;302301;302300;62-400;1295;895;893;409;484
8;302301;302300;62-400;92;31;30;21;9
1;302302;302300;62-406;776;521;519;360;159
2;302302;302300;62-406;1443;1056;1046;663;383
3;302302;302300;62-404;1485;892;887;585;302
4;302302;302300;62-406;309;202;201;126;75
5;302302;302300;62-405;339;206;206;137;69
1;302303;302300;62-436;1075;701;696;379;317
2;302303;302300;62-436;232;142;141;97;44
3;302303;302300;62-436;252;160;157;121;36
4;302303;302300;62-436;472;290;287;188;99
5;302303;302300;62-436;432;265;264;183;81
6;302303;302300;62-436;187;119;118;76;42
7;302303;302300;62-436;171;127;125;71;54
8;302303;302300;62-436;16;12;11;5;6
1;302304;302300;62-402;1176;770;764;527;237
2;302304;302300;62-402;708;470;463;287;176
3;302304;302300;62-402;596;355;351;304;47
4;302304;302300;62-402;498;343;338;240;98
5;302304;302300;62-402;198;142;139;100;39
6;302304;302300;62-402;202;124;123;96;27
7;302304;302300;62-402;255;184;182;65;117
8;302304;302300;62-402;261;163;161;116;45
1;302305;302300;62-430;514;416;410;184;226
2;302305;302300;62-430;416;278;275;128;147
3;302305;302300;62-436;402;302;298;128;170
4;302305;302300;62-430;208;147;146;84;62
5;302305;302300;62-430;523;421;419;223;196
1;302306;302300;62-400;469;307;303;198;105
2;302306;302300;62-400;1052;713;705;469;236
3;302306;302300;62-400;1089;686;681;455;226
4;302306;302300;62-400;1332;834;832;609;223
5;302306;302300;62-400;1109;687;678;481;197
6;302306;302300;62-400;789;576;575;336;239
7;302306;302300;62-400;523;328;325;233;92
8;302306;302300;62-400;742;554;546;211;335
9;302306;302300;62-400;501;341;339;190;149
1;302307;302300;62-420;1399;986;978;525;453
2;302307;302300;62-420;1668;1158;1145;563;582
3;302307;302300;62-420;1039;770;759;375;384
4;302307;302300;62-420;453;312;311;212;99
5;302307;302300;62-420;288;190;188;137;51
6;302307;302300;62-420;974;656;653;461;192
7;302307;302300;62-420;255;140;139;84;55
8;302307;302300;62-420;300;208;205;148;57
9;302307;302300;62-420;361;263;257;201;56
10;302307;302300;62-420;573;380;378;207;171
11;302307;302300;62-420;226;119;119;86;33
12;302307;302300;62-420;39;24;22;10;12
1;302308;302300;62-410;1172;793;785;429;356
2;302308;302300;62-410;876;578;574;334;240
3;302308;302300;62-410;414;261;260;176;84
4;302308;302300;62-410;1461;886;880;627;253
5;302308;302300;62-410;1239;710;700;498;202
6;302308;302300;62-410;492;320;318;213;105
7;302308;302300;62-410;414;254;252;181;71
8;302308;302300;62-410;382;264;262;177;85
9;302308;302300;62-410;190;136;134;97;37
10;302308;302300;62-410;58;28;27;19;8
1;302401;302400;64-520;1806;1265;1250;589;661
1;302402;302400;64-550;1041;738;726;383;343
2;302402;302400;64-550;1594;1140;1133;588;545
3;302402;302400;64-541;1451;949;940;545;395
4;302402;302400;64-553;1301;944;940;476;464
5;302402;302400;64-552;892;579;577;311;266
6;302402;302400;64-533;904;675;671;321;350
1;302403;302400;64-530;1260;977;967;368;599
2;302403;302400;64-542;863;543;537;212;325
3;302403;302400;64-530;976;629;622;320;302
4;302403;302400;64-530;483;314;310;173;137
5;302403;302400;64-530;1097;808;797;274;523
6;302403;302400;64-530;1398;1069;1063;396;667
7;302403;302400;64-530;511;328;320;133;187
8;302403;302400;64-530;490;390;386;130;256
1;302404;302400;64-520;1596;987;979;477;502
2;302404;302400;64-520;1245;840;828;415;413
3;302404;302400;64-520;573;368;359;194;165
1;302405;302400;64-560;1587;1154;1142;528;614
2;302405;302400;64-560;2114;1376;1362;699;663
1;302406;302400;62-045;1829;1290;1274;600;674
2;302406;302400;62-045;1813;1294;1274;511;763
3;302406;302400;62-045;495;305;302;154;148
4;302406;302400;62-045;1150;693;689;381;308
5;302406;302400;62-045;517;287;286;144;142
6;302406;302400;62-045;2258;1589;1568;742;826
7;302406;302400;62-045;1156;716;707;432;275
1;302407;302400;64-500;1983;1372;1359;566;793
2;302407;302400;64-514;1152;861;856;358;498
3;302407;302400;64-551;1744;1196;1172;600;572
4;302407;302400;64-500;1071;738;733;367;366
5;302407;302400;64-500;1091;665;661;301;360
6;302407;302400;64-500;1806;1381;1373;496;877
7;302407;302400;64-500;1731;1289;1277;393;884
8;302407;302400;64-500;1574;1145;1135;397;738
9;302407;302400;64-500;1077;795;783;291;492
10;302407;302400;64-500;1203;878;872;328;544
11;302407;302400;64-500;1432;1044;1035;329;706
12;302407;302400;64-500;1086;682;680;269;411
13;302407;302400;64-500;1085;772;768;273;495
14;302407;302400;64-500;1332;1002;987;338;649
15;302407;302400;64-500;1397;1081;1066;304;762
16;302407;302400;64-500;587;372;368;205;163
17;302407;302400;64-514;1143;865;859;351;508
18;302407;302400;64-500;174;115;113;31;82
19;302407;302400;64-500;25;14;13;7;6
1;302408;302400;64-510;1488;1141;1129;339;790
2;302408;302400;64-510;846;558;556;189;367
3;302408;302400;64-510;784;536;532;200;332
4;302408;302400;64-510;974;650;647;163;484
5;302408;302400;64-510;855;618;615;205;410
6;302408;302400;64-510;1234;904;899;319;580
7;302408;302400;64-510;1675;1280;1271;427;844
8;302408;302400;64-510;705;494;487;209;278
9;302408;302400;64-510;1304;944;939;358;581
10;302408;302400;64-510;1071;694;686;236;450
11;302408;302400;64-510;1348;920;910;444;466
12;302408;302400;64-510;609;430;426;178;248
13;302408;302400;64-510;648;454;448;206;242
14;302408;302400;64-510;512;350;344;177;167
15;302408;302400;64-510;1311;897;887;62;825
1;302501;302500;63-012;1356;907;893;490;403
2;302501;302500;63-014;616;404;399;284;115
3;302501;302500;63-012;612;413;409;268;141
1;302502;302500;63-024;667;442;439;265;174
2;302502;302500;63-025;876;596;590;372;218
3;302502;302500;63-023;1512;1079;1061;536;525
4;302502;302500;63-023;803;507;502;283;219
5;302502;302500;63-023;333;214;213;113;100
6;302502;302500;63-023;582;436;435;243;192
7;302502;302500;63-023;361;243;243;140;103
8;302502;302500;63-025;400;277;273;213;60
1;302503;302500;63-041;931;615;611;354;257
2;302503;302500;63-040;1513;917;903;614;289
3;302503;302500;63-041;998;695;689;536;153
4;302503;302500;63-040;1376;975;966;457;509
5;302503;302500;63-041;1327;881;872;482;390
6;302503;302500;63-041;470;299;294;191;103
1;302504;302500;63-000;1083;775;762;297;465
2;302504;302500;63-000;784;581;574;226;348
3;302504;302500;63-000;1799;1398;1384;568;816
4;302504;302500;63-000;925;700;693;257;436
5;302504;302500;63-000;2066;1644;1615;555;1060
6;302504;302500;63-000;1078;654;652;299;353
7;302504;302500;63-000;1016;716;708;317;391
8;302504;302500;63-000;988;720;712;286;426
9;302504;302500;63-000;1016;712;706;298;408
10;302504;302500;63-000;1037;776;765;287;478
11;302504;302500;63-000;1371;1104;1087;355;732
12;302504;302500;63-000;1444;1029;1016;393;623
13;302504;302500;63-000;1010;710;703;287;416
14;302504;302500;63-000;964;732;728;302;426
15;302504;302500;63-000;1251;827;814;351;463
16;302504;302500;63-000;895;526;521;268;253
17;302504;302500;63-000;356;251;248;169;79
18;302504;302500;63-000;1039;708;701;305;396
19;302504;302500;63-000;806;560;552;296;256
20;302504;302500;63-000;468;279;276;159;117
21;302504;302500;63-000;733;509;504;263;241
22;302504;302500;63-000;397;273;272;166;106
23;302504;302500;63-000;352;210;210;110;100
24;302504;302500;63-000;332;228;227;120;107
25;302504;302500;63-000;596;454;445;225;220
26;302504;302500;63-000;228;152;151;109;42
27;302504;302500;63-000;266;186;181;80;101
28;302504;302500;63-000;272;185;181;114;67
29;302504;302500;63-000;343;189;188;117;71
30;302504;302500;63-000;56;27;27;9;18
31;302504;302500;63-000;76;61;60;20;40
32;302504;302500;63-000;54;24;24;4;20
1;302505;302500;63-020;1115;793;790;366;424
2;302505;302500;63-020;1984;1548;1530;582;948
3;302505;302500;63-020;551;372;366;193;173
4;302505;302500;63-021;896;572;565;286;279
5;302505;302500;63-020;470;338;335;146;189
6;302505;302500;63-021;288;202;199;111;88
1;302601;302600;63-112;950;611;603;311;292
2;302601;302600;63-112;424;260;260;144;116
3;302601;302600;63-112;1033;660;651;248;403
4;302601;302600;63-112;670;467;457;246;211
5;302601;302600;63-112;170;95;94;39;55
6;302601;302600;63-112;413;248;244;146;98
1;302602;302600;63-140;1235;811;797;390;407
2;302602;302600;63-140;383;232;230;126;104
3;302602;302600;63-140;390;231;231;154;77
4;302602;302600;63-140;438;286;283;176;107
5;302602;302600;63-140;601;383;379;242;137
6;302602;302600;63-140;485;289;286;217;69
7;302602;302600;63-140;558;363;362;248;114
8;302602;302600;63-140;375;220;218;149;69
1;302603;302600;63-130;2114;1394;1383;700;683
2;302603;302600;63-130;1429;855;843;569;274
3;302603;302600;63-130;795;508;502;320;182
4;302603;302600;63-130;1047;623;618;379;239
5;302603;302600;63-130;322;203;203;158;45
6;302603;302600;63-130;540;334;333;244;89
1;302604;302600;63-100;2350;1610;1602;642;960
2;302604;302600;63-100;1172;835;829;360;469
3;302604;302600;63-100;2327;1737;1721;680;1041
4;302604;302600;63-100;1306;942;933;373;560
5;302604;302600;63-100;2535;1897;1882;792;1090
6;302604;302600;63-100;1432;1038;1035;407;628
7;302604;302600;63-100;2076;1594;1582;583;999
8;302604;302600;63-100;690;527;522;186;336
9;302604;302600;63-100;2191;1548;1536;603;933
10;302604;302600;63-100;1355;970;965;476;489
11;302604;302600;63-100;1349;784;776;382;394
12;302604;302600;63-100;1595;1009;1001;455;546
13;302604;302600;63-100;1801;1428;1412;526;886
14;302604;302600;63-100;1630;1162;1152;600;552
15;302604;302600;63-100;1058;742;732;337;395
16;302604;302600;63-100;1431;986;974;560;414
17;302604;302600;63-100;1938;1400;1380;644;736
18;302604;302600;63-100;729;459;453;271;182
19;302604;302600;63-100;646;429;426;293;133
20;302604;302600;63-100;654;488;480;212;268
21;302604;302600;63-100;278;189;185;107;78
22;302604;302600;63-100;183;130;130;88;42
23;302604;302600;63-100;213;150;149;78;71
24;302604;302600;63-100;113;59;54;35;19
25;302604;302600;63-100;113;37;33;19;14
26;302604;302600;63-100;51;26;23;14;9
27;302604;302600;63-100;150;55;55;32;23
1;302701;302700;62-700;1024;745;736;371;365
2;302701;302700;62-700;1306;851;847;443;404
3;302701;302700;62-700;1173;736;728;387;341
4;302701;302700;62-700;941;648;639;339;300
5;302701;302700;62-700;1233;891;887;400;487
6;302701;302700;62-700;838;642;638;292;346
7;302701;302700;62-700;1209;863;856;454;402
8;302701;302700;62-700;1024;659;651;367;284
9;302701;302700;62-700;1282;856;854;374;480
10;302701;302700;62-700;903;625;620;275;345
11;302701;302700;62-700;1069;807;804;432;372
12;302701;302700;62-700;1174;886;881;444;437
13;302701;302700;62-700;999;736;731;386;345
14;302701;302700;62-700;1112;785;778;355;423
15;302701;302700;62-700;742;530;526;275;251
16;302701;302700;62-700;704;531;525;243;282
17;302701;302700;62-700;999;691;688;341;347
18;302701;302700;62-700;980;714;711;417;294
19;302701;302700;62-700;49;31;30;21;9
1;302702;302700;62-720;1103;742;737;469;268
2;302702;302700;62-720;776;551;547;428;119
3;302702;302700;62-720;192;136;135;98;37
4;302702;302700;62-720;548;364;359;297;62
5;302702;302700;62-720;389;268;267;228;39
6;302702;302700;62-720;852;627;621;501;120
7;302702;302700;62-720;233;149;149;105;44
8;302702;302700;62-720;253;159;157;116;41
9;302702;302700;62-720;234;168;168;140;28
1;302703;302700;62-730;1211;851;840;515;325
2;302703;302700;62-730;857;547;546;418;128
3;302703;302700;62-730;758;497;495;359;136
4;302703;302700;62-730;688;505;502;396;106
5;302703;302700;62-730;338;203;200;160;40
6;302703;302700;62-730;342;247;242;168;74
7;302703;302700;62-730;342;236;235;183;52
1;302704;302700;62-704;906;648;641;520;121
2;302704;302700;62-704;1173;742;737;557;180
3;302704;302700;62-704;491;322;321;281;40
4;302704;302700;62-704;1061;780;771;563;208
5;302704;302700;62-704;278;197;194;152;42
1;302705;302700;62-709;1455;878;868;643;225
2;302705;302700;62-709;1389;914;910;691;219
3;302705;302700;62-709;882;572;570;460;110
4;302705;302700;62-709;1357;940;932;578;354
1;302706;302700;62-731;776;534;529;362;167
2;302706;302700;62-731;614;432;432;341;91
3;302706;302700;62-731;365;230;229;171;58
4;302706;302700;62-731;795;545;539;370;169
5;302706;302700;62-731;617;445;445;340;105
6;302706;302700;62-731;398;281;278;201;77
1;302707;302700;62-740;1313;887;880;545;335
2;302707;302700;62-740;1023;712;706;442;264
3;302707;302700;62-740;2149;1454;1448;1078;370
4;302707;302700;62-740;858;612;606;488;118
5;302707;302700;62-740;1803;1151;1139;825;314
6;302707;302700;62-740;610;429;427;334;93
1;302708;302700;62-700;611;386;381;295;86
2;302708;302700;62-700;506;337;331;240;91
3;302708;302700;62-700;1752;1205;1190;738;452
4;302708;302700;62-700;693;505;500;243;257
5;302708;302700;62-700;519;347;343;218;125
6;302708;302700;62-700;832;560;556;362;194
7;302708;302700;62-700;952;680;677;436;241
8;302708;302700;62-700;324;229;226;169;57
9;302708;302700;62-700;415;296;294;235;59
10;302708;302700;62-700;664;492;491;267;224
11;302708;302700;62-700;667;514;508;306;202
1;302709;302700;62-710;531;360;356;241;115
2;302709;302700;62-710;1224;964;957;670;287
3;302709;302700;62-710;441;322;319;266;53
4;302709;302700;62-710;1270;928;917;751;166
5;302709;302700;62-710;738;549;546;456;90
6;302709;302700;62-710;744;536;531;417;114
7;302709;302700;62-710;1133;884;875;672;203
1;302801;302800;62-100;1238;964;957;312;645
2;302801;302800;62-100;1856;1260;1247;477;770
3;302801;302800;62-100;1624;1142;1131;439;692
4;302801;302800;62-100;1610;1112;1106;412;694
5;302801;302800;62-100;1296;765;760;335;425
6;302801;302800;62-100;1207;832;826;303;523
7;302801;302800;62-100;1469;1092;1085;428;657
8;302801;302800;62-100;1563;1127;1106;432;674
9;302801;302800;62-100;1775;1303;1289;473;816
10;302801;302800;62-100;1579;1029;1029;427;602
11;302801;302800;62-100;1878;1323;1313;513;800
12;302801;302800;62-100;1387;1039;1026;445;581
13;302801;302800;62-100;58;15;15;7;8
1;302802;302800;62-110;1466;980;972;519;453
2;302802;302800;62-110;228;156;154;127;27
3;302802;302800;62-110;1050;670;667;375;292
4;302802;302800;62-110;242;164;164;135;29
5;302802;302800;62-110;263;156;156;117;39
6;302802;302800;62-110;278;146;144;99;45
7;302802;302800;62-110;332;220;216;138;78
1;302803;302800;62-130;1057;683;676;333;343
2;302803;302800;62-130;1389;913;903;455;448
3;302803;302800;62-130;538;343;342;231;111
4;302803;302800;62-130;198;134;132;99;33
5;302803;302800;62-130;413;253;251;171;80
6;302803;302800;62-130;431;231;225;154;71
7;302803;302800;62-130;320;214;212;151;61
8;302803;302800;62-130;187;127;126;88;38
9;302803;302800;62-130;162;112;112;79;33
10;302803;302800;62-130;231;151;149;102;47
11;302803;302800;62-130;222;151;150;102;48
12;302803;302800;62-130;165;118;118;59;59
13;302803;302800;62-130;241;180;179;118;61
14;302803;302800;62-130;241;141;141;71;70
1;302804;302800;62-290;1262;845;841;413;428
2;302804;302800;62-290;303;200;198;144;54
3;302804;302800;62-285;587;418;409;205;204
4;302804;302800;62-290;369;198;197;137;60
5;302804;302800;62-290;330;181;181;113;68
6;302804;302800;62-290;390;210;208;125;83
7;302804;302800;62-290;329;226;223;159;64
8;302804;302800;62-290;293;185;183;90;93
9;302804;302800;62-290;577;417;413;217;196
1;302805;302800;62-085;872;626;619;228;391
2;302805;302800;62-085;1012;789;783;293;490
3;302805;302800;62-085;1616;1156;1145;437;708
4;302805;302800;62-285;190;100;100;64;36
5;302805;302800;62-085;409;223;222;135;87
6;302805;302800;62-093;563;399;397;165;232
7;302805;302800;62-085;913;640;632;274;358
8;302805;302800;62-085;378;255;252;98;154
9;302805;302800;62-285;301;184;182;124;58
10;302805;302800;62-085;533;279;278;147;131
11;302805;302800;62-085;250;190;190;59;131
12;302805;302800;62-093;289;179;178;90;88
13;302805;302800;62-093;408;268;268;85;183
14;302805;302800;62-285;24;12;11;9;2
1;302806;302800;62-120;1161;717;704;334;370
2;302806;302800;62-120;618;381;378;236;142
3;302806;302800;62-120;386;231;231;128;103
1;302807;302800;62-100;168;102;101;44;57
2;302807;302800;62-100;556;387;379;203;176
3;302807;302800;62-100;674;436;433;241;192
4;302807;302800;62-113;443;286;285;176;109
5;302807;302800;62-104;661;440;438;266;172
6;302807;302800;62-105;1250;842;837;472;365
7;302807;302800;62-106;576;337;329;172;157
8;302807;302800;62-104;562;337;333;203;130
9;302807;302800;62-100;919;657;655;273;382
10;302807;302800;62-100;394;272;270;130;140
11;302807;302800;62-100;346;253;250;136;114
12;302807;302800;62-100;185;122;122;71;51
13;302807;302800;62-100;323;245;245;105;140
14;302807;302800;62-112;573;284;281;163;118
15;302807;302800;62-100;295;190;188;102;86
16;302807;302800;62-113;315;222;220;120;100
17;302807;302800;62-105;241;167;163;90;73
18;302807;302800;62-105;226;138;136;87;49
19;302807;302800;62-100;529;332;330;140;190
1;302901;302900;64-234;1549;986;974;659;315
2;302901;302900;64-234;666;458;453;324;129
3;302901;302900;64-234;836;534;530;391;139
4;302901;302900;64-234;1229;814;800;455;345
5;302901;302900;64-234;1249;820;812;471;341
6;302901;302900;64-234;903;637;631;318;313
7;302901;302900;64-234;907;577;572;323;249
8;302901;302900;64-234;617;434;430;251;179
9;302901;302900;64-234;924;661;659;310;349
10;302901;302900;64-234;723;465;462;306;156
11;302901;302900;64-234;485;316;312;178;134
12;302901;302900;64-234;443;316;313;203;110
13;302901;302900;64-234;307;195;193;126;67
14;302901;302900;64-234;27;24;24;9;15
1;302902;302900;64-212;1403;1032;1017;474;543
2;302902;302900;64-225;775;517;508;381;127
3;302902;302900;64-212;739;494;485;268;217
4;302902;302900;64-225;1095;719;714;411;303
5;302902;302900;64-214;1591;1058;1048;565;483
6;302902;302900;64-232;1444;985;968;539;429
7;302902;302900;64-232;435;299;292;148;144
8;302902;302900;64-231;954;587;579;316;263
9;302902;302900;64-212;599;394;388;255;133
10;302902;302900;64-232;481;308;304;159;145
1;302903;302900;64-200;890;693;685;256;429
2;302903;302900;64-200;1029;706;703;272;431
3;302903;302900;64-200;1291;928;924;394;530
4;302903;302900;64-200;1284;947;927;377;550
5;302903;302900;64-200;1126;858;853;284;569
6;302903;302900;64-200;1117;795;792;295;497
7;302903;302900;64-200;972;723;719;247;472
8;302903;302900;64-200;1220;904;892;286;606
9;302903;302900;64-211;1651;1145;1131;632;499
10;302903;302900;64-224;907;619;616;319;297
11;302903;302900;64-223;1577;989;978;521;457
12;302903;302900;64-200;928;612;605;323;282
13;302903;302900;64-200;886;636;634;306;328
14;302903;302900;64-200;237;156;156;98;58
15;302903;302900;64-200;1415;1024;1020;379;641
16;302903;302900;64-200;308;221;219;85;134
17;302903;302900;64-200;719;494;491;201;290
18;302903;302900;64-200;601;443;438;172;266
19;302903;302900;64-200;372;259;257;87;170
20;302903;302900;64-200;623;491;489;211;278
21;302903;302900;64-200;658;434;431;245;186
22;302903;302900;64-200;687;419;416;234;182
23;302903;302900;64-200;335;244;239;170;69
24;302903;302900;64-200;1497;1135;1121;460;661
25;302903;302900;64-200;81;36;35;20;15
26;302903;302900;64-200;177;59;57;28;29
1;303001;303000;62-306;687;520;516;316;200
2;303001;303000;62-305;462;347;343;213;130
3;303001;303000;62-306;443;320;317;244;73
4;303001;303000;62-305;502;324;321;228;93
5;303001;303000;62-306;382;255;254;180;74
6;303001;303000;62-307;531;358;350;187;163
7;303001;303000;62-305;456;286;283;200;83
8;303001;303000;62-305;303;200;200;173;27
9;303001;303000;62-306;324;215;214;152;62
10;303001;303000;62-306;241;164;163;105;58
1;303002;303000;62-320;1661;1096;1078;602;476
2;303002;303000;62-320;659;414;405;232;173
3;303002;303000;62-320;487;358;357;236;121
4;303002;303000;62-322;1704;1156;1143;622;521
5;303002;303000;62-322;667;465;457;295;162
6;303002;303000;62-320;610;394;386;229;157
7;303002;303000;62-320;888;651;649;317;332
8;303002;303000;62-320;211;155;153;95;58
9;303002;303000;62-320;156;115;115;86;29
10;303002;303000;62-320;220;152;151;103;48
11;303002;303000;62-320;184;96;95;64;31
1;303003;303000;62-330;1795;1376;1364;525;839
2;303003;303000;62-330;2159;1520;1508;671;837
3;303003;303000;62-330;1122;784;775;405;370
4;303003;303000;62-330;1021;655;650;419;231
1;303004;303000;62-310;1380;900;893;516;377
2;303004;303000;62-310;436;318;313;188;125
3;303004;303000;62-310;352;206;204;148;56
4;303004;303000;62-310;682;411;406;310;96
5;303004;303000;62-310;610;341;337;255;82
6;303004;303000;62-310;339;231;228;192;36
7;303004;303000;62-310;453;283;282;150;132
8;303004;303000;62-310;274;177;176;135;41
9;303004;303000;62-310;672;489;487;269;218
1;303005;303000;62-300;2043;1412;1407;635;772
2;303005;303000;62-300;1128;779;774;330;444
3;303005;303000;62-300;1954;1488;1477;629;848
4;303005;303000;62-300;2141;1623;1599;612;987
5;303005;303000;62-300;1568;1195;1185;557;628
6;303005;303000;62-300;1356;1101;1092;418;674
7;303005;303000;62-300;1114;807;800;333;467
8;303005;303000;62-300;1269;925;914;349;565
9;303005;303000;62-300;2489;1850;1835;725;1110
10;303005;303000;62-300;1386;991;988;448;540
11;303005;303000;62-300;1291;964;955;381;574
12;303005;303000;62-300;1713;1223;1202;509;693
13;303005;303000;62-300;1424;1061;1050;438;612
14;303005;303000;62-300;1652;1233;1220;520;700
15;303005;303000;62-300;692;459;453;265;188
16;303005;303000;62-301;872;608;605;423;182
17;303005;303000;62-309;409;264;259;148;111
18;303005;303000;62-300;605;451;449;194;255
19;303005;303000;62-302;541;368;364;186;178
20;303005;303000;62-300;879;640;629;294;335
21;303005;303000;62-300;1176;882;875;417;458
22;303005;303000;62-300;462;298;296;164;132
23;303005;303000;62-323;533;372;368;188;180
24;303005;303000;62-323;650;440;437;316;121
25;303005;303000;62-303;949;662;655;326;329
26;303005;303000;62-303;1195;852;840;410;430
27;303005;303000;62-300;468;335;334;190;144
28;303005;303000;62-302;606;403;401;226;175
29;303005;303000;62-302;288;181;179;115;64
30;303005;303000;62-309;158;107;106;75;31
31;303005;303000;62-304;228;173;171;114;57
32;303005;303000;62-300;586;412;407;197;210
33;303005;303000;62-304;162;115;114;67;47
34;303005;303000;62-302;253;151;150;84;66
35;303005;303000;62-300;416;313;313;179;134
36;303005;303000;62-300;263;170;168;123;45
37;303005;303000;62-302;150;110;108;66;42
38;303005;303000;62-300;118;50;50;29;21
39;303005;303000;62-300;37;12;12;4;8
1;303101;303100;77-400;1714;1133;1128;394;734
2;303101;303100;77-400;1528;1035;1028;390;638
3;303101;303100;77-400;1756;1157;1149;435;714
4;303101;303100;77-400;1573;1055;1043;434;609
5;303101;303100;77-400;1607;931;923;382;541
6;303101;303100;77-400;1649;1085;1081;371;710
7;303101;303100;77-400;2246;1612;1597;532;1065
8;303101;303100;77-400;999;622;621;252;369
9;303101;303100;77-400;90;44;43;17;26
10;303101;303100;77-400;122;102;98;26;72
1;303102;303100;64-915;1538;979;971;451;520
2;303102;303100;64-915;1502;796;793;382;411
3;303102;303100;64-915;1925;1308;1300;508;792
4;303102;303100;64-915;1029;550;542;235;307
5;303102;303100;64-915;583;308;305;167;138
6;303102;303100;64-915;927;543;535;297;238
7;303102;303100;64-915;310;191;188;93;95
8;303102;303100;64-915;209;134;133;86;47
1;303103;303100;77-430;1136;715;706;324;382
2;303103;303100;77-430;557;375;371;183;188
3;303103;303100;77-430;1546;1002;996;532;464
4;303103;303100;77-430;512;327;324;154;170
5;303103;303100;77-430;343;193;193;127;66
6;303103;303100;77-430;344;233;232;140;92
7;303103;303100;77-430;422;231;230;121;109
8;303103;303100;64-917;629;482;478;147;331
1;303104;303100;77-420;490;315;314;177;137
2;303104;303100;77-420;1108;590;584;312;272
3;303104;303100;77-420;1221;789;785;331;454
4;303104;303100;77-420;321;207;206;113;93
5;303104;303100;77-420;304;171;169;85;84
6;303104;303100;77-420;292;169;167;114;53
7;303104;303100;77-420;232;118;116;65;51
1;303105;303100;64-965;795;494;489;220;269
2;303105;303100;64-965;836;501;495;236;259
3;303105;303100;64-965;505;297;297;171;126
4;303105;303100;64-918;946;559;552;315;237
5;303105;303100;64-965;454;220;220;132;88
6;303105;303100;64-965;236;151;151;74;77
7;303105;303100;64-965;366;220;219;136;83
8;303105;303100;64-965;328;205;202;90;112
9;303105;303100;64-965;326;161;160;53;107
10;303105;303100;64-965;294;169;167;103;64
11;303105;303100;64-965;240;161;160;114;46
12;303105;303100;64-965;728;426;423;202;221
1;303106;303100;77-416;1409;910;901;494;407
2;303106;303100;77-416;292;186;184;101;83
3;303106;303100;77-416;407;199;199;113;86
4;303106;303100;77-416;161;95;94;57;37
1;303107;303100;77-424;1035;708;702;389;313
2;303107;303100;77-411;624;375;371;218;153
3;303107;303100;77-424;198;113;111;50;61
4;303107;303100;77-424;761;485;481;305;176
5;303107;303100;77-424;249;135;135;75;60
6;303107;303100;77-424;301;185;182;107;75
7;303107;303100;77-424;258;165;165;64;101
8;303107;303100;77-424;163;109;108;59;49
1;303108;303100;77-400;453;303;298;147;151
2;303108;303100;77-400;459;288;284;111;173
3;303108;303100;77-400;1175;733;728;341;387
4;303108;303100;77-400;344;223;222;146;76
5;303108;303100;77-400;705;413;409;264;145
6;303108;303100;77-400;531;299;297;147;150
7;303108;303100;77-400;378;228;227;146;81
8;303108;303100;77-400;215;123;123;67;56
9;303108;303100;77-400;643;344;341;172;169
10;303108;303100;77-400;570;401;399;159;240
11;303108;303100;77-400;384;263;260;118;142
12;303108;303100;77-400;247;160;159;68;91
13;303108;303100;77-400;218;146;146;84;62
14;303108;303100;77-400;455;324;319;115;204
15;303108;303100;77-400;564;328;323;216;107
1;306101;306100;62-800;1457;945;940;413;527
2;306101;306100;62-800;930;616;613;292;321
3;306101;306100;62-800;952;593;587;227;360
4;306101;306100;62-800;1778;1200;1191;433;758
5;306101;306100;62-800;1086;663;658;308;350
6;306101;306100;62-800;1305;791;777;384;393
7;306101;306100;62-800;1683;1188;1180;480;700
8;306101;306100;62-800;931;642;637;292;345
9;306101;306100;62-800;2293;1772;1759;730;1029
10;306101;306100;62-800;935;654;648;264;384
11;306101;306100;62-800;503;326;318;144;174
12;306101;306100;62-800;1281;873;866;356;510
13;306101;306100;62-800;1589;1094;1087;417;670
14;306101;306100;62-800;560;428;422;166;256
15;306101;306100;62-800;2261;1659;1639;573;1066
16;306101;306100;62-800;1481;1108;1097;415;682
17;306101;306100;62-800;1163;733;726;297;429
18;306101;306100;62-800;1626;1136;1128;488;640
19;306101;306100;62-800;1955;1450;1436;572;864
20;306101;306100;62-800;1246;928;917;417;500
21;306101;306100;62-800;1839;1377;1368;608;760
22;306101;306100;62-800;1505;1160;1156;459;697
23;306101;306100;62-800;1614;1285;1272;498;774
24;306101;306100;62-800;1557;1154;1142;429;713
25;306101;306100;62-800;1553;1192;1184;428;756
26;306101;306100;62-800;753;570;563;199;364
27;306101;306100;62-800;1397;967;962;395;567
28;306101;306100;62-800;1224;864;860;352;508
29;306101;306100;62-800;1263;865;860;316;544
30;306101;306100;62-800;1426;1031;1021;370;651
31;306101;306100;62-800;1195;869;858;356;502
32;306101;306100;62-800;1373;1008;998;404;594
33;306101;306100;62-800;1693;1247;1242;514;728
34;306101;306100;62-800;2070;1610;1600;633;967
35;306101;306100;62-800;1395;1004;994;501;493
36;306101;306100;62-800;2108;1596;1579;745;834
37;306101;306100;62-800;1422;1076;1065;397;668
38;306101;306100;62-800;1578;1198;1189;458;731
39;306101;306100;62-800;661;496;493;174;319
40;306101;306100;62-800;1904;1487;1477;520;957
41;306101;306100;62-800;1330;1060;1054;447;607
42;306101;306100;62-800;605;357;356;172;184
43;306101;306100;62-800;1345;1003;991;345;646
44;306101;306100;62-800;1108;837;831;326;505
45;306101;306100;62-800;748;537;535;211;324
46;306101;306100;62-800;942;748;742;387;355
47;306101;306100;62-800;983;664;659;235;424
48;306101;306100;62-800;823;605;600;230;370
49;306101;306100;62-800;1258;916;909;463;446
50;306101;306100;62-800;1800;1439;1427;430;997
51;306101;306100;62-800;1610;1192;1181;457;724
52;306101;306100;62-800;191;102;101;59;42
53;306101;306100;62-800;52;30;30;16;14
54;306101;306100;62-800;170;92;87;57;30
55;306101;306100;62-800;88;4;4;3;1
56;306101;306100;62-800;59;55;53;10;43
57;306101;306100;62-800;104;40;40;3;37
1;306201;306200;62-500;1713;1180;1164;674;490
2;306201;306200;62-500;1632;1136;1129;527;602
3;306201;306200;62-500;1910;1355;1335;612;723
4;306201;306200;62-500;891;687;683;266;417
5;306201;306200;62-500;1145;850;843;359;484
6;306201;306200;62-500;1412;982;974;499;475
7;306201;306200;62-500;1937;1454;1441;751;690
8;306201;306200;62-500;876;614;606;280;326
9;306201;306200;62-500;850;585;582;314;268
10;306201;306200;62-510;1162;809;802;408;394
11;306201;306200;62-510;1078;764;755;330;425
12;306201;306200;62-510;584;384;379;180;199
13;306201;306200;62-510;851;593;589;292;297
14;306201;306200;62-510;960;662;655;324;331
15;306201;306200;62-510;1358;885;876;437;439
16;306201;306200;62-510;680;450;447;254;193
17;306201;306200;62-510;583;396;388;187;201
18;306201;306200;62-510;1706;1300;1292;577;715
19;306201;306200;62-510;1895;1596;1584;577;1007
20;306201;306200;62-510;1491;1164;1153;573;580
21;306201;306200;62-510;569;484;482;238;244
22;306201;306200;62-510;960;658;653;320;333
23;306201;306200;62-510;601;401;401;164;237
24;306201;306200;62-510;939;650;641;328;313
25;306201;306200;62-510;1177;868;859;423;436
26;306201;306200;62-510;1346;1002;995;508;487
27;306201;306200;62-510;1391;980;974;443;531
28;306201;306200;62-510;922;625;618;303;315
29;306201;306200;62-510;678;453;447;209;238
30;306201;306200;62-510;73;37;35;18;17
31;306201;306200;62-510;1105;783;778;347;431
32;306201;306200;62-510;1184;837;832;369;463
33;306201;306200;62-510;841;610;603;280;323
34;306201;306200;62-510;1160;825;820;323;497
35;306201;306200;62-510;1154;869;863;374;489
36;306201;306200;62-510;752;573;568;224;344
37;306201;306200;62-510;707;537;533;250;283
38;306201;306200;62-510;1353;966;955;410;545
39;306201;306200;62-510;1372;1035;1020;388;632
40;306201;306200;62-510;658;465;463;206;257
41;306201;306200;62-510;950;719;708;309;399
42;306201;306200;62-510;1648;1168;1163;542;621
43;306201;306200;62-510;1620;1161;1154;547;607
44;306201;306200;62-510;1681;1131;1118;666;452
45;306201;306200;62-510;1344;836;834;513;321
46;306201;306200;62-510;191;97;94;52;42
47;306201;306200;62-500;232;118;118;80;38
1;306301;306300;64-100;960;777;774;220;554
2;306301;306300;64-100;1464;1099;1092;376;716
3;306301;306300;64-100;1333;987;977;308;669
4;306301;306300;64-100;856;695;685;219;466
5;306301;306300;64-100;1220;839;827;285;542
6;306301;306300;64-100;2117;1659;1649;497;1152
7;306301;306300;64-100;1425;1008;998;370;628
8;306301;306300;64-100;1682;1292;1277;343;934
9;306301;306300;64-100;1103;813;805;206;599
10;306301;306300;64-100;1127;734;723;299;424
11;306301;306300;64-100;1031;689;682;240;442
12;306301;306300;64-100;834;521;518;214;304
13;306301;306300;64-100;906;660;656;235;421
14;306301;306300;64-100;1116;781;774;239;535
15;306301;306300;64-100;1068;771;767;268;499
16;306301;306300;64-100;821;613;611;185;426
17;306301;306300;64-100;1458;1078;1066;409;657
18;306301;306300;64-100;1401;992;984;359;625
19;306301;306300;64-100;1063;702;700;243;457
20;306301;306300;64-100;1033;604;601;264;337
21;306301;306300;64-100;871;468;462;182;280
22;306301;306300;64-100;980;623;613;223;390
23;306301;306300;64-100;1111;674;668;265;403
24;306301;306300;64-100;1643;1163;1150;385;765
25;306301;306300;64-100;1274;934;920;303;617
26;306301;306300;64-100;1943;1528;1516;460;1056
27;306301;306300;64-100;2139;1537;1523;537;986
28;306301;306300;64-100;1289;1043;1039;397;642
29;306301;306300;64-100;2254;1767;1748;614;1134
30;306301;306300;64-100;1497;1156;1142;414;728
31;306301;306300;64-100;1643;1256;1245;420;825
32;306301;306300;64-100;1133;858;853;313;540
33;306301;306300;64-100;2183;1498;1489;591;898
34;306301;306300;64-100;79;66;65;25;40
1;306401;306400;61-577;1241;951;936;216;720
2;306401;306400;61-553;2290;1808;1787;450;1337
3;306401;306400;61-575;1167;851;846;219;627
4;306401;306400;61-577;1389;1024;1010;260;750
5;306401;306400;61-527;2287;1849;1833;475;1358
6;306401;306400;61-546;1495;1125;1113;301;812
7;306401;306400;61-514;1558;1200;1189;308;881
8;306401;306400;61-501;1541;1178;1161;279;882
9;306401;306400;61-527;1746;1182;1167;328;839
10;306401;306400;61-527;1899;1411;1395;421;974
11;306401;306400;61-501;1640;1149;1130;324;806
12;306401;306400;61-514;2811;2351;2327;503;1824
13;306401;306400;61-485;1979;1443;1427;402;1025
14;306401;306400;60-204;1326;956;950;273;677
15;306401;306400;60-246;1673;1278;1260;355;905
16;306401;306400;60-246;1523;1144;1128;346;782
17;306401;306400;60-211;1645;1270;1262;382;880
18;306401;306400;60-211;1609;1256;1246;333;913
19;306401;306400;60-211;1841;1463;1452;383;1069
20;306401;306400;60-751;1734;1332;1320;351;969
21;306401;306400;60-765;1659;1221;1214;269;945
22;306401;306400;60-726;1598;1102;1091;327;764
23;306401;306400;60-726;1696;1162;1145;367;778
24;306401;306400;60-726;1303;876;869;230;639
25;306401;306400;60-774;1568;1190;1176;301;875
26;306401;306400;60-766;1547;1130;1114;272;842
27;306401;306400;60-766;1880;1568;1552;352;1200
28;306401;306400;60-356;1607;1265;1250;294;956
29;306401;306400;60-356;1753;1397;1381;313;1068
30;306401;306400;60-521;984;698;685;178;507
31;306401;306400;60-822;1825;1396;1382;293;1089
32;306401;306400;60-521;2004;1478;1459;365;1094
33;306401;306400;60-536;1350;927;920;195;725
34;306401;306400;60-521;1228;864;850;226;624
35;306401;306400;60-356;1466;1028;1009;317;692
36;306401;306400;60-542;3761;3192;3145;545;2600
37;306401;306400;60-536;1204;938;934;213;721
38;306401;306400;60-867;1156;874;865;185;680
39;306401;306400;60-867;2427;1971;1952;467;1485
40;306401;306400;60-409;2209;1826;1810;349;1461
41;306401;306400;60-409;1056;866;858;234;624
42;306401;306400;60-409;1107;868;853;257;596
43;306401;306400;60-613;1964;1389;1374;396;978
44;306401;306400;60-613;1792;1446;1433;364;1069
45;306401;306400;60-645;1801;1424;1414;432;982
46;306401;306400;60-645;1856;1513;1500;382;1118
47;306401;306400;60-655;1930;1558;1538;420;1118
48;306401;306400;60-665;1677;1383;1369;402;967
49;306401;306400;60-649;1781;1320;1312;352;960
50;306401;306400;60-665;1778;1470;1455;418;1037
51;306401;306400;61-652;1670;1345;1338;381;957
52;306401;306400;61-652;1749;1348;1337;365;972
53;306401;306400;61-652;2022;1622;1610;378;1232
54;306401;306400;61-699;1629;1348;1331;386;945
55;306401;306400;61-699;1680;1355;1336;388;948
56;306401;306400;61-699;1561;1222;1208;332;876
57;306401;306400;61-699;1650;1320;1310;367;943
58;306401;306400;61-641;1259;1018;1001;323;678
59;306401;306400;61-641;1545;1195;1185;325;860
60;306401;306400;61-642;1863;1501;1486;412;1074
61;306401;306400;61-638;1801;1494;1484;336;1148
62;306401;306400;61-638;1541;1223;1208;338;870
63;306401;306400;61-689;1784;1399;1388;377;1011
64;306401;306400;61-686;1943;1562;1543;399;1144
65;306401;306400;61-689;1111;849;837;229;608
66;306401;306400;61-686;1130;902;886;237;649
67;306401;306400;61-689;1428;1127;1106;322;784
68;306401;306400;61-663;1928;1582;1565;416;1149
69;306401;306400;61-622;1782;1535;1523;381;1142
70;306401;306400;61-622;1854;1604;1589;396;1193
71;306401;306400;61-622;1981;1731;1710;323;1387
72;306401;306400;61-889;1829;1391;1380;399;981
73;306401;306400;61-845;1485;1039;1029;305;724
74;306401;306400;61-883;1716;1192;1178;266;912
75;306401;306400;61-895;1298;885;877;240;637
76;306401;306400;61-895;1595;1154;1140;308;832
77;306401;306400;61-727;1493;1079;1063;331;732
78;306401;306400;61-701;1700;1189;1179;324;855
79;306401;306400;61-781;1630;1106;1098;323;775
80;306401;306400;61-843;1649;1199;1178;274;904
81;306401;306400;61-774;1494;1034;1018;311;707
82;306401;306400;61-714;1425;1112;1103;286;817
83;306401;306400;61-758;2367;1965;1947;380;1567
84;306401;306400;61-127;1006;710;700;229;471
85;306401;306400;61-116;1748;1334;1318;423;895
86;306401;306400;61-116;1649;1250;1239;380;859
87;306401;306400;61-011;2524;1940;1915;524;1391
88;306401;306400;61-011;1478;1009;1001;364;637
89;306401;306400;61-044;1802;1405;1387;478;909
90;306401;306400;61-044;1809;1245;1230;348;882
91;306401;306400;61-049;1813;1488;1473;467;1006
92;306401;306400;61-065;1729;1325;1313;395;918
93;306401;306400;61-062;1897;1531;1520;496;1024
94;306401;306400;61-062;2073;1620;1595;520;1075
95;306401;306400;61-065;1973;1542;1529;435;1094
96;306401;306400;61-245;2000;1594;1585;447;1138
97;306401;306400;61-245;1998;1645;1627;412;1215
98;306401;306400;61-245;1999;1584;1568;444;1124
99;306401;306400;61-255;2032;1639;1622;468;1154
100;306401;306400;61-255;1381;1115;1098;360;738
101;306401;306400;61-294;2003;1584;1569;447;1122
102;306401;306400;61-294;2003;1586;1572;467;1105
103;306401;306400;61-288;1891;1498;1471;448;1023
104;306401;306400;61-288;1832;1402;1389;416;973
105;306401;306400;61-306;2003;1632;1620;491;1129
106;306401;306400;61-306;2512;2142;2127;610;1517
107;306401;306400;61-306;1863;1552;1538;415;1123
108;306401;306400;61-131;2663;2294;2259;437;1822
109;306401;306400;61-131;4662;4005;3963;837;3126
110;306401;306400;61-149;1840;1423;1399;423;976
111;306401;306400;61-223;1640;1267;1250;421;829
112;306401;306400;61-205;1670;1350;1338;387;951
113;306401;306400;61-205;1604;1291;1275;361;914
114;306401;306400;61-223;1824;1427;1416;388;1028
115;306401;306400;61-395;1714;1375;1358;443;915
116;306401;306400;61-156;1832;1444;1419;429;990
117;306401;306400;61-164;2332;1820;1793;495;1298
118;306401;306400;61-395;1819;1440;1423;483;940
119;306401;306400;61-387;1965;1509;1499;511;988
120;306401;306400;61-381;1811;1431;1420;450;970
121;306401;306400;61-381;1860;1440;1426;425;1001
122;306401;306400;61-249;1823;1449;1436;422;1014
123;306401;306400;61-251;1997;1573;1563;446;1117
124;306401;306400;61-249;1769;1485;1461;405;1056
125;306401;306400;61-251;1661;1315;1304;399;905
126;306401;306400;61-251;1716;1406;1389;380;1009
127;306401;306400;61-251;1786;1372;1356;380;976
128;306401;306400;61-251;1745;1372;1362;415;947
129;306401;306400;61-323;1888;1514;1502;564;938
130;306401;306400;61-329;1338;982;971;280;691
131;306401;306400;61-329;1515;1126;1110;323;787
132;306401;306400;61-341;1848;1386;1373;574;799
133;306401;306400;61-353;1931;1573;1558;538;1020
134;306401;306400;61-361;3039;2466;2435;731;1704
135;306401;306400;61-359;1981;1562;1543;532;1011
136;306401;306400;61-441;1823;1410;1395;453;942
137;306401;306400;61-448;1779;1292;1285;383;902
138;306401;306400;61-448;1824;1375;1359;430;929
139;306401;306400;61-465;1748;1250;1243;421;822
140;306401;306400;61-441;2135;1654;1639;507;1132
141;306401;306400;61-432;1671;1109;1105;398;707
142;306401;306400;61-432;1369;1023;1016;320;696
143;306401;306400;61-472;1745;1326;1313;443;870
144;306401;306400;61-472;1478;1222;1214;381;833
145;306401;306400;61-432;1125;911;901;286;615
146;306401;306400;61-432;1194;934;928;290;638
147;306401;306400;61-432;1500;1189;1176;372;804
148;306401;306400;60-594;1962;1615;1594;390;1204
149;306401;306400;60-569;1379;1071;1059;259;800
150;306401;306400;60-591;1677;1343;1333;361;972
151;306401;306400;60-365;1215;995;983;285;698
152;306401;306400;60-354;1177;921;913;264;649
153;306401;306400;60-375;1744;1366;1346;340;1006
154;306401;306400;60-375;1648;1228;1214;399;815
155;306401;306400;60-389;1503;1090;1079;345;734
156;306401;306400;60-389;1669;1227;1210;372;838
157;306401;306400;60-393;1449;1025;1015;313;702
158;306401;306400;60-389;1623;1179;1168;366;802
159;306401;306400;60-326;1609;1294;1276;332;944
160;306401;306400;60-326;1501;1140;1118;345;773
161;306401;306400;60-261;2146;1820;1801;430;1371
162;306401;306400;60-137;1732;1405;1394;431;963
163;306401;306400;60-304;1484;1222;1203;309;894
164;306401;306400;60-159;1905;1570;1548;370;1178
165;306401;306400;60-147;1397;1102;1093;319;774
166;306401;306400;60-159;1607;1269;1246;329;917
167;306401;306400;60-159;1573;1229;1219;335;884
168;306401;306400;60-161;1850;1466;1455;399;1056
169;306401;306400;60-137;1817;1450;1432;461;971
170;306401;306400;60-128;1735;1375;1354;294;1060
171;306401;306400;60-128;1626;1213;1204;342;862
172;306401;306400;60-125;2756;2260;2230;547;1683
173;306401;306400;60-125;1445;1091;1079;343;736
174;306401;306400;60-113;1551;1182;1165;447;718
175;306401;306400;60-121;1538;1182;1173;386;787
176;306401;306400;60-005;1458;1131;1118;363;755
177;306401;306400;60-175;1679;1304;1293;374;919
178;306401;306400;60-175;1831;1486;1474;429;1045
179;306401;306400;60-176;1166;975;962;280;682
180;306401;306400;60-163;1561;1277;1261;413;848
181;306401;306400;60-163;1899;1617;1599;420;1179
182;306401;306400;60-161;1932;1599;1578;446;1132
183;306401;306400;60-176;2486;2210;2175;407;1768
184;306401;306400;60-186;1802;1609;1596;359;1237
185;306401;306400;60-186;1764;1559;1550;346;1204
186;306401;306400;60-325;2894;2596;2566;477;2089
187;306401;306400;60-186;1881;1534;1524;409;1115
188;306401;306400;60-480;1706;1420;1402;396;1006
189;306401;306400;60-452;2239;1888;1872;529;1343
190;306401;306400;60-452;1967;1569;1559;525;1034
191;306401;306400;60-452;1980;1576;1563;435;1128
192;306401;306400;60-463;2712;2339;2323;554;1769
193;306401;306400;60-461;2697;2319;2295;547;1748
194;306401;306400;60-461;2739;2379;2348;535;1813
195;306401;306400;60-476;1877;1622;1611;404;1207
196;306401;306400;60-476;2307;2007;1986;467;1519
197;306401;306400;60-476;1966;1527;1507;419;1088
198;306401;306400;60-476;1981;1689;1670;410;1260
199;306401;306400;60-688;2559;2121;2101;514;1587
200;306401;306400;60-681;2155;1784;1767;481;1286
201;306401;306400;60-681;1682;1331;1318;377;941
202;306401;306400;60-682;2078;1719;1699;425;1274
203;306401;306400;60-682;1749;1405;1387;366;1021
204;306401;306400;60-681;1836;1509;1501;406;1095
205;306401;306400;60-681;2187;1811;1790;446;1344
206;306401;306400;60-681;1705;1394;1383;337;1046
207;306401;306400;60-681;1768;1475;1464;354;1110
208;306401;306400;60-687;1835;1522;1506;330;1176
209;306401;306400;60-682;1696;1400;1383;357;1026
210;306401;306400;60-687;1738;1397;1373;380;993
211;306401;306400;60-687;1716;1459;1443;348;1095
212;306401;306400;60-687;2303;1984;1963;402;1561
213;306401;306400;60-688;1680;1348;1327;369;958
214;306401;306400;60-688;1953;1632;1612;379;1233
215;306401;306400;60-688;1661;1294;1279;342;937
216;306401;306400;60-688;1614;1250;1231;381;850
217;306401;306400;61-616;2104;1729;1716;415;1301
218;306401;306400;61-616;1685;1315;1298;369;929
219;306401;306400;61-616;1520;1197;1182;353;829
220;306401;306400;61-616;1566;1229;1217;376;841
221;306401;306400;61-616;2115;1844;1817;326;1491
222;306401;306400;61-616;950;836;827;191;636
223;306401;306400;61-608;3697;3108;3081;699;2382
224;306401;306400;61-608;2056;1809;1795;324;1471
225;306401;306400;61-614;1694;1385;1372;327;1045
226;306401;306400;61-614;2014;1751;1727;449;1278
227;306401;306400;61-680;2504;2114;2084;518;1566
228;306401;306400;61-485;570;250;245;95;150
229;306401;306400;61-545;114;98;98;34;64
230;306401;306400;61-578;31;18;13;3;10
231;306401;306400;60-235;30;13;12;4;8
232;306401;306400;60-780;143;80;79;24;55
233;306401;306400;60-806;77;66;66;14;52
234;306401;306400;60-535;174;113;111;34;77
235;306401;306400;60-834;207;84;84;28;56
236;306401;306400;61-623;100;65;62;28;34
237;306401;306400;60-479;359;176;170;54;116
238;306401;306400;60-631;86;64;64;32;32
239;306401;306400;60-649;140;137;134;23;111
240;306401;306400;61-848;174;93;93;37;56
241;306401;306400;61-866;128;87;84;40;44
242;306401;306400;61-729;474;381;371;74;297
243;306401;306400;61-114;76;35;35;12;23
244;306401;306400;61-044;136;104;104;41;63
245;306401;306400;61-044;18;5;4;3;1
246;306401;306400;61-285;275;160;156;61;95
247;306401;306400;61-049;74;45;43;35;8
248;306401;306400;61-245;28;12;12;5;7
249;306401;306400;61-315;31;18;18;14;4
250;306401;306400;61-655;61;36;34;16;18
251;306401;306400;60-659;258;89;89;30;59
252;306401;306400;60-569;168;129;128;50;78
253;306401;306400;60-572;44;34;34;10;24
254;306401;306400;60-355;422;218;217;85;132
255;306401;306400;60-129;75;32;31;17;14
256;306401;306400;60-171;182;179;170;21;149
257;306401;306400;60-461;90;54;52;23;29
258;306401;306400;60-480;112;87;87;44;43
259;306401;306400;60-480;35;35;34;7;27
1;320101;320100;78-200;1227;854;846;342;504
2;320101;320100;78-200;1080;663;654;259;395
3;320101;320100;78-200;1020;670;664;258;406
4;320101;320100;78-200;1318;886;878;349;529
5;320101;320100;78-200;1184;819;811;303;508
6;320101;320100;78-200;1230;833;825;321;504
7;320101;320100;78-200;1601;1094;1085;424;661
8;320101;320100;78-200;682;349;344;157;187
9;320101;320100;78-200;1053;640;634;251;383
10;320101;320100;78-200;1202;739;733;298;435
11;320101;320100;78-200;747;540;535;250;285
12;320101;320100;78-200;949;609;606;254;352
13;320101;320100;78-200;1497;1069;1059;436;623
14;320101;320100;78-200;1201;710;705;335;370
15;320101;320100;78-200;205;105;103;45;58
16;320101;320100;78-200;44;22;22;17;5
17;320101;320100;78-200;113;41;40;19;21
1;320102;320100;78-200;774;476;473;267;206
2;320102;320100;78-200;1108;622;612;321;291
3;320102;320100;78-200;722;411;407;207;200
4;320102;320100;78-217;1083;615;609;299;310
5;320102;320100;78-200;905;528;527;280;247
6;320102;320100;78-200;623;309;308;181;127
7;320102;320100;78-200;338;181;180;132;48
1;320103;320100;78-230;1312;678;667;314;353
2;320103;320100;78-230;1393;906;901;445;456
3;320103;320100;78-230;1328;926;917;408;509
4;320103;320100;78-230;756;387;384;231;153
5;320103;320100;78-230;977;456;453;302;151
6;320103;320100;78-230;498;264;264;148;116
1;320104;320100;78-220;764;454;452;259;193
2;320104;320100;78-220;653;334;333;222;111
3;320104;320100;78-220;1335;762;752;421;331
4;320104;320100;78-220;966;676;668;301;367
5;320104;320100;78-220;967;522;520;286;234
6;320104;320100;78-220;370;268;265;65;200
1;320201;320200;73-240;1710;1073;1069;524;545
2;320201;320200;73-240;843;491;489;256;233
3;320201;320200;73-240;606;345;344;196;148
4;320201;320200;73-240;303;171;170;108;62
5;320201;320200;73-240;51;19;18;6;12
1;320202;320200;73-200;789;597;591;235;356
2;320202;320200;73-200;1097;757;751;305;446
3;320202;320200;73-200;742;542;538;225;313
4;320202;320200;73-200;1412;859;852;359;493
5;320202;320200;73-200;1056;755;749;267;482
6;320202;320200;73-200;1168;817;809;293;516
7;320202;320200;73-200;691;494;486;161;325
8;320202;320200;73-200;1207;772;766;294;472
9;320202;320200;73-200;1041;718;714;317;397
10;320202;320200;73-200;1057;698;693;243;450
11;320202;320200;73-200;899;595;592;265;327
12;320202;320200;73-200;150;86;86;40;46
13;320202;320200;73-222;256;145;144;86;58
14;320202;320200;73-200;535;336;334;182;152
15;320202;320200;73-222;313;164;164;101;63
16;320202;320200;73-200;286;171;170;111;59
17;320202;320200;73-222;286;126;126;62;64
18;320202;320200;73-200;190;113;112;54;58
19;320202;320200;73-200;396;225;225;137;88
20;320202;320200;73-222;355;198;198;116;82
21;320202;320200;73-200;202;100;99;72;27
22;320202;320200;73-200;249;151;149;102;47
23;320202;320200;73-200;353;177;176;108;68
24;320202;320200;73-200;197;135;134;92;42
25;320202;320200;73-200;257;168;165;75;90
26;320202;320200;73-200;65;32;32;13;19
1;320203;320200;73-220;1163;739;735;360;375
2;320203;320200;73-220;825;471;466;209;257
3;320203;320200;73-220;376;223;221;105;116
4;320203;320200;73-220;273;190;190;133;57
5;320203;320200;73-220;318;181;181;103;78
6;320203;320200;73-220;214;108;107;41;66
7;320203;320200;73-220;430;270;269;118;151
8;320203;320200;73-220;61;24;23;3;20
1;320204;320200;73-231;602;396;393;201;192
2;320204;320200;73-231;382;214;212;113;99
3;320204;320200;73-231;351;208;205;115;90
4;320204;320200;73-231;354;190;185;132;53
5;320204;320200;73-231;285;193;193;94;99
6;320204;320200;73-231;349;184;183;111;72
7;320204;320200;73-231;241;161;157;96;61
1;320205;320200;73-260;1881;1122;1109;600;509
2;320205;320200;73-260;351;201;197;124;73
3;320205;320200;73-260;472;276;273;146;127
4;320205;320200;73-260;551;305;302;167;135
5;320205;320200;73-260;397;225;221;114;107
6;320205;320200;73-260;331;198;194;150;44
7;320205;320200;73-260;276;150;149;81;68
8;320205;320200;73-260;153;87;87;55;32
9;320205;320200;73-260;225;148;148;94;54
10;320205;320200;73-260;182;92;91;54;37
11;320205;320200;73-260;359;220;219;117;102
12;320205;320200;73-260;314;175;174;127;47
1;320206;320200;73-210;1069;656;641;302;339
2;320206;320200;73-210;974;615;610;335;275
3;320206;320200;73-210;539;244;239;152;87
4;320206;320200;73-210;600;342;340;228;112
5;320206;320200;73-210;617;331;326;207;119
1;320301;320300;78-550;1777;1100;1090;428;662
2;320301;320300;78-550;1138;735;728;275;453
3;320301;320300;78-550;996;667;663;241;422
4;320301;320300;78-550;1108;716;712;346;366
5;320301;320300;78-550;1237;722;722;377;345
6;320301;320300;78-551;546;321;319;197;122
7;320301;320300;78-552;814;455;450;230;220
8;320301;320300;78-553;854;424;420;238;182
1;320302;320300;78-500;706;487;481;135;346
2;320302;320300;78-500;819;548;541;218;323
3;320302;320300;78-500;894;579;572;177;395
4;320302;320300;78-500;753;415;412;174;238
5;320302;320300;78-500;767;441;438;167;271
6;320302;320300;78-500;925;574;571;233;338
7;320302;320300;78-500;917;637;633;215;418
8;320302;320300;78-500;876;564;559;191;368
9;320302;320300;78-500;740;474;472;191;281
10;320302;320300;78-500;795;488;485;235;250
11;320302;320300;78-500;672;404;403;199;204
12;320302;320300;78-500;508;284;284;165;119
13;320302;320300;78-500;565;341;340;177;163
14;320302;320300;78-500;523;291;289;157;132
15;320302;320300;78-506;586;355;353;190;163
16;320302;320300;78-500;555;342;338;173;165
17;320302;320300;78-500;382;201;198;120;78
18;320302;320300;78-500;269;165;163;103;60
19;320302;320300;78-500;214;113;110;48;62
20;320302;320300;78-500;49;33;33;15;18
1;320303;320300;78-540;737;461;450;247;203
2;320303;320300;78-540;646;407;405;153;252
3;320303;320300;78-540;197;117;117;70;47
4;320303;320300;78-540;933;553;546;229;317
5;320303;320300;78-540;738;454;449;172;277
6;320303;320300;78-540;657;348;343;231;112
7;320303;320300;78-540;439;260;257;119;138
8;320303;320300;78-540;165;104;104;58;46
9;320303;320300;78-540;303;166;165;94;71
10;320303;320300;78-540;278;155;155;79;76
1;320305;320300;78-531;738;457;454;280;174
2;320305;320300;78-530;366;200;193;125;68
3;320305;320300;78-530;824;471;469;262;207
4;320305;320300;78-530;680;383;378;211;167
5;320305;320300;78-530;259;155;154;89;65
6;320305;320300;78-530;269;144;143;74;69
7;320305;320300;78-530;377;325;318;39;279
1;320306;320300;78-520;704;463;463;188;275
2;320306;320300;78-520;674;433;429;189;240
3;320306;320300;78-520;784;501;492;229;263
4;320306;320300;78-520;825;460;453;237;216
5;320306;320300;78-520;729;506;503;254;249
6;320306;320300;78-520;1396;948;941;393;548
7;320306;320300;78-520;813;514;508;249;259
8;320306;320300;78-520;728;403;401;216;185
9;320306;320300;78-520;1556;993;981;426;555
10;320306;320300;78-520;688;442;439;192;247
11;320306;320300;78-520;219;134;134;78;56
12;320306;320300;78-523;627;385;383;184;199
13;320306;320300;78-520;235;111;111;57;54
14;320306;320300;78-520;354;235;234;100;134
15;320306;320300;78-523;642;379;375;254;121
16;320306;320300;78-520;272;172;170;99;71
17;320306;320300;78-523;179;94;94;58;36
18;320306;320300;78-520;97;97;96;51;45
1;320402;320400;72-100;1443;912;903;403;500
2;320402;320400;72-100;1642;1152;1142;463;679
3;320402;320400;72-100;1351;922;912;368;544
4;320402;320400;72-100;1558;1109;1097;434;663
5;320402;320400;72-100;1100;821;811;282;529
6;320402;320400;72-100;886;565;562;247;315
7;320402;320400;72-100;1669;1217;1203;427;776
8;320402;320400;72-100;1717;1164;1156;501;655
9;320402;320400;72-100;1651;1121;1115;456;659
10;320402;320400;72-100;1261;914;901;333;568
11;320402;320400;72-100;1404;1043;1032;477;555
12;320402;320400;72-113;1025;717;713;270;443
13;320402;320400;72-100;910;647;639;283;356
14;320402;320400;72-132;1133;725;721;378;343
15;320402;320400;72-100;467;365;363;136;227
16;320402;320400;72-123;1209;864;858;281;577
17;320402;320400;72-105;973;682;673;301;372
18;320402;320400;70-895;1660;1277;1259;472;787
19;320402;320400;72-113;178;64;64;28;36
20;320402;320400;72-113;268;202;202;76;126
21;320402;320400;72-100;365;261;259;103;156
22;320402;320400;72-100;159;100;99;63;36
23;320402;320400;72-100;380;269;267;119;148
24;320402;320400;72-131;535;356;353;168;185
25;320402;320400;72-100;297;201;199;100;99
26;320402;320400;72-132;173;110;107;57;50
27;320402;320400;72-123;861;675;670;309;361
28;320402;320400;72-105;485;271;269;108;161
29;320402;320400;72-100;80;25;25;7;18
30;320402;320400;72-100;759;595;580;79;501
31;320402;320400;72-123;42;18;18;7;11
1;320403;320400;72-130;975;544;540;360;180
2;320403;320400;72-130;1255;868;858;409;449
3;320403;320400;72-130;1190;727;722;381;341
4;320403;320400;72-130;599;360;355;182;173
5;320403;320400;72-130;453;258;254;164;90
6;320403;320400;72-130;372;285;285;156;129
7;320403;320400;72-130;346;240;236;141;95
8;320403;320400;72-130;269;156;151;96;55
9;320403;320400;72-130;293;167;164;96;68
10;320403;320400;72-130;321;182;181;119;62
11;320403;320400;72-130;404;261;259;196;63
1;320404;320400;72-200;1694;1191;1176;495;681
2;320404;320400;72-200;1447;982;973;427;546
3;320404;320400;72-200;1340;886;879;353;526
4;320404;320400;72-200;1217;759;751;321;430
5;320404;320400;72-200;1497;992;984;415;569
6;320404;320400;72-200;1578;1168;1159;388;771
7;320404;320400;72-200;1382;911;905;320;585
8;320404;320400;72-200;1295;850;840;345;495
9;320404;320400;72-200;916;529;527;292;235
10;320404;320400;72-200;1254;657;645;350;295
11;320404;320400;72-200;975;545;545;318;227
12;320404;320400;72-200;553;273;269;167;102
13;320404;320400;72-200;539;288;285;166;119
14;320404;320400;72-200;735;398;396;260;136
15;320404;320400;72-200;269;170;166;80;86
16;320404;320400;72-200;176;92;92;50;42
17;320404;320400;72-200;315;222;222;109;113
18;320404;320400;72-200;29;18;18;13;5
19;320404;320400;72-200;60;34;31;17;14
20;320404;320400;72-200;40;30;29;18;11
21;320404;320400;72-200;672;552;545;63;482
1;320405;320400;72-221;1071;683;673;345;328
2;320405;320400;72-221;546;327;325;171;154
3;320405;320400;72-221;305;153;152;105;47
4;320405;320400;72-221;289;211;208;124;84
1;320406;320400;72-110;1124;726;723;366;357
2;320406;320400;72-121;1147;609;601;395;206
3;320406;320400;72-122;600;373;368;168;200
4;320406;320400;72-110;828;491;486;262;224
1;320407;320400;72-112;842;457;455;232;223
2;320407;320400;72-111;613;341;340;182;158
3;320407;320400;72-112;429;202;201;102;99
4;320407;320400;72-111;286;141;140;61;79
5;320407;320400;72-112;1356;811;805;341;464
1;320501;320500;72-304;1205;769;759;413;346
2;320501;320500;72-304;541;258;256;165;91
3;320501;320500;72-304;328;177;174;93;81
4;320501;320500;72-304;274;173;172;101;71
5;320501;320500;72-304;287;133;131;82;49
1;320502;320500;72-300;908;667;665;234;431
2;320502;320500;72-300;515;302;299;122;177
3;320502;320500;72-300;665;367;363;205;158
4;320502;320500;72-313;656;379;377;201;176
5;320502;320500;72-300;481;290;287;133;154
6;320502;320500;72-307;554;266;264;131;133
7;320502;320500;72-300;1549;1067;1054;405;649
8;320502;320500;72-300;1652;1144;1132;432;700
9;320502;320500;72-300;1115;697;693;296;397
10;320502;320500;72-300;1387;970;967;322;645
11;320502;320500;72-300;839;492;485;202;283
12;320502;320500;72-300;1573;1017;1006;392;614
13;320502;320500;72-300;1002;596;591;252;339
14;320502;320500;72-300;1156;783;782;253;529
15;320502;320500;72-300;676;371;367;175;192
16;320502;320500;72-300;559;273;271;146;125
17;320502;320500;72-341;336;214;213;113;100
18;320502;320500;72-300;510;369;364;132;232
19;320502;320500;72-300;423;311;310;108;202
20;320502;320500;72-300;208;78;75;38;37
21;320502;320500;72-300;42;32;31;13;18
22;320502;320500;72-300;58;34;27;15;12
1;320503;320500;72-343;736;465;464;252;212
2;320503;320500;72-342;1289;819;813;460;353
3;320503;320500;72-343;623;407;401;242;159
4;320503;320500;72-342;255;164;159;86;73
1;320504;320500;72-310;1610;1022;1008;437;571
2;320504;320500;72-310;1254;805;800;379;421
3;320504;320500;72-310;727;375;370;222;148
4;320504;320500;72-310;386;149;149;85;64
5;320504;320500;72-310;412;239;235;159;76
6;320504;320500;72-310;558;301;300;198;102
7;320504;320500;72-310;395;246;245;145;100
8;320504;320500;72-310;226;152;150;77;73
9;320504;320500;72-310;210;118;118;69;49
10;320504;320500;72-310;267;124;123;82;41
11;320504;320500;72-310;182;98;98;73;25
12;320504;320500;72-310;191;152;143;26;117
1;320507;320500;72-346;2616;2261;2246;764;1482
2;320507;320500;72-344;2206;1995;1977;793;1184
3;320507;320500;72-350;2728;2392;2376;845;1531
4;320507;320500;72-344;220;158;153;75;78
1;320508;320500;72-320;780;545;539;195;344
2;320508;320500;72-320;1684;1083;1076;430;646
3;320508;320500;72-320;1721;1099;1092;454;638
4;320508;320500;72-320;1214;721;715;308;407
5;320508;320500;72-320;1558;983;974;401;573
6;320508;320500;72-350;612;380;375;229;146
7;320508;320500;72-320;598;362;362;198;164
8;320508;320500;72-320;517;267;267;161;106
9;320508;320500;72-320;893;515;508;234;274
10;320508;320500;72-330;2954;2510;2492;852;1640
11;320508;320500;72-320;207;123;123;83;40
12;320508;320500;72-320;223;62;61;35;26
1;320601;320600;74-110;1370;905;896;467;429
2;320601;320600;74-110;647;296;292;198;94
3;320601;320600;74-111;1132;597;590;382;208
4;320601;320600;74-110;373;210;210;102;108
5;320601;320600;74-110;310;181;179;100;79
6;320601;320600;74-110;375;208;206;136;70
7;320601;320600;74-110;284;125;124;80;44
1;320602;320600;74-520;1166;707;704;293;411
2;320602;320600;74-520;1445;784;779;415;364
3;320602;320600;74-520;516;302;300;140;160
1;320603;320600;74-500;1341;921;915;385;530
2;320603;320600;74-500;1315;889;880;395;485
3;320603;320600;74-500;1333;909;902;405;497
4;320603;320600;74-500;1453;902;892;381;511
5;320603;320600;74-500;341;169;169;77;92
6;320603;320600;74-500;948;550;548;336;212
7;320603;320600;74-500;968;549;541;331;210
8;320603;320600;74-500;1182;696;688;442;246
9;320603;320600;74-500;599;364;362;177;185
10;320603;320600;74-500;568;315;310;231;79
1;320604;320600;74-100;1171;838;830;372;458
2;320604;320600;74-100;1312;861;854;409;445
3;320604;320600;74-100;1325;913;903;392;511
4;320604;320600;74-100;1186;801;795;377;418
5;320604;320600;74-100;1215;886;878;379;499
6;320604;320600;74-100;966;703;694;326;368
7;320604;320600;74-101;1382;1098;1080;413;667
8;320604;320600;74-101;939;701;694;319;375
9;320604;320600;74-101;1403;1088;1072;473;599
10;320604;320600;74-101;1072;789;781;331;450
11;320604;320600;74-101;886;623;618;295;323
12;320604;320600;74-101;1104;762;756;329;427
13;320604;320600;74-100;426;303;302;160;142
14;320604;320600;74-100;1038;669;665;323;342
15;320604;320600;74-100;848;465;465;294;171
16;320604;320600;74-100;177;118;118;91;27
17;320604;320600;74-100;428;297;296;131;165
18;320604;320600;74-100;607;403;399;200;199
19;320604;320600;74-105;766;511;506;296;210
20;320604;320600;74-100;485;329;326;148;178
21;320604;320600;74-100;365;201;197;96;101
22;320604;320600;74-100;428;294;290;130;160
23;320604;320600;74-100;194;110;106;61;45
24;320604;320600;74-100;229;148;148;97;51
25;320604;320600;74-100;285;129;127;70;57
26;320604;320600;74-100;216;145;145;99;46
27;320604;320600;74-100;209;164;162;74;88
28;320604;320600;74-101;703;527;524;214;310
29;320604;320600;74-105;1100;835;827;307;520
30;320604;320600;74-100;69;27;25;9;16
31;320604;320600;74-100;40;15;13;7;6
32;320604;320600;74-100;32;6;5;1;4
33;320604;320600;74-105;36;11;11;4;7
34;320604;320600;74-105;75;9;9;4;5
1;320605;320600;74-505;1259;759;751;382;369
2;320605;320600;74-505;1282;822;818;365;453
3;320605;320600;74-505;804;449;443;261;182
4;320605;320600;74-505;619;376;374;246;128
5;320605;320600;74-505;438;264;263;157;106
6;320605;320600;74-505;417;230;228;127;101
7;320605;320600;74-505;221;126;123;58;65
1;320606;320600;74-503;1630;1102;1091;511;580
2;320606;320600;74-503;586;331;326;154;172
3;320606;320600;74-503;545;280;278;161;117
4;320606;320600;74-503;349;211;210;124;86
5;320606;320600;74-503;62;38;35;32;3
1;320607;320600;74-106;354;255;255;173;82
2;320607;320600;74-106;628;464;463;248;215
3;320607;320600;74-106;1060;702;697;331;366
4;320607;320600;74-106;356;259;255;129;126
5;320607;320600;74-106;245;147;146;90;56
6;320607;320600;74-106;253;173;172;87;85
1;320608;320600;74-510;1608;1025;1021;448;573
2;320608;320600;74-510;346;182;182;113;69
3;320608;320600;74-510;526;304;304;192;112
4;320608;320600;74-510;416;268;267;174;93
5;320608;320600;74-510;523;312;312;206;106
6;320608;320600;74-510;305;164;162;109;53
7;320608;320600;74-510;79;30;29;18;11
1;320609;320600;74-120;1648;1052;1049;500;549
2;320609;320600;74-121;654;393;389;258;131
3;320609;320600;74-121;518;304;300;211;89
4;320609;320600;74-120;471;271;271;193;78
5;320609;320600;74-121;314;195;194;113;81
6;320609;320600;74-121;262;125;121;95;26
1;320701;320700;72-420;1346;1156;1148;383;765
2;320701;320700;72-420;881;711;710;286;424
3;320701;320700;72-420;1222;1000;994;315;679
4;320701;320700;72-420;747;571;564;149;415
5;320701;320700;72-415;1799;1602;1591;584;1007
1;320702;320700;72-410;968;667;662;292;370
2;320702;320700;72-410;538;287;284;200;84
3;320702;320700;72-410;1229;708;702;385;317
4;320702;320700;72-410;580;305;302;203;99
5;320702;320700;74-410;931;607;605;270;335
1;320703;320700;72-400;1375;961;956;339;617
2;320703;320700;72-400;1142;764;757;295;462
3;320703;320700;72-400;1377;960;955;358;597
4;320703;320700;72-400;1456;1034;1028;353;675
5;320703;320700;72-400;1621;1118;1108;399;709
6;320703;320700;72-400;717;450;449;199;250
7;320703;320700;72-400;650;398;396;170;226
8;320703;320700;72-400;897;533;525;239;286
9;320703;320700;72-400;554;311;305;148;157
10;320703;320700;72-400;406;245;242;121;121
11;320703;320700;72-400;373;221;220;98;122
12;320703;320700;72-400;69;35;31;21;10
13;320703;320700;72-400;74;13;13;7;6
1;320704;320700;72-500;1044;745;740;269;471
2;320704;320700;72-500;1181;806;801;280;521
3;320704;320700;72-500;1771;1376;1368;601;767
4;320704;320700;72-500;1764;1368;1362;448;914
5;320704;320700;72-500;526;374;374;114;260
6;320704;320700;72-500;336;221;218;77;141
1;320705;320700;72-405;866;528;525;217;308
2;320705;320700;72-405;710;412;410;249;161
3;320705;320700;72-405;507;273;272;131;141
4;320705;320700;72-405;634;378;377;182;195
5;320705;320700;72-405;187;117;115;57;58
6;320705;320700;72-405;185;103;103;45;58
1;320706;320700;72-510;681;463;458;198;260
2;320706;320700;72-510;1058;681;667;279;388
3;320706;320700;72-510;1072;703;701;323;378
4;320706;320700;72-510;634;417;415;176;239
5;320706;320700;72-510;550;363;360;171;189
6;320706;320700;72-518;533;358;356;179;177
7;320706;320700;72-513;463;337;337;147;190
8;320706;320700;72-514;779;516;515;184;331
9;320706;320700;72-514;619;332;329;148;181
10;320706;320700;72-511;366;231;228;126;102
11;320706;320700;72-510;328;196;195;101;94
12;320706;320700;72-510;400;273;271;179;92
13;320706;320700;72-510;535;320;318;154;164
14;320706;320700;72-510;449;241;237;102;135
15;320706;320700;72-518;223;148;148;76;72
16;320706;320700;72-510;234;116;113;52;61
17;320706;320700;72-510;260;136;134;83;51
1;320801;320800;78-100;1697;1479;1465;524;941
2;320801;320800;78-100;1925;1490;1480;557;923
3;320801;320800;78-100;1495;1117;1109;402;707
4;320801;320800;78-100;1761;1201;1192;430;762
5;320801;320800;78-100;1975;1432;1421;513;908
6;320801;320800;78-100;1410;1099;1094;387;707
7;320801;320800;78-100;1318;1029;1021;380;641
8;320801;320800;78-100;1319;874;868;367;501
9;320801;320800;78-100;1290;865;855;332;523
10;320801;320800;78-100;2074;1514;1506;521;985
11;320801;320800;78-100;1765;1428;1417;475;942
12;320801;320800;78-100;1570;1126;1119;429;690
13;320801;320800;78-100;1705;1234;1226;412;814
14;320801;320800;78-100;2151;1666;1648;635;1013
15;320801;320800;78-100;1772;1364;1353;467;886
16;320801;320800;78-100;1265;884;880;369;511
17;320801;320800;78-100;1080;820;812;240;572
18;320801;320800;78-100;2083;1775;1763;571;1192
19;320801;320800;78-100;1812;1264;1258;471;787
20;320801;320800;78-100;1340;1019;1010;375;635
21;320801;320800;78-100;1450;1155;1149;402;747
22;320801;320800;78-100;1958;1480;1474;477;997
23;320801;320800;78-100;1772;1263;1250;447;803
24;320801;320800;78-100;1262;1067;1066;398;668
25;320801;320800;78-100;225;134;132;53;79
26;320801;320800;78-100;259;250;248;123;125
1;320802;320800;78-113;1455;985;980;499;481
2;320802;320800;78-114;1010;630;628;316;312
3;320802;320800;78-114;340;206;205;100;105
4;320802;320800;78-113;608;332;328;186;142
5;320802;320800;78-113;343;221;215;122;93
6;320802;320800;78-113;257;154;150;89;61
7;320802;320800;78-114;78;25;23;14;9
8;320802;320800;78-113;30;21;20;15;5
1;320803;320800;78-120;815;538;535;246;289
2;320803;320800;78-120;761;442;440;224;216
3;320803;320800;78-120;840;534;526;267;259
4;320803;320800;78-120;715;384;381;230;151
5;320803;320800;78-120;415;250;246;145;101
6;320803;320800;78-120;386;262;260;108;152
7;320803;320800;78-120;55;31;31;13;18
1;320804;320800;78-100;560;387;381;106;275
2;320804;320800;78-100;722;530;523;162;361
3;320804;320800;78-100;1854;1361;1345;516;829
4;320804;320800;78-132;733;475;472;219;253
5;320804;320800;78-131;2399;2216;2210;839;1371
6;320804;320800;78-133;713;469;466;217;249
7;320804;320800;78-133;694;425;421;220;201
8;320804;320800;78-132;2474;2033;2021;663;1358
9;320804;320800;78-102;469;329;324;183;141
10;320804;320800;78-100;379;254;251;118;133
1;320805;320800;78-125;886;576;572;266;306
2;320805;320800;78-125;317;211;211;92;119
3;320805;320800;78-124;270;174;172;103;69
4;320805;320800;78-124;443;278;278;152;126
5;320805;320800;78-125;373;210;208;86;122
6;320805;320800;78-124;244;139;138;91;47
7;320805;320800;78-124;342;199;196;142;54
1;320806;320800;78-122;1276;838;829;315;514
2;320806;320800;78-123;1107;727;719;404;315
3;320806;320800;78-123;282;181;180;80;100
4;320806;320800;78-123;293;178;176;102;74
1;320807;320800;78-111;2653;2361;2349;927;1422
2;320807;320800;78-111;533;348;341;178;163
3;320807;320800;78-111;1441;1289;1281;530;751
4;320807;320800;78-111;2051;1675;1665;697;968
1;320901;320900;76-031;1418;1010;999;382;617
2;320901;320900;76-031;1057;688;679;306;373
3;320901;320900;76-037;1239;776;765;405;360
4;320901;320900;76-038;1551;898;888;565;323
5;320901;320900;76-035;1327;834;823;393;430
1;320902;320900;76-039;1569;1009;998;445;553
2;320902;320900;76-039;1584;1165;1158;436;722
3;320902;320900;76-039;740;421;418;197;221
4;320902;320900;76-039;1027;821;814;218;596
5;320902;320900;76-039;56;21;20;10;10
1;320903;320900;76-020;1715;1100;1092;543;549
2;320903;320900;76-020;1051;657;649;343;306
3;320903;320900;76-020;736;420;417;268;149
4;320903;320900;76-020;304;154;154;106;48
5;320903;320900;76-020;442;244;243;126;117
6;320903;320900;76-020;438;258;255;137;118
7;320903;320900;76-020;674;320;318;185;133
8;320903;320900;76-020;381;228;228;130;98
9;320903;320900;76-020;263;150;146;85;61
10;320903;320900;76-020;277;146;144;73;71
11;320903;320900;76-020;160;126;121;12;109
1;320904;320900;76-015;831;599;595;260;335
2;320904;320900;76-042;1276;845;840;290;550
3;320904;320900;76-009;806;523;519;224;295
4;320904;320900;76-015;402;251;248;119;129
5;320904;320900;76-015;353;269;268;114;154
6;320904;320900;76-015;239;134;131;58;73
7;320904;320900;76-015;287;163;162;75;87
1;320905;320900;76-032;1382;1125;1120;433;687
2;320905;320900;76-032;1066;855;849;307;542
3;320905;320900;76-032;2199;1967;1956;686;1270
4;320905;320900;76-034;602;602;597;244;353
5;320905;320900;76-034;2398;2177;2162;821;1341
6;320905;320900;76-032;491;395;393;155;238
7;320905;320900;76-034;520;439;438;176;262
8;320905;320900;76-032;59;29;27;20;7
9;320905;320900;76-034;44;17;17;4;13
1;320906;320900;76-010;1331;846;837;358;479
2;320906;320900;76-010;749;507;504;214;290
3;320906;320900;76-010;367;210;207;113;94
4;320906;320900;76-010;872;445;439;252;187
5;320906;320900;76-010;753;423;419;220;199
6;320906;320900;76-010;495;229;228;129;99
7;320906;320900;76-010;672;386;383;221;162
8;320906;320900;76-010;502;309;307;148;159
9;320906;320900;76-010;313;153;150;81;69
10;320906;320900;76-010;94;41;38;19;19
11;320906;320900;76-010;56;22;22;12;10
1;320907;320900;76-004;825;532;529;234;295
2;320907;320900;76-004;626;398;397;188;209
3;320907;320900;76-004;630;417;414;174;240
4;320907;320900;76-004;854;548;542;262;280
5;320907;320900;76-003;391;240;237;144;93
6;320907;320900;76-003;489;324;322;172;150
7;320907;320900;76-004;387;222;222;113;109
8;320907;320900;76-004;367;222;220;97;123
9;320907;320900;76-003;574;352;350;168;182
10;320907;320900;76-003;261;151;150;90;60
11;320907;320900;76-004;462;334;332;125;207
12;320907;320900;76-003;185;125;123;71;52
13;320907;320900;76-003;782;627;621;245;376
14;320907;320900;76-004;303;206;205;109;96
15;320907;320900;76-004;301;197;192;99;93
16;320907;320900;75-016;533;424;422;120;302
17;320907;320900;76-004;808;510;505;250;255
18;320907;320900;76-004;766;524;522;249;273
19;320907;320900;76-004;590;401;399;164;235
20;320907;320900;76-004;541;334;331;131;200
1;320908;320900;76-024;1292;983;975;361;614
2;320908;320900;76-024;1421;1075;1065;320;745
3;320908;320900;76-024;1185;939;925;307;618
4;320908;320900;76-024;352;209;208;95;113
5;320908;320900;76-024;272;157;154;82;72
6;320908;320900;76-023;609;387;384;168;216
7;320908;320900;76-024;518;271;267;141;126
8;320908;320900;76-024;175;113;111;54;57
9;320908;320900;76-024;432;267;264;126;138
1;321001;321000;74-320;930;563;556;264;292
2;321001;321000;74-320;869;552;551;272;279
3;321001;321000;74-320;879;600;599;269;330
4;321001;321000;74-320;930;596;589;268;321
5;321001;321000;74-320;705;473;472;178;294
6;321001;321000;74-320;671;418;418;192;226
7;321001;321000;74-320;972;626;620;299;321
8;321001;321000;74-320;873;606;603;208;395
9;321001;321000;74-320;951;658;653;272;381
10;321001;321000;74-320;871;604;595;257;338
11;321001;321000;74-320;769;499;496;241;255
12;321001;321000;74-320;350;229;227;90;137
13;321001;321000;74-320;311;185;184;108;76
14;321001;321000;74-322;852;504;500;295;205
15;321001;321000;74-320;742;436;434;286;148
16;321001;321000;74-320;1264;859;853;352;501
17;321001;321000;74-320;316;179;175;119;56
18;321001;321000;74-320;235;172;172;87;85
19;321001;321000;74-320;56;18;18;10;8
1;321002;321000;74-407;971;579;575;258;317
2;321002;321000;74-406;478;311;308;148;160
3;321002;321000;74-407;356;227;225;135;90
4;321002;321000;74-407;269;143;142;89;53
1;321003;321000;74-400;924;577;574;228;346
2;321003;321000;74-400;851;535;530;226;304
3;321003;321000;74-400;1041;647;646;276;370
4;321003;321000;74-400;827;547;545;221;324
5;321003;321000;74-400;651;452;450;203;247
6;321003;321000;74-400;1015;700;697;296;401
7;321003;321000;74-311;811;454;451;249;202
8;321003;321000;74-404;664;415;414;200;214
9;321003;321000;74-404;593;336;327;183;144
10;321003;321000;74-400;819;466;460;259;201
11;321003;321000;74-311;516;294;293;155;138
12;321003;321000;74-400;387;211;207;132;75
13;321003;321000;74-404;398;250;249;124;125
14;321003;321000;74-404;222;133;132;64;68
15;321003;321000;74-404;268;166;164;87;77
16;321003;321000;74-311;242;154;152;72;80
17;321003;321000;74-400;1163;651;646;272;374
18;321003;321000;74-400;1187;827;818;332;486
19;321003;321000;74-400;1048;732;730;282;448
20;321003;321000;74-400;678;380;377;177;200
21;321003;321000;74-400;73;12;12;5;7
1;321004;321000;74-300;997;699;692;275;417
2;321004;321000;74-300;1141;801;794;258;536
3;321004;321000;74-300;921;583;577;242;335
4;321004;321000;74-300;1140;759;754;310;444
5;321004;321000;74-300;761;457;454;199;255
6;321004;321000;74-300;1062;604;599;290;309
7;321004;321000;74-300;882;495;490;233;257
8;321004;321000;74-300;837;588;583;209;374
9;321004;321000;74-300;445;285;283;165;118
10;321004;321000;74-300;922;517;514;320;194
11;321004;321000;74-300;486;297;294;169;125
12;321004;321000;74-300;725;392;385;260;125
13;321004;321000;74-300;667;385;383;179;204
14;321004;321000;74-300;298;168;167;81;86
15;321004;321000;74-300;265;184;183;83;100
16;321004;321000;74-300;155;78;77;43;34
17;321004;321000;74-300;218;125;124;65;59
18;321004;321000;74-300;247;155;155;85;70
19;321004;321000;74-300;260;146;144;77;67
20;321004;321000;74-300;227;121;120;80;40
21;321004;321000;74-300;197;119;118;78;40
22;321004;321000;74-300;429;275;272;169;103
23;321004;321000;74-300;353;206;206;129;77
24;321004;321000;74-300;221;137;137;57;80
25;321004;321000;74-300;159;41;34;24;10
1;321005;321000;74-304;449;265;260;148;112
2;321005;321000;74-305;940;551;546;277;269
3;321005;321000;74-304;516;305;302;164;138
4;321005;321000;74-304;257;194;192;101;91
5;321005;321000;74-304;331;195;195;123;72
1;321101;321100;72-003;1638;1276;1261;360;901
2;321101;321100;72-002;2504;1979;1963;605;1358
3;321101;321100;72-006;1797;1519;1509;313;1196
4;321101;321100;72-003;1869;1564;1550;432;1118
5;321101;321100;72-006;2277;1869;1852;511;1341
6;321101;321100;71-218;2255;1891;1868;458;1410
7;321101;321100;72-003;308;224;224;94;130
8;321101;321100;71-218;1774;1513;1501;308;1193
9;321101;321100;72-006;1681;1312;1304;432;872
10;321101;321100;72-002;263;210;210;59;151
11;321101;321100;72-003;188;111;109;51;58
12;321101;321100;72-003;177;110;110;55;55
13;321101;321100;72-003;263;196;194;72;122
14;321101;321100;72-003;656;519;512;156;356
15;321101;321100;72-003;1871;1576;1563;397;1166
16;321101;321100;72-006;1287;1089;1077;273;804
1;321102;321100;72-001;983;761;758;309;449
2;321102;321100;72-005;744;547;544;254;290
3;321102;321100;72-005;1026;678;672;277;395
4;321102;321100;72-005;1057;823;818;217;601
5;321102;321100;72-005;964;778;770;204;566
6;321102;321100;72-005;817;668;663;161;502
7;321102;321100;72-001;767;562;555;193;362
8;321102;321100;72-001;794;585;581;244;337
9;321102;321100;72-005;783;521;517;208;309
10;321102;321100;72-005;818;612;603;198;405
11;321102;321100;72-005;753;622;615;151;464
12;321102;321100;72-005;673;555;551;156;395
13;321102;321100;72-005;561;485;483;110;373
1;321103;321100;72-022;877;551;540;181;359
2;321103;321100;72-022;363;252;250;98;152
1;321104;321100;72-004;1369;1076;1067;329;738
2;321104;321100;72-004;227;155;150;70;80
3;321104;321100;72-004;1569;1173;1162;376;786
4;321104;321100;72-020;1578;1076;1065;416;649
5;321104;321100;72-015;500;330;327;162;165
6;321104;321100;72-015;296;207;206;95;111
7;321104;321100;72-015;223;169;169;91;78
8;321104;321100;72-015;978;575;565;300;265
9;321104;321100;72-010;1422;905;902;441;461
10;321104;321100;72-010;1306;785;771;375;396
11;321104;321100;72-010;1035;685;677;278;399
12;321104;321100;72-010;686;522;519;237;282
13;321104;321100;72-010;1543;1170;1158;422;736
14;321104;321100;72-010;1051;692;686;321;365
15;321104;321100;72-010;1729;1180;1171;475;696
16;321104;321100;72-010;1277;940;925;340;585
17;321104;321100;72-010;1235;800;789;360;429
18;321104;321100;72-010;1745;1119;1108;488;620
19;321104;321100;72-010;1249;944;937;389;548
20;321104;321100;72-010;1643;1180;1170;537;633
21;321104;321100;72-010;1216;881;878;399;479
22;321104;321100;72-010;1032;737;730;341;389
23;321104;321100;72-010;1072;787;781;342;439
24;321104;321100;72-010;1058;732;724;350;374
25;321104;321100;72-010;1324;908;895;387;508
26;321104;321100;72-015;298;209;207;116;91
27;321104;321100;72-015;343;230;228;97;131
28;321104;321100;72-010;64;30;30;11;19
1;321201;321200;74-202;1308;778;771;492;279
2;321201;321200;74-202;999;623;616;382;234
1;321202;321200;74-204;877;534;531;356;175
2;321202;321200;74-205;655;413;411;288;123
3;321202;321200;74-204;315;193;192;109;83
1;321203;321200;74-240;1184;772;763;394;369
2;321203;321200;74-240;1167;719;707;386;321
3;321203;321200;74-230;710;345;342;238;104
4;321203;321200;74-240;814;464;459;220;239
5;321203;321200;74-240;231;142;142;84;58
1;321204;321200;74-210;601;342;337;212;125
2;321204;321200;74-210;474;290;289;157;132
3;321204;321200;74-210;872;510;507;282;225
4;321204;321200;73-115;467;269;267;175;92
5;321204;321200;74-210;383;219;219;136;83
6;321204;321200;74-210;296;187;187;120;67
7;321204;321200;74-211;248;143;141;99;42
8;321204;321200;73-115;287;154;154;104;50
1;321205;321200;74-200;1217;847;841;432;409
2;321205;321200;74-200;1026;719;713;318;395
3;321205;321200;74-200;2043;1429;1418;749;669
4;321205;321200;74-200;675;472;468;227;241
5;321205;321200;74-200;1358;936;930;461;469
6;321205;321200;74-200;1421;996;989;491;498
7;321205;321200;74-200;1055;763;758;354;404
8;321205;321200;74-200;1790;1117;1108;676;432
9;321205;321200;74-200;729;497;495;310;185
10;321205;321200;74-211;977;720;714;504;210
11;321205;321200;74-230;449;272;268;195;73
12;321205;321200;74-230;529;328;323;177;146
13;321205;321200;74-200;332;212;209;142;67
14;321205;321200;74-200;103;20;20;9;11
1;321206;321200;74-201;833;530;523;356;167
2;321206;321200;74-211;603;391;390;300;90
3;321206;321200;74-201;580;353;348;211;137
4;321206;321200;74-201;465;280;274;156;118
1;321301;321300;76-150;2182;1957;1939;703;1236
2;321301;321300;76-150;1332;873;863;357;506
3;321301;321300;76-150;1082;674;661;274;387
4;321301;321300;76-150;1227;867;860;310;550
5;321301;321300;76-150;1352;968;957;337;620
6;321301;321300;76-150;1392;959;947;334;613
7;321301;321300;76-150;1216;843;840;341;499
8;321301;321300;76-150;1257;820;816;300;516
1;321302;321300;76-100;1636;1147;1133;494;639
2;321302;321300;76-100;1642;973;968;472;496
3;321302;321300;76-100;1598;1015;1011;458;553
4;321302;321300;76-100;1644;1111;1098;546;552
5;321302;321300;76-100;2056;1406;1389;631;758
6;321302;321300;76-100;36;27;27;11;16
1;321303;321300;76-150;701;553;551;234;317
2;321303;321300;76-150;219;133;129;82;47
3;321303;321300;76-150;412;262;261;98;163
4;321303;321300;76-150;378;234;231;123;108
5;321303;321300;76-150;402;266;260;140;120
6;321303;321300;76-150;423;237;235;130;105
7;321303;321300;76-150;316;225;224;111;113
8;321303;321300;76-156;2436;2246;2236;966;1270
9;321303;321300;76-150;204;139;139;79;60
10;321303;321300;76-150;225;138;136;57;79
11;321303;321300;76-150;442;300;298;150;148
12;321303;321300;76-150;387;243;239;147;92
13;321303;321300;76-156;237;157;155;85;70
14;321303;321300;76-156;319;204;204;70;134
15;321303;321300;76-150;567;330;321;182;139
16;321303;321300;76-150;226;127;125;64;61
17;321303;321300;76-150;218;166;165;45;120
18;321303;321300;76-150;183;111;110;54;56
1;321304;321300;76-142;340;242;239;114;125
2;321304;321300;76-142;711;496;489;300;189
3;321304;321300;76-142;607;322;320;189;131
4;321304;321300;76-129;730;469;463;294;169
5;321304;321300;76-142;272;169;167;100;67
6;321304;321300;76-142;451;328;327;167;160
7;321304;321300;76-142;237;110;109;70;39
8;321304;321300;76-142;381;258;256;156;100
9;321304;321300;76-142;353;229;225;116;109
10;321304;321300;76-142;318;181;180;110;70
11;321304;321300;76-129;170;123;122;78;44
1;321305;321300;76-113;266;183;181;98;83
2;321305;321300;76-113;724;409;401;228;173
3;321305;321300;76-113;555;316;316;191;125
4;321305;321300;76-113;323;158;157;104;53
5;321305;321300;76-113;339;195;192;93;99
6;321305;321300;76-107;2174;2025;2014;897;1117
7;321305;321300;76-107;488;385;381;135;246
8;321305;321300;76-107;312;240;240;131;109
9;321305;321300;76-113;185;128;128;73;55
10;321305;321300;76-113;274;144;143;106;37
11;321305;321300;76-113;342;205;202;131;71
12;321305;321300;76-113;493;305;300;191;109
13;321305;321300;76-113;405;270;266;144;122
14;321305;321300;76-113;392;247;246;155;91
1;321306;321300;76-100;369;219;219;143;76
2;321306;321300;76-100;482;298;295;176;119
3;321306;321300;76-100;211;132;132;70;62
4;321306;321300;76-100;677;367;363;204;159
5;321306;321300;76-100;1003;578;572;323;249
6;321306;321300;76-100;601;346;345;185;160
7;321306;321300;76-100;450;245;243;162;81
8;321306;321300;76-100;385;224;221;128;93
9;321306;321300;76-100;361;205;205;119;86
10;321306;321300;76-100;293;189;187;136;51
11;321306;321300;76-100;281;167;165;115;50
12;321306;321300;76-100;329;231;230;137;93
13;321306;321300;76-100;263;156;156;95;61
14;321306;321300;76-100;162;110;109;71;38
15;321306;321300;76-100;188;130;129;73;56
16;321306;321300;76-100;348;192;188;128;60
1;321401;321400;73-110;1895;1414;1405;546;859
2;321401;321400;73-110;1669;1179;1169;459;710
3;321401;321400;73-110;1550;1083;1079;412;667
4;321401;321400;73-110;1969;1426;1408;600;808
5;321401;321400;73-110;1217;880;875;354;521
6;321401;321400;73-110;1138;795;785;274;511
7;321401;321400;73-110;1291;925;920;388;532
8;321401;321400;73-110;1193;826;823;349;474
9;321401;321400;73-110;1262;903;897;372;525
10;321401;321400;73-110;1469;1132;1125;456;669
11;321401;321400;73-110;1437;1082;1071;418;653
12;321401;321400;73-110;1333;890;883;402;481
13;321401;321400;73-110;1337;946;938;391;547
14;321401;321400;73-110;1256;825;822;342;480
15;321401;321400;73-110;1374;903;891;399;492
16;321401;321400;73-110;1530;1052;1049;517;532
17;321401;321400;73-110;1802;1255;1248;520;728
18;321401;321400;73-110;1791;1321;1307;500;807
19;321401;321400;73-110;1518;997;987;426;561
20;321401;321400;73-110;1054;756;750;290;460
21;321401;321400;73-110;1234;886;880;311;569
22;321401;321400;73-110;1032;716;714;278;436
23;321401;321400;73-110;1165;830;824;340;484
24;321401;321400;73-110;981;648;640;272;368
25;321401;321400;73-110;993;657;655;284;371
26;321401;321400;73-110;1215;847;835;357;478
27;321401;321400;73-110;1134;747;742;338;404
28;321401;321400;73-110;1091;797;788;336;452
29;321401;321400;73-110;1413;1019;1006;444;562
30;321401;321400;73-110;1516;1122;1115;467;648
31;321401;321400;73-110;1574;1202;1197;475;722
32;321401;321400;73-110;1844;1468;1459;459;1000
33;321401;321400;73-102;1137;705;690;345;345
34;321401;321400;73-102;1655;1119;1110;508;602
35;321401;321400;73-110;84;31;31;13;18
36;321401;321400;73-110;66;45;45;19;26
37;321401;321400;73-110;705;596;583;81;502
1;321402;321400;73-120;613;395;390;213;177
2;321402;321400;73-120;1414;938;930;450;480
3;321402;321400;73-120;811;582;581;249;332
4;321402;321400;73-120;301;175;173;92;81
5;321402;321400;73-120;304;188;187;112;75
6;321402;321400;73-120;242;157;157;119;38
7;321402;321400;73-120;168;107;107;69;38
8;321402;321400;73-120;220;112;112;73;39
9;321402;321400;73-120;211;134;132;78;54
1;321403;321400;73-130;1649;1040;1031;546;485
2;321403;321400;73-130;876;491;488;349;139
3;321403;321400;73-130;403;234;232;151;81
4;321403;321400;73-130;251;159;156;109;47
5;321403;321400;73-130;214;146;144;99;45
1;321404;321400;73-115;1354;906;892;420;472
2;321404;321400;73-115;438;258;251;175;76
3;321404;321400;73-115;611;255;254;156;98
4;321404;321400;73-115;510;306;302;157;145
5;321404;321400;73-115;490;269;265;147;118
6;321404;321400;73-115;544;264;264;159;105
7;321404;321400;73-115;271;141;141;96;45
8;321404;321400;73-115;166;78;78;55;23
9;321404;321400;73-115;464;269;269;196;73
10;321404;321400;73-115;247;146;141;84;57
11;321404;321400;73-115;254;144;143;90;53
12;321404;321400;73-115;56;29;26;11;15
1;321405;321400;73-140;1488;944;932;412;520
2;321405;321400;73-140;273;155;154;104;50
3;321405;321400;73-140;388;237;237;146;91
4;321405;321400;73-140;404;231;231;131;100
1;321406;321400;73-108;1659;1303;1283;414;869
2;321406;321400;73-108;1349;1021;1014;459;555
3;321406;321400;73-108;1388;1161;1157;388;769
4;321406;321400;73-110;333;238;236;148;88
5;321406;321400;73-108;388;302;301;142;159
1;321408;321400;73-121;397;228;226;145;81
2;321408;321400;73-121;536;325;320;201;119
3;321408;321400;73-121;878;581;578;308;270
4;321408;321400;73-121;457;244;241;177;64
1;321409;321400;73-112;1085;692;689;422;267
2;321409;321400;73-112;657;367;362;230;132
3;321409;321400;73-112;500;278;276;189;87
4;321409;321400;73-112;218;130;129;83;46
5;321409;321400;73-112;244;120;119;69;50
1;321410;321400;73-109;710;488;485;228;257
2;321410;321400;73-131;728;398;392;253;139
3;321410;321400;73-131;540;307;301;199;102
4;321410;321400;73-110;566;418;415;169;246
5;321410;321400;73-102;829;622;618;270;348
6;321410;321400;73-102;376;224;224;136;88
7;321410;321400;73-110;1997;1543;1531;506;1025
8;321410;321400;73-110;527;347;346;194;152
9;321410;321400;73-134;454;229;228;126;102
10;321410;321400;73-110;1147;874;872;386;486
11;321410;321400;73-131;239;123;123;80;43
12;321410;321400;73-131;340;204;199;128;71
13;321410;321400;73-110;447;272;268;164;104
14;321410;321400;73-102;325;192;192;108;84
15;321410;321400;73-102;320;168;166;113;53
16;321410;321400;73-102;481;313;311;145;166
17;321410;321400;73-110;476;353;351;152;199
18;321410;321400;73-110;433;310;309;167;142
19;321410;321400;73-110;434;323;318;172;146
20;321410;321400;73-110;232;164;163;85;78
1;321411;321400;73-132;1053;647;646;317;329
2;321411;321400;73-132;617;375;373;247;126
3;321411;321400;73-131;593;342;339;214;125
4;321411;321400;73-132;783;407;405;265;140
1;321501;321500;78-400;1155;837;832;332;500
2;321501;321500;78-400;1514;1102;1099;422;677
3;321501;321500;78-400;1500;1093;1087;529;558
4;321501;321500;78-400;1237;797;791;311;480
5;321501;321500;78-400;887;519;515;229;286
6;321501;321500;78-400;1089;694;691;330;361
7;321501;321500;78-400;990;632;625;284;341
8;321501;321500;78-400;1420;945;939;387;552
9;321501;321500;78-400;1018;628;617;273;344
10;321501;321500;78-400;1047;703;698;304;394
11;321501;321500;78-400;1146;779;774;321;453
12;321501;321500;78-400;1409;962;952;428;524
13;321501;321500;78-400;1494;917;911;422;489
14;321501;321500;78-400;1418;854;845;409;436
15;321501;321500;78-400;1207;836;825;353;472
16;321501;321500;78-400;1360;900;895;408;487
17;321501;321500;78-400;1159;765;761;343;418
18;321501;321500;78-400;1196;782;774;358;416
19;321501;321500;78-400;1306;862;855;400;455
20;321501;321500;78-400;1726;1231;1223;502;721
21;321501;321500;78-400;1259;896;888;371;517
22;321501;321500;78-400;640;462;459;206;253
23;321501;321500;78-400;57;36;36;18;18
24;321501;321500;78-400;198;152;152;24;128
25;321501;321500;78-400;46;27;26;11;15
1;321502;321500;78-460;1415;811;804;433;371
2;321502;321500;78-460;1204;720;716;412;304
3;321502;321500;78-460;687;387;380;244;136
4;321502;321500;78-460;1147;634;625;423;202
5;321502;321500;78-460;1591;839;831;504;327
1;321503;321500;78-425;839;564;560;236;324
2;321503;321500;78-425;812;470;467;211;256
3;321503;321500;78-425;457;258;256;153;103
4;321503;321500;78-426;444;250;246;124;122
5;321503;321500;78-421;489;276;275;166;109
6;321503;321500;78-421;238;116;112;72;40
7;321503;321500;78-421;243;167;167;105;62
8;321503;321500;78-425;216;126;125;60;65
1;321504;321500;78-449;1395;926;924;396;528
2;321504;321500;78-449;1062;700;696;267;429
3;321504;321500;78-445;810;536;532;263;269
4;321504;321500;78-446;551;309;305;172;133
5;321504;321500;78-446;469;304;302;178;124
6;321504;321500;78-446;369;230;228;109;119
7;321504;321500;78-445;235;141;140;74;66
8;321504;321500;78-446;200;135;131;60;71
9;321504;321500;78-445;207;129;129;66;63
10;321504;321500;78-446;408;274;270;127;143
11;321504;321500;78-449;1000;657;650;261;389
12;321504;321500;78-446;263;182;181;89;92
13;321504;321500;78-449;52;32;32;12;20
14;321504;321500;78-449;163;82;77;38;39
1;321505;321500;78-450;536;348;348;181;167
2;321505;321500;78-450;594;324;320;217;103
3;321505;321500;78-451;617;333;330;177;153
4;321505;321500;78-452;349;213;211;93;118
5;321505;321500;78-450;256;160;159;112;47
6;321505;321500;78-450;209;118;115;76;39
7;321505;321500;78-450;271;132;131;73;58
8;321505;321500;78-450;487;327;326;136;190
1;321506;321500;78-411;1201;618;613;350;263
2;321506;321500;78-400;526;306;302;161;141
3;321506;321500;78-400;926;582;580;345;235
4;321506;321500;78-400;248;153;153;110;43
5;321506;321500;78-400;789;538;534;327;207
6;321506;321500;78-400;644;355;349;206;143
7;321506;321500;78-422;740;492;486;256;230
8;321506;321500;78-400;214;139;136;81;55
9;321506;321500;78-400;246;128;128;89;39
10;321506;321500;78-400;162;94;92;52;40
11;321506;321500;78-400;299;204;199;138;61
12;321506;321500;78-400;179;99;99;46;53
13;321506;321500;78-422;404;245;243;120;123
14;321506;321500;78-400;230;138;137;92;45
15;321506;321500;78-400;59;17;16;4;12
1;321601;321600;78-300;1537;937;926;420;506
2;321601;321600;78-300;1404;884;870;325;545
3;321601;321600;78-300;1100;704;698;297;401
4;321601;321600;78-300;1278;839;833;361;472
5;321601;321600;78-300;1657;1128;1115;399;716
6;321601;321600;78-300;1449;988;982;432;550
7;321601;321600;78-300;1271;803;794;324;470
8;321601;321600;78-300;768;519;515;220;295
1;321602;321600;78-316;850;532;525;299;226
2;321602;321600;78-316;385;229;228;112;116
3;321602;321600;78-316;232;154;153;60;93
4;321602;321600;78-316;547;316;314;172;142
1;321603;321600;78-320;821;616;613;271;342
2;321603;321600;78-320;1547;953;951;454;497
3;321603;321600;78-320;1190;802;797;389;408
4;321603;321600;78-320;1193;752;742;371;371
5;321603;321600;78-320;1402;874;868;408;460
6;321603;321600;78-320;1208;750;744;358;386
7;321603;321600;78-320;990;487;482;256;226
8;321603;321600;78-320;1578;916;910;479;431
9;321603;321600;78-320;558;344;339;193;146
10;321603;321600;78-320;30;13;13;6;7
11;321603;321600;78-320;670;627;623;248;375
1;321604;321600;78-331;912;571;564;288;276
2;321604;321600;78-331;507;274;274;193;81
3;321604;321600;78-331;447;248;247;176;71
4;321604;321600;78-331;407;205;200;143;57
5;321604;321600;78-331;207;116;114;65;49
6;321604;321600;78-331;36;33;29;18;11
1;321605;321600;78-314;683;429;414;169;245
2;321605;321600;78-314;663;469;468;189;279
3;321605;321600;78-314;835;390;388;218;170
4;321605;321600;78-314;597;303;299;161;138
5;321605;321600;78-314;57;21;19;15;4
1;321606;321600;78-311;487;296;291;162;129
2;321606;321600;78-312;544;316;313;219;94
3;321606;321600;78-324;385;194;192;117;75
4;321606;321600;78-312;398;224;218;134;84
5;321606;321600;78-300;294;154;154;111;43
6;321606;321600;78-300;525;280;278;158;120
7;321606;321600;78-300;304;186;186;96;90
8;321606;321600;78-300;377;222;222;139;83
9;321606;321600;78-324;265;173;171;107;64
10;321606;321600;78-324;433;291;290;149;141
11;321606;321600;78-300;205;125;124;67;57
1;321701;321700;78-600;1742;1183;1168;396;772
2;321701;321700;78-600;1621;1132;1118;355;763
3;321701;321700;78-600;1736;1139;1128;419;709
4;321701;321700;78-600;1026;690;682;258;424
5;321701;321700;78-600;1517;1060;1046;386;660
6;321701;321700;78-600;2008;1318;1305;524;781
7;321701;321700;78-600;1786;1249;1242;480;762
8;321701;321700;78-600;1342;898;891;328;563
9;321701;321700;78-600;1373;992;984;385;599
10;321701;321700;78-600;1452;1091;1082;360;722
11;321701;321700;78-600;1604;1204;1188;449;739
12;321701;321700;78-600;44;28;28;14;14
13;321701;321700;78-600;56;44;40;30;10
1;321702;321700;78-630;1663;1007;1002;473;529
2;321702;321700;78-630;1234;664;658;388;270
3;321702;321700;78-630;336;208;208;110;98
4;321702;321700;78-630;343;197;195;110;85
1;321703;321700;78-650;1223;772;764;290;474
2;321703;321700;78-650;1185;785;776;315;461
3;321703;321700;78-651;431;290;288;133;155
4;321703;321700;78-652;230;133;133;84;49
5;321703;321700;78-650;198;131;131;60;71
6;321703;321700;78-650;300;139;139;97;42
7;321703;321700;78-650;278;142;141;75;66
1;321704;321700;78-640;741;469;461;213;248
2;321704;321700;78-641;669;379;375;231;144
3;321704;321700;78-641;673;338;335;223;112
4;321704;321700;78-640;249;120;120;71;49
5;321704;321700;78-640;187;99;98;51;47
6;321704;321700;78-640;988;556;551;293;258
1;321705;321700;78-607;465;280;279;132;147
2;321705;321700;78-609;593;338;338;177;161
3;321705;321700;78-600;677;439;433;208;225
4;321705;321700;78-611;1175;872;866;344;522
5;321705;321700;78-600;724;414;406;242;164
6;321705;321700;78-627;620;344;340;150;190
7;321705;321700;78-600;570;318;314;171;143
8;321705;321700;78-642;529;319;314;146;168
9;321705;321700;78-627;565;353;348;152;196
10;321705;321700;78-607;243;157;157;81;76
11;321705;321700;78-600;535;285;284;122;162
12;321705;321700;78-600;631;415;408;194;214
13;321705;321700;78-600;490;265;264;155;109
14;321705;321700;78-642;513;287;286;149;137
15;321705;321700;78-607;374;232;228;150;78
16;321705;321700;78-600;374;288;282;137;145
1;321801;321800;72-210;1519;905;898;478;420
2;321801;321800;72-210;733;373;370;245;125
3;321801;321800;72-210;517;257;254;157;97
4;321801;321800;72-210;184;107;107;72;35
1;321802;321800;73-150;1398;987;979;354;625
2;321802;321800;73-150;1277;853;844;361;483
3;321802;321800;73-150;1254;834;827;320;507
4;321802;321800;73-150;562;341;338;133;205
5;321802;321800;73-150;1369;944;939;377;562
6;321802;321800;73-150;663;417;415;183;232
7;321802;321800;73-150;606;416;412;182;230
8;321802;321800;73-150;750;389;385;202;183
9;321802;321800;73-150;657;335;334;184;150
10;321802;321800;73-150;467;279;278;149;129
11;321802;321800;73-150;620;325;320;158;162
1;321803;321800;72-314;826;549;540;229;311
2;321803;321800;72-314;481;247;246;132;114
3;321803;321800;72-314;484;270;265;140;125
4;321803;321800;73-155;771;405;403;275;128
1;321804;321800;72-315;1216;807;795;387;408
2;321804;321800;72-315;1884;1180;1169;467;702
3;321804;321800;72-315;405;207;207;132;75
4;321804;321800;72-315;442;241;238;118;120
5;321804;321800;72-315;924;504;501;304;197
6;321804;321800;72-315;444;241;236;118;118
7;321804;321800;72-315;61;28;27;14;13
1;321805;321800;73-155;1920;1176;1166;525;641
2;321805;321800;73-155;630;362;361;227;134
3;321805;321800;73-155;346;194;192;134;58
4;321805;321800;73-155;776;428;422;223;199
5;321805;321800;73-155;355;207;204;134;70
6;321805;321800;73-155;932;529;517;314;203
1;326101;326100;75-900;1270;1014;1004;375;629
2;326101;326100;75-235;1021;760;755;226;529
3;326101;326100;75-233;1490;1095;1092;426;666
4;326101;326100;75-255;1728;1264;1253;432;821
5;326101;326100;75-342;2947;2409;2389;698;1691
6;326101;326100;75-343;1459;1068;1060;422;638
7;326101;326100;75-343;1386;966;962;369;593
8;326101;326100;75-354;2000;1411;1389;543;846
9;326101;326100;75-335;1049;701;696;272;424
10;326101;326100;75-321;1508;1026;1015;419;596
11;326101;326100;75-415;1153;714;707;298;409
12;326101;326100;75-445;1251;930;920;333;587
13;326101;326100;75-452;1408;1029;1023;396;627
14;326101;326100;75-327;1791;1396;1377;465;912
15;326101;326100;75-451;1488;1156;1149;393;756
16;326101;326100;75-453;1622;1239;1232;441;791
17;326101;326100;75-449;1288;982;979;326;653
18;326101;326100;75-449;1873;1463;1453;494;959
19;326101;326100;75-449;1263;969;962;364;598
20;326101;326100;75-361;1708;1405;1395;408;987
21;326101;326100;75-445;1385;1066;1058;403;655
22;326101;326100;75-446;1414;978;967;384;583
23;326101;326100;75-434;1413;942;936;373;563
24;326101;326100;75-522;1338;932;923;370;553
25;326101;326100;75-503;905;660;651;225;426
26;326101;326100;75-567;1711;1303;1296;461;835
27;326101;326100;75-567;1788;1230;1224;430;794
28;326101;326100;75-512;1572;1033;1025;394;631
29;326101;326100;75-581;1454;1103;1094;362;732
30;326101;326100;75-654;2004;1525;1517;461;1056
31;326101;326100;75-679;1892;1472;1460;483;977
32;326101;326100;75-679;2432;2019;2006;526;1480
33;326101;326100;75-631;1574;1120;1108;423;685
34;326101;326100;75-631;1509;1031;1021;383;638
35;326101;326100;75-712;2014;1512;1506;581;925
36;326101;326100;75-900;954;714;708;254;454
37;326101;326100;75-736;2230;1677;1658;622;1036
38;326101;326100;75-803;1042;676;668;241;427
39;326101;326100;75-001;856;585;580;198;382
40;326101;326100;75-243;1394;915;911;366;545
41;326101;326100;75-243;1732;1074;1067;430;637
42;326101;326100;75-070;1138;764;751;296;455
43;326101;326100;75-070;959;627;621;276;345
44;326101;326100;75-808;2046;1489;1475;540;935
45;326101;326100;75-100;1486;1006;1003;375;628
46;326101;326100;75-111;1259;807;801;352;449
47;326101;326100;75-842;774;494;491;185;306
48;326101;326100;75-847;1811;1354;1339;422;917
49;326101;326100;75-823;1544;919;913;391;522
50;326101;326100;75-122;1401;991;982;373;609
51;326101;326100;75-581;140;127;125;51;74
52;326101;326100;75-252;77;19;19;10;9
53;326101;326100;75-202;343;263;259;38;221
54;326101;326100;75-422;304;251;247;54;193
55;326101;326100;75-206;77;35;34;14;20
56;326101;326100;75-819;76;26;25;12;13
1;326201;326200;70-892;1154;875;871;353;518
2;326201;326200;70-893;2297;1715;1700;763;937
3;326201;326200;70-880;1369;986;977;425;552
4;326201;326200;70-880;1815;1390;1372;580;792
5;326201;326200;70-792;1093;873;865;363;502
6;326201;326200;70-792;1380;1093;1087;354;733
7;326201;326200;70-895;1045;724;719;344;375
8;326201;326200;70-895;1275;881;873;413;460
9;326201;326200;70-842;1403;1042;1035;434;601
10;326201;326200;70-842;1318;930;907;359;548
11;326201;326200;70-833;2028;1480;1470;569;901
12;326201;326200;70-812;1175;825;809;316;493
13;326201;326200;70-812;1837;1275;1263;527;736
14;326201;326200;70-823;2019;1466;1453;615;838
15;326201;326200;70-784;1698;1326;1318;453;865
16;326201;326200;70-777;1220;956;947;409;538
17;326201;326200;70-783;1229;904;898;361;537
18;326201;326200;70-783;1495;1117;1111;428;683
19;326201;326200;70-783;984;750;741;256;485
20;326201;326200;70-783;1315;987;982;403;579
21;326201;326200;70-783;1192;914;905;347;558
22;326201;326200;70-785;984;741;732;313;419
23;326201;326200;70-785;1352;1042;1035;437;598
24;326201;326200;70-785;1354;1036;1018;376;642
25;326201;326200;70-786;1495;1161;1154;410;744
26;326201;326200;70-783;611;428;423;150;273
27;326201;326200;70-781;1738;1333;1317;480;837
28;326201;326200;70-789;1491;1121;1108;413;695
29;326201;326200;70-781;1624;1270;1255;506;749
30;326201;326200;70-781;1503;1121;1112;452;660
31;326201;326200;70-781;1819;1470;1453;430;1023
32;326201;326200;70-781;1688;1362;1344;524;820
33;326201;326200;70-773;1587;1150;1136;446;690
34;326201;326200;70-774;1331;998;990;366;624
35;326201;326200;70-774;916;702;697;260;437
36;326201;326200;70-763;1816;1265;1261;469;792
37;326201;326200;70-747;1395;974;964;436;528
38;326201;326200;70-743;1589;1084;1074;391;683
39;326201;326200;70-743;1538;1097;1090;384;706
40;326201;326200;70-743;1567;1199;1187;402;785
41;326201;326200;70-702;1679;1110;1098;541;557
42;326201;326200;70-656;629;404;402;221;181
43;326201;326200;70-021;909;645;642;281;361
44;326201;326200;70-023;1701;1333;1316;481;835
45;326201;326200;70-025;1858;1329;1322;508;814
46;326201;326200;70-028;1198;894;882;334;548
47;326201;326200;70-131;2337;1825;1810;636;1174
48;326201;326200;70-123;1782;1342;1334;481;853
49;326201;326200;70-123;1672;1233;1223;425;798
50;326201;326200;70-111;904;614;607;228;379
51;326201;326200;70-136;1318;987;978;403;575
52;326201;326200;70-132;1216;909;903;355;548
53;326201;326200;71-004;1881;1462;1442;447;995
54;326201;326200;71-023;1586;1280;1270;437;833
55;326201;326200;71-023;1440;1077;1069;363;706
56;326201;326200;71-023;1763;1471;1458;394;1064
57;326201;326200;71-032;1142;967;961;331;630
58;326201;326200;71-032;1271;1004;992;389;603
59;326201;326200;71-017;1540;1215;1205;421;784
60;326201;326200;71-017;1098;852;846;285;561
61;326201;326200;71-044;1569;1262;1243;406;837
62;326201;326200;71-044;1635;1292;1280;407;873
63;326201;326200;71-044;2249;1855;1835;489;1346
64;326201;326200;71-044;1725;1371;1353;407;946
65;326201;326200;70-065;2092;1578;1560;510;1050
66;326201;326200;70-322;1187;820;814;286;528
67;326201;326200;70-310;682;459;455;158;297
68;326201;326200;70-331;1226;803;798;309;489
69;326201;326200;70-383;1295;875;864;297;567
70;326201;326200;70-383;898;652;644;221;423
71;326201;326200;70-236;1599;1282;1270;401;869
72;326201;326200;70-236;1522;1235;1231;399;832
73;326201;326200;70-382;1423;1055;1045;364;681
74;326201;326200;70-382;1479;1116;1108;368;740
75;326201;326200;70-327;1170;768;757;235;522
76;326201;326200;70-351;1472;1005;991;391;600
77;326201;326200;70-361;1383;1006;993;395;598
78;326201;326200;70-211;422;255;253;110;143
79;326201;326200;70-214;1250;796;787;320;467
80;326201;326200;70-214;954;676;672;229;443
81;326201;326200;70-311;1306;812;808;345;463
82;326201;326200;70-262;1452;1045;1040;382;658
83;326201;326200;70-262;1486;925;918;373;545
84;326201;326200;70-241;1120;722;715;285;430
85;326201;326200;70-306;1309;815;805;372;433
86;326201;326200;70-306;1364;864;860;332;528
87;326201;326200;70-352;1381;897;888;388;500
88;326201;326200;70-204;723;570;562;206;356
89;326201;326200;70-543;895;715;711;190;521
90;326201;326200;70-546;1717;1172;1162;409;753
91;326201;326200;70-306;1731;1133;1126;413;713
92;326201;326200;70-424;1241;857;851;296;555
93;326201;326200;70-424;1127;812;804;262;542
94;326201;326200;70-426;1048;591;588;225;363
95;326201;326200;70-426;1313;987;975;346;629
96;326201;326200;71-417;880;517;515;196;319
97;326201;326200;71-417;1063;770;764;305;459
98;326201;326200;70-450;1309;838;833;322;511
99;326201;326200;70-451;1054;733;729;265;464
100;326201;326200;71-417;1231;918;911;282;629
101;326201;326200;71-402;678;532;519;184;335
102;326201;326200;70-424;1446;994;984;388;596
103;326201;326200;71-612;659;437;428;156;272
104;326201;326200;71-537;2012;1528;1511;482;1029
105;326201;326200;71-612;1190;879;870;322;548
106;326201;326200;70-507;929;706;698;246;452
107;326201;326200;71-622;1841;1338;1338;516;822
108;326201;326200;71-441;1306;848;836;347;489
109;326201;326200;71-413;1262;861;856;303;553
110;326201;326200;71-444;1639;1213;1198;497;701
111;326201;326200;71-444;1432;876;870;366;504
112;326201;326200;71-413;1064;846;840;239;601
113;326201;326200;71-551;1199;910;902;300;602
114;326201;326200;71-551;1311;896;889;363;526
115;326201;326200;71-540;1588;1180;1170;383;787
116;326201;326200;71-540;884;676;672;231;441
117;326201;326200;71-540;1400;996;983;348;635
118;326201;326200;71-540;1652;1216;1197;447;750
119;326201;326200;71-553;1860;1307;1298;503;795
120;326201;326200;71-080;748;580;575;201;374
121;326201;326200;71-075;1666;1338;1324;428;896
122;326201;326200;71-075;1156;799;793;326;467
123;326201;326200;71-126;1185;942;938;294;644
124;326201;326200;71-126;1523;1145;1132;427;705
125;326201;326200;71-131;1786;1468;1453;407;1046
126;326201;326200;71-122;1502;1155;1140;386;754
127;326201;326200;71-122;1854;1451;1434;467;967
128;326201;326200;71-114;857;662;657;245;412
129;326201;326200;71-114;999;781;772;236;536
130;326201;326200;71-138;1511;1114;1104;384;720
131;326201;326200;71-201;1614;1274;1264;394;870
132;326201;326200;71-201;1891;1550;1531;442;1089
133;326201;326200;71-201;1820;1436;1426;434;992
134;326201;326200;71-201;2173;1817;1793;471;1322
135;326201;326200;71-201;1570;1254;1246;396;850
136;326201;326200;71-246;2050;1680;1656;468;1188
137;326201;326200;71-244;841;601;594;159;435
138;326201;326200;71-246;1390;1076;1067;375;692
139;326201;326200;71-246;1660;1271;1261;453;808
140;326201;326200;71-246;1585;1205;1197;399;798
141;326201;326200;71-241;1765;1385;1373;415;958
142;326201;326200;71-273;791;531;521;210;311
143;326201;326200;71-270;1462;1030;1020;378;642
144;326201;326200;71-244;1186;878;872;274;598
145;326201;326200;71-276;1282;1027;1015;273;742
146;326201;326200;71-101;1222;916;905;255;650
147;326201;326200;71-276;1261;1016;1011;263;748
148;326201;326200;70-490;1330;1048;1042;304;738
149;326201;326200;70-490;993;755;746;230;516
150;326201;326200;71-333;1608;1298;1284;361;923
151;326201;326200;71-382;845;677;674;213;461
152;326201;326200;70-454;1803;1379;1365;540;825
153;326201;326200;70-454;2244;1775;1752;497;1255
154;326201;326200;71-457;1867;1386;1371;503;868
155;326201;326200;71-476;1622;1204;1197;425;772
156;326201;326200;71-476;1195;960;946;314;632
157;326201;326200;71-631;790;536;533;235;298
158;326201;326200;71-610;1525;1008;996;425;571
159;326201;326200;71-632;1772;1257;1247;480;767
160;326201;326200;71-636;1472;1109;1099;445;654
161;326201;326200;71-610;1907;1286;1273;497;776
162;326201;326200;70-494;3008;2485;2463;690;1773
163;326201;326200;71-504;1177;862;844;322;522
164;326201;326200;71-504;1440;1099;1094;427;667
165;326201;326200;71-793;2753;2309;2293;658;1635
166;326201;326200;71-793;2885;2458;2433;598;1835
167;326201;326200;71-795;1438;1174;1166;337;829
168;326201;326200;71-795;1550;1264;1255;415;840
169;326201;326200;71-795;1591;1352;1342;376;966
170;326201;326200;71-665;2004;1557;1546;529;1017
171;326201;326200;71-665;1941;1454;1439;527;912
172;326201;326200;71-665;1711;1353;1346;481;865
173;326201;326200;71-665;1139;880;876;332;544
174;326201;326200;71-685;2092;1625;1595;571;1024
175;326201;326200;71-681;1502;1022;1010;413;597
176;326201;326200;71-681;1213;917;904;376;528
177;326201;326200;71-681;1441;1029;1020;423;597
178;326201;326200;71-681;1703;1213;1205;495;710
179;326201;326200;71-781;1653;1377;1366;394;972
180;326201;326200;71-699;2007;1490;1481;551;930
181;326201;326200;71-747;1706;1383;1366;474;892
182;326201;326200;71-711;1661;1258;1247;441;806
183;326201;326200;71-699;1166;813;803;333;470
184;326201;326200;71-751;679;434;426;186;240
185;326201;326200;71-730;642;417;412;199;213
186;326201;326200;71-739;2097;1671;1653;523;1130
187;326201;326200;71-857;1996;1629;1616;522;1094
188;326201;326200;71-734;734;440;437;216;221
189;326201;326200;71-826;2693;1974;1952;825;1127
190;326201;326200;71-828;928;486;479;263;216
191;326201;326200;71-870;1050;652;649;340;309
192;326201;326200;71-833;1126;761;757;337;420
193;326201;326200;70-789;663;508;503;160;343
194;326201;326200;70-236;1436;1121;1110;395;715
195;326201;326200;71-460;35;35;34;24;10
196;326201;326200;70-899;179;115;115;43;72
197;326201;326200;70-780;152;132;131;53;78
198;326201;326200;70-111;163;126;123;67;56
199;326201;326200;70-382;48;19;18;4;14
200;326201;326200;71-252;146;146;142;59;83
201;326201;326200;71-460;35;35;33;8;25
202;326201;326200;71-246;227;74;74;29;45
203;326201;326200;71-740;112;69;68;31;37
204;326201;326200;71-747;205;86;85;40;45
205;326201;326200;70-226;450;387;373;81;292
206;326201;326200;71-422;86;56;53;17;36
207;326201;326200;71-506;125;75;71;38;33
208;326201;326200;71-505;35;18;17;11;6
209;326201;326200;71-455;241;149;145;63;82
210;326201;326200;71-470;16;14;13;8;5
1;326301;326300;72-600;978;978;972;296;676
2;326301;326300;72-600;2121;1639;1630;556;1074
3;326301;326300;72-600;929;648;642;210;432
4;326301;326300;72-600;1021;740;738;267;471
5;326301;326300;72-600;1255;910;905;296;609
6;326301;326300;72-600;1314;966;954;296;658
7;326301;326300;72-600;1453;1080;1073;348;725
8;326301;326300;72-600;1777;1294;1279;414;865
9;326301;326300;72-600;787;540;539;196;343
10;326301;326300;72-600;1019;674;670;227;443
11;326301;326300;72-600;1257;820;818;322;496
12;326301;326300;72-600;1569;1124;1114;399;715
13;326301;326300;72-600;1260;860;856;331;525
14;326301;326300;72-600;1119;750;748;300;448
15;326301;326300;72-600;1045;675;674;247;427
16;326301;326300;72-600;1380;1029;1023;348;675
17;326301;326300;72-600;1453;969;959;371;588
18;326301;326300;72-600;1161;776;769;320;449
19;326301;326300;72-600;1196;789;783;320;463
20;326301;326300;72-600;1281;958;942;277;665
21;326301;326300;72-600;864;627;617;210;407
22;326301;326300;72-602;1457;1008;1001;452;549
23;326301;326300;72-602;870;522;513;219;294
24;326301;326300;72-603;543;343;342;164;178
25;326301;326300;72-605;1031;785;779;334;445
26;326301;326300;72-600;1677;1588;1581;528;1053
27;326301;326300;72-600;61;28;26;9;17
28;326301;326300;72-600;94;26;26;8;18
